,MSOA11CD,Year,Count,Mean_Price,Median_Price,Type_Detached,Type_Semi_Detached,Type_Terraced,Type_Flats,Newbuild_Yes,Newbuild_No,Freehold,Leasehold
1,E02000001,ALL,1437,614000,500000,0,0,10,1427,403,1034,6,1431
2,E02000002,ALL,280,187000,184000,8,79,128,65,0,280,212,68
3,E02000003,ALL,545,200000,210000,18,77,295,155,26,519,386,159
4,E02000004,ALL,349,199000,200000,6,76,217,50,2,347,298,51
5,E02000005,ALL,366,174000,170000,1,19,317,29,1,365,337,29
6,E02000007,ALL,323,169000,163000,15,70,149,89,66,257,233,90
7,E02000008,ALL,448,166000,165000,1,46,364,37,0,448,413,35
8,E02000009,ALL,706,181000,176000,1,48,261,396,380,326,312,394
9,E02000010,ALL,302,164000,162000,0,22,252,28,0,302,274,28
10,E02000011,ALL,312,186000,186000,17,50,192,53,0,312,259,53
11,E02000012,ALL,487,263000,265000,3,47,370,67,2,485,418,69
12,E02000013,ALL,296,175000,169000,2,39,233,22,0,296,275,21
13,E02000014,ALL,332,167000,165000,1,26,289,16,0,332,315,17
14,E02000015,ALL,194,150000,145000,7,39,57,91,1,193,103,91
15,E02000016,ALL,403,153000,145000,0,1,49,353,203,200,48,355
16,E02000017,ALL,325,212000,219000,2,15,260,48,0,325,278,47
17,E02000018,ALL,294,165000,163000,2,16,239,37,1,293,255,39
18,E02000019,ALL,310,165000,163000,0,22,258,30,4,306,280,30
19,E02000020,ALL,472,191000,190000,9,37,333,93,135,337,278,194
20,E02000021,ALL,289,160000,159000,0,22,236,31,0,289,259,30
21,E02000022,ALL,226,137000,140000,0,9,12,205,14,212,20,206
22,E02000023,ALL,142,161000,167000,1,15,83,43,1,141,97,45
23,E02000024,ALL,845,433000,365000,117,236,209,283,67,778,559,286
24,E02000025,ALL,622,326000,275000,60,175,69,318,1,621,299,323
25,E02000026,ALL,447,374000,360000,48,188,88,123,1,446,318,129
26,E02000027,ALL,442,308000,293000,32,158,129,123,10,432,311,131
27,E02000028,ALL,476,368000,325000,39,164,52,221,21,455,253,223
28,E02000029,ALL,566,303000,274000,27,169,151,219,10,556,341,225
29,E02000030,ALL,567,826000,610000,248,199,74,46,8,559,515,52
30,E02000031,ALL,480,475000,383000,78,139,70,193,16,464,283,197
31,E02000032,ALL,366,420000,415000,28,235,80,23,0,366,341,25
32,E02000033,ALL,510,301000,302000,10,173,163,164,7,503,346,164
33,E02000034,ALL,535,348000,264000,33,150,73,279,2,533,254,281
34,E02000035,ALL,557,410000,340000,41,94,89,333,37,520,222,335
35,E02000036,ALL,593,316000,300000,42,275,71,205,31,562,378,215
36,E02000037,ALL,530,414000,398000,89,210,20,211,138,392,318,212
37,E02000038,ALL,661,368000,355000,29,163,154,315,8,653,347,314
38,E02000039,ALL,456,567000,412000,131,96,59,170,11,445,286,170
39,E02000040,ALL,587,457000,360000,80,162,85,260,189,398,302,285
40,E02000041,ALL,397,350000,320000,34,183,76,104,4,393,288,109
41,E02000042,ALL,690,332000,287000,16,95,143,436,15,675,240,450
42,E02000043,ALL,393,524000,520000,39,218,43,93,5,388,294,99
43,E02000044,ALL,377,313000,250000,21,71,166,119,23,354,257,120
44,E02000045,ALL,573,307000,255000,18,90,142,323,11,562,242,331
45,E02000046,ALL,393,408000,342000,8,85,83,217,2,391,170,223
46,E02000047,ALL,474,229000,225000,0,70,179,225,123,351,247,227
47,E02000048,ALL,714,439000,365000,56,263,95,300,48,666,411,303
48,E02000049,ALL,160,212000,225000,0,8,55,97,45,115,63,97
49,E02000050,ALL,543,375000,295000,9,74,186,274,19,524,258,285
50,E02000051,ALL,568,583000,436000,87,87,29,365,30,538,200,368
51,E02000052,ALL,709,414000,355000,7,76,231,395,3,706,296,413
52,E02000053,ALL,1364,269000,250000,2,74,59,1229,991,373,133,1231
53,E02000054,ALL,442,393000,290000,61,126,9,246,9,433,190,252
54,E02000055,ALL,561,450000,331000,83,84,54,340,19,542,218,343
55,E02000056,ALL,612,1374000,945000,140,205,24,243,28,584,336,276
56,E02000057,ALL,351,452000,375000,70,78,62,141,2,349,207,144
57,E02000058,ALL,646,658000,560000,68,227,138,213,12,634,395,251
58,E02000059,ALL,592,253000,248000,5,62,157,368,136,456,227,365
59,E02000060,ALL,372,594000,554000,53,151,44,124,23,349,246,126
60,E02000061,ALL,523,1003000,660000,70,154,21,278,84,439,240,283
61,E02000062,ALL,238,288000,288000,3,63,85,87,0,238,153,85
62,E02000063,ALL,333,360000,345000,7,170,36,120,0,333,211,122
63,E02000064,ALL,301,644000,360000,18,51,53,179,30,271,118,183
64,E02000065,ALL,234,147000,152000,3,21,135,75,0,234,159,75
65,E02000066,ALL,251,152000,150000,7,17,138,89,25,226,161,90
66,E02000067,ALL,635,160000,150000,15,79,230,311,126,509,321,314
67,E02000068,ALL,346,161000,155000,6,56,150,134,3,343,213,133
68,E02000069,ALL,364,186000,173000,26,107,81,150,0,364,212,152
69,E02000070,ALL,488,224000,228000,33,249,139,67,0,488,423,65
70,E02000071,ALL,424,209000,208000,15,184,197,28,0,424,395,29
71,E02000072,ALL,416,160000,162000,5,88,233,90,22,394,324,92
72,E02000073,ALL,624,247000,248000,12,487,97,28,0,624,592,32
73,E02000074,ALL,429,166000,164000,4,181,85,159,100,329,268,161
74,E02000075,ALL,494,251000,250000,35,294,98,67,0,494,425,69
75,E02000077,ALL,425,219000,220000,2,265,115,43,2,423,384,41
76,E02000078,ALL,557,213000,202000,20,244,198,95,1,556,461,96
77,E02000079,ALL,611,231000,224000,40,217,169,185,3,608,425,186
78,E02000080,ALL,622,231000,235000,23,378,142,79,5,617,541,81
79,E02000081,ALL,497,224000,222000,29,242,125,101,1,496,389,108
80,E02000082,ALL,579,240000,235000,27,239,291,22,2,577,558,21
81,E02000083,ALL,802,197000,185000,47,193,338,224,147,655,578,224
82,E02000084,ALL,712,276000,250000,122,321,175,94,1,711,616,96
83,E02000085,ALL,571,229000,212000,13,174,326,58,1,570,512,59
84,E02000086,ALL,498,267000,245000,46,194,203,55,0,498,442,56
85,E02000087,ALL,664,326000,280000,173,181,130,180,99,565,484,180
86,E02000088,ALL,523,269000,250000,25,221,262,15,0,523,511,12
87,E02000089,ALL,484,288000,279000,40,281,139,24,5,479,461,23
88,E02000090,ALL,890,232000,200000,73,151,172,494,104,786,387,503
89,E02000091,ALL,754,261000,232000,58,278,114,304,30,724,445,309
90,E02000092,ALL,310,220000,194000,22,116,86,86,0,310,219,91
91,E02000093,ALL,289,307000,317000,10,106,101,72,2,287,214,75
92,E02000094,ALL,241,293000,300000,8,98,63,72,1,240,158,83
93,E02000095,ALL,307,313000,315000,8,140,50,109,16,291,197,110
94,E02000096,ALL,308,411000,435000,73,146,9,80,3,305,227,81
95,E02000097,ALL,311,307000,300000,12,140,85,74,2,309,235,76
96,E02000098,ALL,295,372000,370000,58,136,25,76,0,295,219,76
97,E02000099,ALL,309,290000,290000,6,105,72,126,3,306,184,125
98,E02000100,ALL,264,403000,390000,48,134,35,47,14,250,216,48
99,E02000101,ALL,306,330000,240000,61,54,26,165,4,302,140,166
100,E02000102,ALL,205,257000,250000,1,23,114,67,6,199,135,70
101,E02000103,ALL,318,311000,292000,14,95,47,162,37,281,149,169
102,E02000104,ALL,267,310000,308000,18,126,25,98,2,265,169,98
103,E02000105,ALL,283,269000,245000,24,84,49,126,10,273,163,120
104,E02000106,ALL,271,301000,250000,3,66,90,112,1,270,150,121
105,E02000107,ALL,455,464000,330000,28,61,69,297,5,450,152,303
106,E02000108,ALL,226,254000,250000,10,44,58,114,36,190,113,113
107,E02000109,ALL,397,255000,250000,6,84,40,267,146,251,131,266
108,E02000110,ALL,326,477000,455000,5,88,94,139,9,317,185,141
109,E02000111,ALL,243,262000,240000,12,63,48,120,2,241,120,123
110,E02000112,ALL,270,258000,250000,2,47,78,143,68,202,128,142
111,E02000113,ALL,156,214000,213000,1,19,59,77,5,151,81,75
112,E02000114,ALL,419,375000,305000,15,32,78,294,36,383,115,304
113,E02000115,ALL,536,483000,373000,33,27,8,468,19,517,59,477
114,E02000116,ALL,211,281000,250000,3,10,56,142,3,208,63,148
115,E02000117,ALL,285,253000,230000,0,23,73,189,7,278,90,195
116,E02000118,ALL,313,237000,245000,0,43,91,179,70,243,134,179
117,E02000119,ALL,154,211000,194000,1,0,27,126,37,117,29,125
118,E02000120,ALL,693,447000,365000,8,9,129,547,70,623,132,561
119,E02000121,ALL,288,229000,224000,1,31,75,181,52,236,103,185
120,E02000122,ALL,480,779000,588000,42,106,101,231,10,470,239,241
121,E02000123,ALL,502,306000,267000,2,36,131,333,13,489,149,353
122,E02000124,ALL,799,622000,430000,1,31,237,530,70,729,261,538
123,E02000125,ALL,595,480000,410000,4,33,257,301,7,588,272,323
124,E02000126,ALL,255,334000,325000,0,3,14,238,72,183,14,241
125,E02000127,ALL,507,242000,195000,43,83,279,102,0,507,406,101
126,E02000128,ALL,591,326000,285000,44,186,264,97,4,587,495,96
127,E02000130,ALL,627,323000,277000,15,151,242,219,5,622,404,223
128,E02000131,ALL,984,237000,213000,17,40,86,841,180,804,135,849
129,E02000132,ALL,1036,272000,240000,44,80,163,749,64,972,280,756
130,E02000133,ALL,1134,562000,470000,472,131,226,305,169,965,799,335
131,E02000134,ALL,1147,278000,237000,70,138,307,632,48,1099,511,636
132,E02000135,ALL,388,203000,180000,7,24,80,277,14,374,106,282
133,E02000136,ALL,350,413000,316000,113,84,83,70,14,336,279,71
134,E02000137,ALL,819,325000,260000,129,124,104,462,29,790,350,469
135,E02000138,ALL,1035,362000,275000,139,76,114,706,60,975,318,717
136,E02000139,ALL,715,327000,275000,30,224,217,244,50,665,468,247
137,E02000140,ALL,359,196000,194000,14,176,109,60,7,352,297,62
138,E02000141,ALL,599,246000,243000,6,74,237,282,4,595,302,297
139,E02000142,ALL,700,361000,295000,125,123,218,234,31,669,466,234
140,E02000144,ALL,749,312000,270000,112,142,203,292,22,727,454,295
141,E02000145,ALL,434,188000,175000,12,142,220,60,37,397,378,56
142,E02000146,ALL,890,273000,250000,43,235,353,259,125,765,625,265
143,E02000147,ALL,614,464000,450000,241,129,24,220,15,599,390,224
144,E02000148,ALL,503,452000,400000,135,284,49,35,1,502,466,37
145,E02000149,ALL,486,227000,215000,63,208,155,60,3,483,428,58
146,E02000150,ALL,546,377000,338000,34,136,321,55,2,544,492,54
147,E02000151,ALL,606,430000,414000,146,385,32,43,0,606,554,52
148,E02000152,ALL,566,298000,273000,36,177,238,115,211,355,453,113
149,E02000153,ALL,538,380000,369000,62,370,94,12,11,527,527,11
150,E02000154,ALL,622,311000,248000,161,138,131,192,97,525,430,192
151,E02000155,ALL,529,242000,238000,36,357,93,43,2,527,487,42
152,E02000156,ALL,890,362000,362000,135,396,167,192,9,881,687,203
153,E02000157,ALL,582,342000,320000,182,208,137,55,0,582,527,55
154,E02000158,ALL,453,312000,288000,118,205,99,31,46,407,424,29
155,E02000159,ALL,556,642000,413000,275,145,68,68,15,541,487,69
156,E02000160,ALL,520,363000,350000,94,296,37,93,9,511,425,95
157,E02000161,ALL,703,301000,288000,145,338,165,55,1,702,647,56
158,E02000162,ALL,463,310000,285000,132,134,105,92,0,463,369,94
159,E02000163,ALL,529,422000,332000,211,180,113,25,6,523,500,29
160,E02000165,ALL,487,249000,242000,119,133,174,61,14,473,425,62
161,E02000166,ALL,518,847000,525000,41,51,51,375,11,507,142,376
162,E02000167,ALL,619,1321000,835000,30,53,156,380,6,613,233,386
163,E02000168,ALL,482,587000,425000,2,22,116,342,5,477,139,343
164,E02000169,ALL,577,1517000,950000,53,48,13,463,11,566,113,464
165,E02000170,ALL,651,675000,540000,15,67,89,480,54,597,167,484
166,E02000171,ALL,573,685000,500000,8,26,109,430,5,568,139,434
167,E02000172,ALL,385,449000,350000,1,10,84,290,44,341,96,289
168,E02000173,ALL,571,1061000,735000,16,27,25,503,9,562,58,513
169,E02000174,ALL,418,526000,410000,2,21,65,330,6,412,87,331
170,E02000175,ALL,675,565000,488000,3,18,88,566,18,657,102,573
171,E02000176,ALL,672,840000,659000,3,6,37,626,9,663,46,626
172,E02000177,ALL,494,499000,390000,1,10,73,410,12,482,84,410
173,E02000178,ALL,651,415000,375000,3,5,52,591,30,621,60,591
174,E02000179,ALL,484,828000,640000,1,14,85,384,46,438,94,390
175,E02000180,ALL,443,525000,420000,4,25,88,326,10,433,119,324
176,E02000181,ALL,724,686000,560000,10,14,30,670,5,719,48,676
177,E02000182,ALL,455,1088000,615000,13,8,34,400,5,450,55,400
178,E02000183,ALL,627,1149000,690000,5,20,108,494,48,579,128,499
179,E02000184,ALL,401,435000,375000,0,2,56,343,64,337,47,354
180,E02000185,ALL,428,462000,366000,3,7,26,392,10,418,29,399
181,E02000186,ALL,473,1028000,525000,6,7,64,396,85,388,51,422
182,E02000187,ALL,332,577000,450000,0,0,12,320,151,181,11,321
183,E02000188,ALL,192,363000,340000,0,1,4,187,4,188,2,190
184,E02000189,ALL,147,452000,390000,0,0,12,135,15,132,13,134
185,E02000190,ALL,396,395000,330000,0,1,7,388,92,304,8,388
186,E02000191,ALL,383,674000,522000,1,1,17,364,43,340,12,371
187,E02000192,ALL,375,651000,500000,0,2,23,350,60,315,28,347
188,E02000193,ALL,662,620000,450000,0,1,15,646,74,588,16,646
189,E02000194,ALL,691,275000,240000,31,69,137,454,44,647,234,457
190,E02000195,ALL,494,325000,315000,85,149,122,138,10,484,356,138
191,E02000196,ALL,255,291000,275000,9,79,107,60,3,252,192,63
192,E02000197,ALL,369,270000,250000,22,59,220,68,7,362,303,66
193,E02000198,ALL,349,199000,190000,4,51,138,156,16,333,197,152
194,E02000199,ALL,412,219000,215000,6,49,257,100,1,411,305,107
195,E02000200,ALL,579,212000,182000,9,72,122,376,68,511,198,381
196,E02000201,ALL,402,189000,180000,11,30,146,215,15,387,185,217
197,E02000202,ALL,372,216000,220000,1,24,286,61,0,372,305,67
198,E02000203,ALL,242,191000,186000,2,24,143,73,3,239,169,73
199,E02000204,ALL,305,210000,220000,5,31,181,88,30,275,217,88
200,E02000206,ALL,506,183000,178000,6,53,177,270,85,421,234,272
201,E02000207,ALL,350,205000,204000,13,61,181,95,10,340,251,99
202,E02000208,ALL,519,163000,157000,2,31,133,353,212,307,167,352
203,E02000209,ALL,290,191000,193000,3,18,234,35,0,290,253,37
204,E02000210,ALL,532,215000,220000,1,66,370,95,2,530,437,95
205,E02000211,ALL,606,280000,265000,130,208,134,134,3,603,445,161
206,E02000212,ALL,330,177000,175000,1,59,150,120,56,274,208,122
207,E02000213,ALL,490,194000,181000,18,24,75,373,141,349,113,377
208,E02000214,ALL,344,291000,280000,18,82,180,64,1,343,279,65
209,E02000215,ALL,715,214000,202000,17,91,219,388,34,681,325,390
210,E02000216,ALL,461,290000,230000,70,20,114,257,7,454,197,264
211,E02000217,ALL,940,202000,203000,6,89,253,592,403,537,348,592
212,E02000218,ALL,234,299000,310000,25,133,34,42,7,227,192,42
213,E02000219,ALL,496,346000,324000,101,224,73,98,15,481,394,102
214,E02000220,ALL,987,199000,185000,17,46,103,821,284,703,159,828
215,E02000221,ALL,472,232000,216000,36,101,124,211,33,439,259,213
216,E02000222,ALL,731,263000,218000,110,103,241,277,40,691,456,275
217,E02000223,ALL,125,162000,163000,0,22,84,19,0,125,104,21
218,E02000224,ALL,620,237000,215000,27,162,166,265,21,599,352,268
219,E02000225,ALL,247,194000,194000,0,163,62,22,0,247,200,47
220,E02000226,ALL,407,341000,330000,96,223,79,9,0,407,377,30
221,E02000227,ALL,809,213000,210000,30,206,298,275,1,808,534,275
222,E02000228,ALL,540,408000,398000,280,142,6,112,16,524,430,110
223,E02000229,ALL,180,190000,188000,1,87,61,31,0,180,150,30
224,E02000230,ALL,766,312000,275000,226,121,84,335,55,711,429,337
225,E02000231,ALL,467,583000,490000,298,86,15,68,38,429,394,73
226,E02000232,ALL,394,321000,297000,115,193,63,23,18,376,372,22
227,E02000233,ALL,489,282000,250000,90,169,129,101,16,473,386,103
228,E02000234,ALL,526,318000,276000,163,137,141,85,12,514,435,91
229,E02000235,ALL,464,351000,308000,199,147,45,73,2,462,385,79
230,E02000236,ALL,473,331000,300000,107,207,137,22,10,463,452,21
231,E02000237,ALL,482,305000,300000,147,218,72,45,3,479,437,45
232,E02000238,ALL,376,243000,250000,4,113,166,93,1,375,282,94
233,E02000239,ALL,326,282000,289000,3,70,197,56,33,293,270,56
234,E02000240,ALL,436,224000,232000,4,157,115,160,11,425,269,167
235,E02000241,ALL,328,243000,250000,1,97,151,79,10,318,246,82
236,E02000242,ALL,225,281000,270000,4,77,117,27,1,224,198,27
237,E02000243,ALL,304,248000,250000,4,119,58,123,1,303,176,128
238,E02000244,ALL,348,263000,268000,1,61,172,114,0,348,235,113
239,E02000245,ALL,329,189000,179000,4,38,66,221,43,286,111,218
240,E02000246,ALL,304,220000,232000,1,125,65,113,1,303,189,115
241,E02000247,ALL,447,205000,192000,17,58,100,272,45,402,169,278
242,E02000248,ALL,388,366000,293000,22,79,59,228,2,386,148,240
243,E02000249,ALL,320,266000,250000,23,130,53,114,14,306,201,119
244,E02000250,ALL,446,504000,495000,9,97,197,143,0,446,300,146
245,E02000251,ALL,248,255000,250000,1,20,192,35,0,248,210,38
246,E02000252,ALL,425,279000,247000,6,48,104,267,25,400,152,273
247,E02000253,ALL,368,286000,275000,6,75,191,96,1,367,267,101
248,E02000254,ALL,160,238000,240000,1,39,101,19,0,160,142,18
249,E02000255,ALL,517,435000,375000,17,111,159,230,10,507,282,235
250,E02000256,ALL,590,528000,350000,57,106,32,395,14,576,188,402
251,E02000257,ALL,938,501000,380000,84,59,100,695,142,796,233,705
252,E02000258,ALL,315,449000,390000,11,123,53,128,12,303,182,133
253,E02000259,ALL,340,370000,335000,15,88,120,117,26,314,215,125
254,E02000260,ALL,124,234000,239000,3,39,43,39,0,124,83,41
255,E02000261,ALL,822,378000,328000,24,105,121,572,191,631,201,621
256,E02000262,ALL,583,423000,335000,14,85,152,332,24,559,243,340
257,E02000263,ALL,199,223000,233000,0,10,157,32,0,199,162,37
258,E02000264,ALL,584,487000,349000,40,145,28,371,124,460,198,386
259,E02000265,ALL,690,354000,320000,7,93,243,347,28,662,316,374
260,E02000266,ALL,213,228000,226000,3,57,58,95,2,211,114,99
261,E02000267,ALL,561,330000,330000,12,63,303,183,59,502,363,198
262,E02000268,ALL,571,529000,430000,32,130,199,210,8,563,353,218
263,E02000269,ALL,639,481000,435000,17,99,312,211,16,623,421,218
264,E02000270,ALL,440,351000,300000,4,32,82,322,92,348,109,331
265,E02000271,ALL,663,800000,700000,25,84,341,213,24,639,434,229
266,E02000272,ALL,438,456000,465000,8,90,265,75,0,438,354,84
267,E02000274,ALL,364,209000,212000,3,35,189,137,89,275,224,140
268,E02000275,ALL,164,291000,241000,21,42,47,54,9,155,109,55
269,E02000276,ALL,489,412000,375000,6,49,234,200,3,486,262,227
270,E02000277,ALL,343,214000,220000,9,135,123,76,1,342,262,81
271,E02000278,ALL,334,204000,217000,5,76,154,99,26,308,233,101
272,E02000279,ALL,540,194000,195000,26,46,228,240,1,539,298,242
273,E02000280,ALL,596,295000,280000,68,141,277,110,1,595,481,115
274,E02000281,ALL,456,220000,215000,5,45,210,196,1,455,258,198
275,E02000282,ALL,333,190000,182000,4,54,123,152,8,325,177,156
276,E02000283,ALL,318,235000,228000,4,61,218,35,5,313,281,37
277,E02000284,ALL,613,274000,265000,14,86,276,237,9,604,375,238
278,E02000285,ALL,372,312000,310000,2,161,179,30,1,371,330,42
279,E02000286,ALL,834,299000,250000,86,90,105,553,80,754,273,561
280,E02000287,ALL,391,741000,500000,126,101,21,143,40,351,237,154
281,E02000288,ALL,391,202000,208000,5,56,193,137,5,386,250,141
282,E02000289,ALL,327,424000,430000,37,210,47,33,4,323,292,35
283,E02000290,ALL,221,180000,180000,1,24,94,102,0,221,116,105
284,E02000291,ALL,844,243000,225000,15,65,151,613,193,651,227,617
285,E02000292,ALL,572,244000,248000,2,56,422,92,4,568,479,93
286,E02000293,ALL,457,469000,430000,88,172,33,164,26,431,292,165
287,E02000294,ALL,265,217000,225000,1,31,197,36,0,265,230,35
288,E02000295,ALL,562,333000,279000,28,151,81,302,11,551,261,301
289,E02000296,ALL,664,284000,250000,16,81,145,422,71,593,240,424
290,E02000297,ALL,551,341000,350000,29,161,237,124,5,546,425,126
291,E02000298,ALL,497,513000,488000,56,193,105,143,6,491,343,154
292,E02000299,ALL,334,203000,207000,2,20,257,55,1,333,278,56
293,E02000300,ALL,344,202000,210000,6,35,200,103,0,344,241,103
294,E02000301,ALL,340,182000,184000,1,27,181,131,4,336,210,130
295,E02000302,ALL,430,321000,325000,11,82,230,107,45,385,320,110
296,E02000303,ALL,266,204000,220000,1,92,88,85,4,262,180,86
297,E02000304,ALL,342,483000,472000,38,147,48,109,16,326,225,117
298,E02000305,ALL,569,334000,285000,11,72,174,312,21,548,221,348
299,E02000306,ALL,179,173000,170000,0,15,64,100,0,179,79,100
300,E02000307,ALL,389,244000,233000,0,40,324,25,1,388,364,25
301,E02000308,ALL,343,315000,315000,6,63,168,106,0,343,237,106
302,E02000309,ALL,357,189000,192000,3,23,250,81,0,357,278,79
303,E02000311,ALL,451,249000,242000,2,41,211,197,76,375,253,198
304,E02000312,ALL,541,307000,278000,9,73,181,278,14,527,245,296
305,E02000313,ALL,87,149000,160000,2,2,62,21,0,87,66,21
306,E02000314,ALL,323,167000,160000,13,27,176,107,0,323,215,108
307,E02000315,ALL,218,169000,170000,1,18,159,40,4,214,178,40
308,E02000316,ALL,823,250000,250000,2,4,56,761,351,472,45,778
309,E02000317,ALL,184,223000,177000,1,6,80,97,0,184,86,98
310,E02000318,ALL,327,183000,182000,2,35,248,42,1,326,287,40
311,E02000319,ALL,401,185000,185000,0,12,276,113,1,400,289,112
312,E02000320,ALL,241,192000,188000,1,12,206,22,0,241,217,24
313,E02000321,ALL,172,180000,178000,1,8,111,52,0,172,121,51
314,E02000323,ALL,373,215000,208000,2,7,172,192,85,288,180,193
315,E02000324,ALL,252,281000,246000,7,84,79,82,0,252,170,82
316,E02000326,ALL,546,314000,322000,3,44,334,165,20,526,360,186
317,E02000327,ALL,159,207000,180000,2,5,37,115,37,122,43,116
318,E02000328,ALL,654,436000,340000,26,58,92,478,121,533,170,484
319,E02000329,ALL,310,204000,200000,1,96,187,26,0,310,283,27
320,E02000331,ALL,438,258000,230000,6,77,159,196,2,436,242,196
321,E02000332,ALL,449,254000,242000,28,103,208,110,14,435,339,110
322,E02000333,ALL,622,500000,360000,56,76,53,437,7,615,179,443
323,E02000334,ALL,357,257000,245000,9,158,102,88,0,357,269,88
324,E02000335,ALL,455,252000,250000,0,132,275,48,18,437,396,59
325,E02000337,ALL,346,220000,215000,0,114,180,52,2,344,290,56
326,E02000339,ALL,357,322000,290000,21,95,169,72,2,355,272,85
327,E02000340,ALL,488,272000,227000,37,129,95,227,11,477,252,236
328,E02000341,ALL,250,222000,195000,13,70,88,79,0,250,169,81
329,E02000342,ALL,294,236000,232000,4,93,128,69,0,294,223,71
330,E02000343,ALL,343,258000,240000,15,170,73,85,0,343,254,89
331,E02000344,ALL,382,272000,274000,11,215,92,64,2,380,315,67
332,E02000345,ALL,149,357000,315000,4,9,57,79,0,149,61,88
333,E02000346,ALL,388,301000,280000,0,1,3,384,225,163,4,384
334,E02000347,ALL,226,356000,302000,4,11,30,181,0,226,40,186
335,E02000348,ALL,149,323000,250000,3,6,30,110,2,147,38,111
336,E02000350,ALL,494,370000,312000,3,7,108,376,26,468,104,390
337,E02000351,ALL,576,370000,332000,1,14,45,516,43,533,47,529
338,E02000352,ALL,323,375000,332000,3,14,59,247,19,304,72,251
339,E02000353,ALL,483,495000,475000,1,13,253,216,10,473,257,226
340,E02000354,ALL,466,313000,270000,1,7,80,378,13,453,80,386
341,E02000355,ALL,393,400000,375000,3,4,171,215,3,390,171,222
342,E02000356,ALL,486,457000,401000,3,4,162,317,21,465,161,325
343,E02000357,ALL,235,235000,228000,0,2,23,210,104,131,22,213
344,E02000358,ALL,543,368000,335000,1,5,139,398,21,522,118,425
345,E02000359,ALL,375,407000,402000,1,8,222,144,21,354,228,147
346,E02000360,ALL,385,309000,273000,0,5,54,326,62,323,50,335
347,E02000361,ALL,350,328000,286000,1,6,52,291,34,316,53,297
348,E02000362,ALL,310,286000,245000,1,8,103,198,26,284,108,202
349,E02000363,ALL,283,284000,235000,1,3,52,227,39,244,44,239
350,E02000364,ALL,601,449000,371000,6,24,144,427,122,479,168,433
351,E02000365,ALL,1276,418000,350000,6,43,178,1049,595,681,224,1052
352,E02000366,ALL,318,441000,364000,6,13,87,212,6,312,100,218
353,E02000367,ALL,550,392000,345000,7,22,92,429,46,504,106,444
354,E02000368,ALL,340,325000,285000,2,5,46,287,38,302,52,288
355,E02000369,ALL,782,368000,345000,1,8,20,753,290,492,21,761
356,E02000370,ALL,537,468000,398000,0,1,15,521,187,350,15,522
357,E02000371,ALL,791,437000,385000,2,3,17,769,223,568,20,771
358,E02000372,ALL,222,334000,310000,1,14,125,82,0,222,144,78
359,E02000373,ALL,123,269000,225000,0,6,19,98,1,122,25,98
360,E02000374,ALL,354,497000,430000,3,38,175,138,1,353,207,147
361,E02000375,ALL,325,460000,371000,3,1,96,225,6,319,93,232
362,E02000376,ALL,503,485000,350000,2,8,92,401,65,438,100,403
363,E02000377,ALL,506,477000,370000,3,18,148,337,12,494,169,337
364,E02000378,ALL,626,473000,369000,0,2,69,555,14,612,67,559
365,E02000379,ALL,605,567000,395000,12,59,117,417,100,505,178,427
366,E02000380,ALL,421,755000,670000,0,12,231,178,2,419,239,182
367,E02000381,ALL,630,853000,566000,2,7,222,399,2,628,222,408
368,E02000382,ALL,403,658000,425000,7,30,113,253,21,382,147,256
369,E02000383,ALL,612,514000,420000,3,1,35,573,11,601,33,579
370,E02000384,ALL,374,534000,393000,1,10,87,276,56,318,93,281
371,E02000385,ALL,573,487000,426000,4,3,76,490,3,570,76,497
372,E02000386,ALL,375,456000,385000,0,1,54,320,20,355,48,327
373,E02000387,ALL,348,484000,427000,0,1,126,221,2,346,130,218
374,E02000388,ALL,730,617000,510000,1,10,200,519,47,683,203,527
375,E02000389,ALL,642,698000,570000,3,18,258,363,1,641,269,373
376,E02000390,ALL,660,662000,598000,0,6,345,309,10,650,345,315
377,E02000391,ALL,735,1143000,810000,3,8,389,335,8,727,384,351
378,E02000392,ALL,807,865000,630000,6,14,328,459,6,801,338,469
379,E02000393,ALL,736,726000,600000,3,7,309,417,20,716,305,431
380,E02000394,ALL,1144,705000,595000,1,4,142,997,335,809,130,1014
381,E02000395,ALL,613,985000,702000,6,60,165,382,1,612,229,384
382,E02000396,ALL,498,949000,758000,3,6,259,230,7,491,263,235
383,E02000397,ALL,393,279000,250000,5,34,104,250,2,391,135,258
384,E02000398,ALL,165,186000,181000,0,6,86,73,1,164,92,73
385,E02000400,ALL,363,364000,330000,4,69,100,190,7,356,167,196
386,E02000401,ALL,141,228000,230000,0,15,106,20,0,141,119,22
387,E02000402,ALL,146,199000,205000,0,16,81,49,1,145,96,50
388,E02000403,ALL,334,298000,262000,0,27,137,170,1,333,155,179
389,E02000404,ALL,259,254000,250000,0,6,150,103,7,252,154,105
390,E02000405,ALL,446,547000,450000,18,46,169,213,0,446,216,230
391,E02000406,ALL,293,269000,265000,0,5,205,83,6,287,204,89
392,E02000407,ALL,251,210000,190000,1,3,118,129,0,251,117,134
393,E02000408,ALL,161,205000,210000,1,6,110,44,0,161,114,47
394,E02000409,ALL,166,278000,280000,1,2,108,55,1,165,109,57
395,E02000410,ALL,476,597000,419000,6,50,127,293,7,469,172,304
396,E02000411,ALL,357,208000,212000,2,6,121,228,119,238,129,228
397,E02000412,ALL,247,279000,250000,1,15,87,144,31,216,102,145
398,E02000413,ALL,497,603000,415000,26,76,139,256,83,414,233,264
399,E02000414,ALL,302,246000,247000,1,5,210,86,0,302,205,97
400,E02000415,ALL,292,295000,275000,1,2,156,133,3,289,154,138
401,E02000416,ALL,530,334000,290000,1,11,100,418,3,527,103,427
402,E02000417,ALL,454,655000,475000,9,62,124,259,2,452,182,272
403,E02000418,ALL,427,612000,535000,3,42,201,181,34,393,236,191
404,E02000419,ALL,416,360000,321000,1,30,184,201,2,414,198,218
405,E02000420,ALL,253,244000,240000,1,11,156,85,10,243,167,86
406,E02000421,ALL,170,205000,184000,0,3,52,115,5,165,56,114
407,E02000422,ALL,272,252000,245000,0,4,164,104,1,271,161,111
408,E02000423,ALL,304,306000,282000,1,10,170,123,3,301,175,129
409,E02000424,ALL,535,469000,376000,3,13,159,360,3,532,163,372
410,E02000425,ALL,158,321000,330000,0,10,104,44,2,156,112,46
411,E02000426,ALL,475,944000,490000,44,40,104,287,0,475,188,287
412,E02000427,ALL,372,371000,322000,2,9,147,214,0,372,150,222
413,E02000428,ALL,232,246000,240000,2,0,82,148,2,230,76,156
414,E02000429,ALL,666,571000,440000,16,43,102,505,37,629,159,507
415,E02000430,ALL,608,487000,376000,12,41,108,447,17,591,147,461
416,E02000431,ALL,619,597000,427000,15,33,102,469,5,614,136,483
417,E02000432,ALL,477,404000,335000,2,20,79,376,5,472,94,383
418,E02000433,ALL,566,589000,390000,166,45,52,303,43,523,256,310
419,E02000434,ALL,665,366000,330000,72,156,30,407,219,446,259,406
420,E02000435,ALL,388,390000,332000,44,139,80,125,17,371,250,138
421,E02000436,ALL,301,534000,480000,130,118,14,39,0,301,262,39
422,E02000437,ALL,453,321000,302000,64,223,66,100,16,437,351,102
423,E02000438,ALL,476,346000,258000,57,143,55,221,28,448,255,221
424,E02000439,ALL,288,274000,282000,3,179,36,70,14,274,219,69
425,E02000440,ALL,441,388000,365000,49,266,76,50,10,431,391,50
426,E02000441,ALL,439,399000,300000,114,85,56,184,9,430,254,185
427,E02000442,ALL,282,286000,286000,1,100,157,24,3,279,256,26
428,E02000443,ALL,414,251000,250000,6,111,171,126,20,394,287,127
429,E02000444,ALL,295,314000,330000,13,167,39,76,1,294,219,76
430,E02000445,ALL,491,243000,240000,14,105,157,215,51,440,273,218
431,E02000447,ALL,359,339000,350000,27,195,56,81,19,340,278,81
432,E02000448,ALL,455,510000,460000,151,88,46,170,7,448,273,182
433,E02000449,ALL,202,285000,288000,1,33,141,27,12,190,176,26
434,E02000451,ALL,346,370000,380000,53,163,66,64,0,346,272,74
435,E02000452,ALL,413,255000,230000,10,109,48,246,10,403,160,253
436,E02000453,ALL,516,266000,246000,10,102,102,302,115,401,208,308
437,E02000454,ALL,439,436000,419000,84,237,61,57,0,439,379,60
438,E02000455,ALL,471,279000,250000,20,79,44,328,26,445,140,331
439,E02000456,ALL,334,305000,320000,11,106,121,96,9,325,231,103
440,E02000457,ALL,291,364000,360000,44,193,18,36,3,288,255,36
441,E02000459,ALL,579,235000,205000,16,82,123,358,137,442,215,364
442,E02000460,ALL,309,247000,235000,3,37,131,138,97,212,170,139
443,E02000461,ALL,436,365000,315000,35,50,100,251,3,433,177,259
444,E02000462,ALL,299,252000,265000,7,102,94,96,24,275,203,96
445,E02000463,ALL,295,261000,250000,2,98,148,47,6,289,247,48
446,E02000464,ALL,433,206000,183000,19,109,223,82,145,288,350,83
447,E02000465,ALL,355,178000,176000,5,113,199,38,3,352,316,39
448,E02000466,ALL,439,224000,206000,45,194,110,90,4,435,346,93
449,E02000467,ALL,365,157000,160000,0,86,201,78,25,340,286,79
450,E02000468,ALL,454,218000,213000,35,205,188,26,5,449,429,25
451,E02000469,ALL,292,182000,176000,24,88,143,37,4,288,256,36
452,E02000470,ALL,655,250000,235000,63,281,199,112,61,594,539,116
453,E02000471,ALL,471,294000,270000,47,317,90,17,4,467,454,17
454,E02000472,ALL,565,222000,220000,36,195,261,73,5,560,489,76
455,E02000473,ALL,643,257000,246000,65,261,209,108,24,619,536,107
456,E02000474,ALL,595,201000,205000,37,169,218,171,55,540,422,173
457,E02000475,ALL,680,327000,280000,169,180,54,277,34,646,397,283
458,E02000476,ALL,644,195000,170000,27,117,81,419,94,550,221,423
459,E02000477,ALL,677,279000,265000,90,254,237,96,45,632,582,95
460,E02000478,ALL,335,621000,525000,241,55,13,26,6,329,309,26
461,E02000479,ALL,686,208000,205000,28,231,209,218,61,625,469,217
462,E02000480,ALL,848,191000,185000,25,159,295,369,273,575,478,370
463,E02000481,ALL,545,256000,246000,58,212,164,111,29,516,432,113
464,E02000482,ALL,438,418000,353000,77,283,28,50,4,434,387,51
465,E02000483,ALL,534,231000,228000,29,206,95,204,1,533,322,212
466,E02000484,ALL,554,259000,240000,67,156,267,64,63,491,492,62
467,E02000485,ALL,636,262000,250000,33,347,74,182,10,626,447,189
468,E02000486,ALL,462,231000,230000,12,239,140,71,0,462,388,74
469,E02000487,ALL,464,429000,420000,116,282,55,11,6,458,454,10
470,E02000488,ALL,482,251000,250000,20,294,140,28,0,482,457,25
471,E02000489,ALL,464,220000,217000,20,148,233,63,44,420,399,65
472,E02000490,ALL,405,204000,205000,25,137,221,22,4,401,382,23
473,E02000491,ALL,454,191000,190000,75,122,175,82,13,441,370,84
474,E02000492,ALL,372,232000,227000,119,146,82,25,16,356,346,26
475,E02000493,ALL,345,179000,180000,15,113,150,67,23,322,277,68
476,E02000494,ALL,507,598000,460000,259,36,66,146,25,482,353,154
477,E02000495,ALL,736,323000,293000,112,177,98,349,33,703,375,361
478,E02000496,ALL,476,287000,250000,65,163,134,114,16,460,366,110
479,E02000497,ALL,764,345000,320000,136,211,160,257,197,567,494,270
480,E02000498,ALL,497,347000,318000,127,156,96,118,60,437,375,122
481,E02000499,ALL,496,386000,365000,99,268,19,110,9,487,380,116
482,E02000500,ALL,642,408000,370000,257,100,28,257,142,500,387,255
483,E02000501,ALL,594,312000,305000,60,264,191,79,21,573,509,85
484,E02000502,ALL,746,312000,269000,91,192,182,281,97,649,452,294
485,E02000503,ALL,617,282000,278000,17,63,474,63,13,604,551,66
486,E02000504,ALL,527,400000,380000,182,247,35,63,19,508,455,72
487,E02000506,ALL,499,434000,415000,271,80,39,109,104,395,392,107
488,E02000507,ALL,417,253000,250000,3,114,254,46,2,415,367,50
489,E02000508,ALL,634,244000,216000,60,111,105,358,139,495,274,360
490,E02000509,ALL,476,222000,205000,20,125,101,230,101,375,240,236
491,E02000510,ALL,475,281000,265000,92,193,119,71,9,466,395,80
492,E02000511,ALL,470,235000,250000,7,311,68,84,0,470,386,84
493,E02000512,ALL,361,234000,230000,49,116,118,78,0,361,275,86
494,E02000513,ALL,363,197000,200000,6,118,93,146,0,363,215,148
495,E02000514,ALL,372,227000,227000,5,164,168,35,0,372,332,40
496,E02000515,ALL,821,206000,195000,50,173,160,438,175,646,381,440
497,E02000516,ALL,315,230000,233000,24,108,143,40,0,315,271,44
498,E02000517,ALL,541,225000,219000,14,170,163,194,194,347,345,196
499,E02000518,ALL,393,227000,234000,18,186,99,90,17,376,294,99
500,E02000519,ALL,232,230000,237000,13,111,69,39,2,230,188,44
501,E02000520,ALL,505,231000,238000,6,196,179,124,121,384,378,127
502,E02000521,ALL,723,234000,232000,7,173,208,335,357,366,384,339
503,E02000522,ALL,440,239000,230000,54,167,101,118,1,439,321,119
504,E02000523,ALL,677,214000,215000,10,174,94,399,323,354,274,403
505,E02000524,ALL,342,242000,242000,50,116,85,91,6,336,251,91
506,E02000525,ALL,387,202000,200000,5,115,117,150,19,368,232,155
507,E02000526,ALL,665,837000,650000,12,148,204,301,21,644,353,312
508,E02000528,ALL,968,330000,280000,2,44,85,837,429,539,126,842
509,E02000529,ALL,257,247000,249000,10,95,64,88,15,242,155,102
510,E02000530,ALL,165,196000,189000,2,36,55,72,20,145,93,72
511,E02000531,ALL,642,332000,300000,6,73,240,323,24,618,310,332
512,E02000532,ALL,684,762000,650000,33,148,221,282,24,660,395,289
513,E02000533,ALL,694,646000,485000,26,83,229,356,12,682,326,368
514,E02000534,ALL,463,352000,308000,34,147,62,220,49,414,235,228
515,E02000535,ALL,245,278000,282000,11,150,45,39,2,243,200,45
516,E02000536,ALL,255,290000,282000,11,160,44,40,1,254,209,46
517,E02000537,ALL,385,355000,310000,24,142,127,92,63,322,296,89
518,E02000538,ALL,213,249000,248000,8,64,81,60,39,174,153,60
519,E02000539,ALL,899,280000,250000,8,88,342,461,172,727,434,465
520,E02000540,ALL,415,281000,248000,12,122,114,167,5,410,241,174
521,E02000541,ALL,173,238000,233000,3,44,67,59,34,139,111,62
522,E02000542,ALL,278,230000,228000,8,69,73,128,48,230,149,129
523,E02000543,ALL,416,248000,230000,24,93,112,187,6,410,229,187
524,E02000544,ALL,359,289000,283000,12,202,107,38,9,350,318,41
525,E02000545,ALL,488,319000,280000,8,102,190,188,13,475,290,198
526,E02000546,ALL,272,235000,238000,7,80,104,81,18,254,186,86
527,E02000547,ALL,442,212000,218000,18,218,82,124,1,441,312,130
528,E02000548,ALL,432,198000,198000,15,150,106,161,30,402,254,178
529,E02000549,ALL,542,226000,230000,19,256,159,108,10,532,427,115
530,E02000550,ALL,415,200000,205000,6,103,169,137,4,411,275,140
531,E02000551,ALL,301,194000,197000,3,58,154,86,0,301,211,90
532,E02000552,ALL,545,198000,205000,30,120,200,195,5,540,338,207
533,E02000553,ALL,400,236000,225000,21,157,150,72,5,395,328,72
534,E02000554,ALL,403,372000,315000,4,9,59,331,2,401,67,336
535,E02000555,ALL,545,463000,355000,3,16,167,359,31,514,177,368
536,E02000556,ALL,638,382000,336000,3,9,163,463,30,608,166,472
537,E02000557,ALL,467,406000,335000,2,14,92,359,25,442,103,364
538,E02000558,ALL,295,293000,250000,0,2,35,258,72,223,37,258
539,E02000559,ALL,1083,488000,425000,3,14,237,829,445,638,255,828
540,E02000560,ALL,610,345000,305000,0,2,93,515,134,476,92,518
541,E02000561,ALL,542,571000,440000,4,30,135,373,4,538,162,380
542,E02000562,ALL,608,567000,423000,6,15,90,497,68,540,107,501
543,E02000563,ALL,411,344000,295000,3,12,31,365,14,397,46,365
544,E02000564,ALL,808,384000,361000,1,15,39,753,126,682,53,755
545,E02000565,ALL,370,400000,335000,2,4,44,320,16,354,40,330
546,E02000566,ALL,733,652000,475000,8,18,184,523,128,605,200,533
547,E02000567,ALL,913,475000,400000,7,14,117,775,154,759,120,793
548,E02000568,ALL,493,358000,337000,3,5,56,429,155,338,60,433
549,E02000569,ALL,522,680000,444000,4,29,93,396,0,522,121,401
550,E02000570,ALL,943,693000,520000,14,10,227,692,230,713,244,699
551,E02000571,ALL,621,528000,445000,2,17,170,432,123,498,184,437
552,E02000572,ALL,246,373000,320000,0,4,25,217,28,218,26,220
553,E02000573,ALL,726,759000,588000,5,16,256,449,54,672,258,468
554,E02000574,ALL,530,564000,500000,2,2,45,481,49,481,44,486
555,E02000575,ALL,960,576000,515000,5,0,43,912,115,845,47,913
556,E02000576,ALL,917,542000,475000,1,1,4,911,328,589,4,913
557,E02000577,ALL,192,452000,374000,0,0,12,180,76,116,12,180
558,E02000578,ALL,175,529000,459000,0,2,21,152,46,129,24,151
559,E02000579,ALL,538,846000,586000,9,13,141,375,7,531,163,375
560,E02000580,ALL,451,849000,580000,0,1,74,376,4,447,64,387
561,E02000581,ALL,146,863000,472000,1,3,47,95,1,145,50,96
562,E02000582,ALL,631,1386000,850000,7,6,100,518,0,631,111,520
563,E02000583,ALL,658,1795000,838000,3,13,206,436,5,653,220,438
564,E02000584,ALL,750,1833000,1161000,4,5,199,542,7,743,206,544
565,E02000585,ALL,611,1525000,710000,10,3,120,478,1,610,120,491
566,E02000586,ALL,649,1759000,1330000,0,10,90,549,2,647,102,547
567,E02000587,ALL,638,1865000,1125000,0,25,147,466,1,637,173,465
568,E02000588,ALL,865,2127000,1550000,3,4,185,673,7,858,183,682
569,E02000589,ALL,843,1140000,850000,5,1,78,759,1,842,81,762
570,E02000590,ALL,678,1322000,692000,2,5,115,556,0,678,117,561
571,E02000591,ALL,544,781000,640000,0,1,16,527,59,485,14,530
572,E02000592,ALL,758,1478000,1122000,2,3,86,667,1,757,80,678
573,E02000593,ALL,855,989000,670000,0,2,42,811,13,842,39,816
574,E02000594,ALL,731,1640000,1075000,2,2,167,560,1,730,162,569
575,E02000595,ALL,745,1795000,925000,3,18,200,524,9,736,210,535
576,E02000596,ALL,866,1271000,785000,1,12,136,717,1,865,145,721
577,E02000597,ALL,434,886000,650000,1,6,74,353,13,421,72,362
578,E02000598,ALL,545,499000,440000,90,175,166,114,7,538,424,121
579,E02000599,ALL,399,1109000,780000,222,104,26,47,3,396,349,50
580,E02000600,ALL,645,412000,315000,58,145,122,320,9,636,322,323
581,E02000601,ALL,1026,425000,384000,131,265,112,518,182,844,512,514
582,E02000602,ALL,683,331000,295000,54,207,120,302,13,670,381,302
583,E02000603,ALL,363,326000,280000,12,135,144,72,4,359,289,74
584,E02000604,ALL,583,376000,337000,44,165,196,178,11,572,405,178
585,E02000605,ALL,635,382000,338000,72,244,177,142,9,626,487,148
586,E02000606,ALL,1104,356000,308000,53,140,75,836,51,1053,261,843
587,E02000607,ALL,555,395000,360000,72,207,91,185,10,545,361,194
588,E02000608,ALL,819,324000,285000,13,75,77,654,77,742,160,659
589,E02000609,ALL,378,381000,360000,87,177,37,77,8,370,302,76
590,E02000610,ALL,776,331000,270000,49,70,102,555,15,761,218,558
591,E02000611,ALL,434,429000,412000,83,322,11,18,1,433,416,18
592,E02000612,ALL,556,367000,358000,74,251,142,89,1,555,466,90
593,E02000613,ALL,785,365000,290000,103,217,159,306,28,757,474,311
594,E02000614,ALL,580,273000,250000,14,186,258,122,35,545,456,124
595,E02000615,ALL,494,268000,250000,46,246,105,97,15,479,397,97
596,E02000616,ALL,457,247000,245000,26,65,305,61,3,454,394,63
597,E02000617,ALL,569,263000,250000,69,185,173,142,5,564,428,141
598,E02000619,ALL,370,412000,321000,0,6,67,297,58,312,69,301
599,E02000620,ALL,553,480000,395000,1,3,95,454,24,529,99,454
600,E02000621,ALL,890,630000,422000,2,4,95,789,273,617,89,801
601,E02000622,ALL,459,383000,320000,5,5,108,341,2,457,111,348
602,E02000623,ALL,254,359000,255000,3,7,39,205,4,250,46,208
603,E02000624,ALL,561,380000,330000,5,10,43,503,111,450,40,521
604,E02000625,ALL,431,299000,275000,3,2,17,409,98,333,20,411
605,E02000626,ALL,208,288000,240000,0,3,38,167,5,203,39,169
606,E02000627,ALL,488,381000,325000,4,13,113,358,11,477,121,367
607,E02000628,ALL,282,276000,249000,1,2,25,254,31,251,25,257
608,E02000629,ALL,828,458000,379000,5,25,147,651,66,762,163,665
609,E02000630,ALL,630,617000,415000,9,16,165,440,27,603,181,449
610,E02000631,ALL,578,422000,340000,17,48,196,317,8,570,252,326
611,E02000632,ALL,1058,393000,364000,3,6,207,842,141,917,202,856
612,E02000633,ALL,420,339000,312000,1,1,71,347,12,408,72,348
613,E02000634,ALL,416,432000,360000,3,10,52,351,32,384,63,353
614,E02000635,ALL,643,384000,335000,4,27,191,421,110,533,216,427
615,E02000636,ALL,879,695000,500000,5,79,305,490,44,835,374,505
616,E02000637,ALL,720,353000,322000,1,27,183,509,23,697,203,517
617,E02000638,ALL,571,305000,270000,2,13,133,423,13,558,140,431
618,E02000639,ALL,310,267000,220000,1,21,8,280,26,284,30,280
619,E02000640,ALL,890,481000,440000,10,31,280,569,12,878,291,599
620,E02000641,ALL,290,261000,247000,0,4,54,232,18,272,57,233
621,E02000642,ALL,647,377000,317000,10,52,182,403,23,624,229,418
622,E02000643,ALL,685,389000,318000,3,68,114,500,5,680,170,515
623,E02000644,ALL,646,321000,276000,17,114,101,414,17,629,227,419
624,E02000645,ALL,732,367000,275000,8,100,190,434,23,709,291,441
625,E02000646,ALL,775,337000,272000,30,74,136,535,23,752,224,551
626,E02000647,ALL,534,312000,276000,21,101,94,318,5,529,214,320
627,E02000648,ALL,381,246000,230000,2,33,136,210,23,358,172,209
628,E02000649,ALL,872,301000,250000,18,70,136,648,12,860,219,653
629,E02000650,ALL,523,295000,265000,7,61,99,356,9,514,161,362
630,E02000651,ALL,519,322000,275000,7,90,121,301,24,495,219,300
631,E02000652,ALL,270,261000,250000,1,8,227,34,0,270,237,33
632,E02000653,ALL,357,272000,250000,0,7,91,259,55,302,83,274
633,E02000654,ALL,220,201000,181000,3,0,20,197,48,172,22,198
634,E02000655,ALL,396,220000,194000,2,4,124,266,25,371,127,269
635,E02000657,ALL,612,299000,250000,5,18,170,419,164,448,186,426
636,E02000658,ALL,427,351000,265000,1,44,106,276,10,417,142,285
637,E02000659,ALL,589,422000,315000,28,56,87,418,59,530,166,423
638,E02000660,ALL,705,295000,250000,11,29,89,576,86,619,123,582
639,E02000661,ALL,518,405000,330000,10,22,132,354,19,499,150,368
640,E02000662,ALL,389,295000,250000,0,23,150,216,15,374,168,221
641,E02000663,ALL,460,311000,278000,6,32,196,226,16,444,220,240
642,E02000664,ALL,1187,227000,206000,7,35,120,1025,586,601,156,1031
643,E02000665,ALL,554,330000,290000,10,42,286,216,31,523,337,217
644,E02000666,ALL,411,303000,275000,3,44,189,175,3,408,231,180
645,E02000667,ALL,488,324000,310000,2,40,322,124,2,486,362,126
646,E02000668,ALL,478,317000,285000,10,82,225,161,5,473,309,169
647,E02000669,ALL,561,250000,230000,3,23,214,321,7,554,235,326
648,E02000670,ALL,294,221000,200000,5,23,105,161,3,291,126,168
649,E02000671,ALL,709,303000,272000,15,46,312,336,18,691,360,349
650,E02000672,ALL,398,237000,215000,4,44,156,194,5,393,200,198
651,E02000673,ALL,618,364000,282000,45,119,90,364,13,605,242,376
652,E02000674,ALL,472,257000,249000,3,19,342,108,5,467,341,131
653,E02000675,ALL,498,260000,247000,23,148,182,145,1,497,347,151
654,E02000676,ALL,635,308000,273000,15,52,240,328,9,626,295,340
655,E02000677,ALL,332,287000,260000,9,103,106,114,1,331,214,118
656,E02000678,ALL,335,189000,184000,0,19,212,104,44,291,231,104
657,E02000679,ALL,509,275000,248000,25,43,163,278,48,461,226,283
658,E02000680,ALL,420,292000,243000,10,47,123,240,7,413,177,243
659,E02000681,ALL,301,228000,220000,3,64,158,76,0,301,227,74
660,E02000682,ALL,328,226000,235000,4,103,154,67,2,326,258,70
661,E02000683,ALL,304,201000,191000,4,51,148,101,6,298,200,104
662,E02000685,ALL,440,263000,238000,10,47,124,259,7,433,171,269
663,E02000686,ALL,221,192000,190000,0,32,71,118,19,202,102,119
664,E02000687,ALL,479,299000,260000,10,55,200,214,1,478,260,219
665,E02000689,ALL,867,567000,440000,34,67,388,378,106,761,485,382
666,E02000690,ALL,437,1751000,1150000,165,56,90,126,10,427,292,145
667,E02000691,ALL,697,565000,410000,17,155,143,382,70,627,305,392
668,E02000692,ALL,812,778000,481000,83,90,111,528,39,773,265,547
669,E02000693,ALL,825,285000,250000,4,66,205,550,3,822,242,583
670,E02000694,ALL,904,452000,415000,10,91,537,266,5,899,631,273
671,E02000695,ALL,352,297000,280000,9,24,276,43,3,349,310,42
672,E02000696,ALL,488,223000,215000,2,18,200,268,5,483,204,284
673,E02000697,ALL,794,460000,425000,16,96,341,341,14,780,442,352
674,E02000698,ALL,701,736000,585000,134,174,148,245,15,686,447,254
675,E02000699,ALL,758,445000,386000,19,109,336,294,12,746,440,318
676,E02000700,ALL,410,220000,215000,4,19,168,219,10,400,194,216
677,E02000701,ALL,351,221000,225000,8,41,215,87,10,341,262,89
678,E02000702,ALL,453,210000,210000,4,34,191,224,79,374,230,223
679,E02000703,ALL,565,470000,425000,27,175,208,155,5,560,409,156
680,E02000704,ALL,790,327000,291000,16,113,237,424,80,710,357,433
681,E02000705,ALL,555,252000,245000,1,52,398,104,155,400,447,108
682,E02000706,ALL,338,202000,197000,11,22,179,126,37,301,208,130
683,E02000707,ALL,247,211000,220000,0,28,183,36,2,245,209,38
684,E02000708,ALL,621,347000,340000,15,95,363,148,80,541,458,163
685,E02000709,ALL,467,330000,328000,5,102,281,79,0,467,378,89
686,E02000710,ALL,384,238000,228000,22,94,115,153,18,366,232,152
687,E02000711,ALL,707,223000,211000,7,41,303,356,266,441,352,355
688,E02000712,ALL,383,229000,224000,0,35,264,84,0,383,296,87
689,E02000713,ALL,484,263000,265000,3,87,303,91,0,484,390,94
690,E02000714,ALL,237,241000,222000,3,12,167,55,0,237,181,56
691,E02000715,ALL,151,196000,205000,0,1,114,36,1,150,116,35
692,E02000716,ALL,229,236000,215000,0,6,163,60,0,229,167,62
693,E02000717,ALL,181,197000,198000,0,0,108,73,3,178,107,74
694,E02000718,ALL,182,173000,170000,0,4,84,94,38,144,87,95
695,E02000719,ALL,236,226000,225000,1,19,117,99,0,236,134,102
696,E02000720,ALL,187,279000,250000,5,4,149,29,0,187,158,29
697,E02000721,ALL,192,222000,202000,5,11,93,83,6,186,111,81
698,E02000722,ALL,296,245000,241000,3,8,146,139,8,288,156,140
699,E02000723,ALL,176,231000,240000,2,1,151,22,2,174,153,23
700,E02000724,ALL,207,208000,219000,0,5,151,51,16,191,156,51
701,E02000725,ALL,385,229000,230000,0,5,170,210,35,350,175,210
702,E02000726,ALL,726,243000,240000,0,4,92,630,344,382,94,632
703,E02000727,ALL,149,210000,220000,1,1,100,47,2,147,102,47
704,E02000728,ALL,208,212000,225000,0,2,169,37,0,208,167,41
705,E02000729,ALL,171,250000,249000,0,13,97,61,0,171,111,60
706,E02000730,ALL,142,221000,233000,0,7,99,36,1,141,107,35
707,E02000731,ALL,225,203000,220000,1,0,168,56,7,218,168,57
708,E02000732,ALL,142,195000,210000,0,4,104,34,0,142,107,35
709,E02000733,ALL,282,209000,220000,0,5,168,109,9,273,172,110
710,E02000734,ALL,141,214000,216000,0,4,91,46,0,141,94,47
711,E02000735,ALL,200,194000,196000,0,1,136,63,8,192,134,66
712,E02000736,ALL,234,199000,206000,0,10,188,36,0,234,195,39
713,E02000737,ALL,298,201000,205000,0,4,252,42,1,297,254,44
714,E02000738,ALL,276,215000,220000,1,9,247,19,1,275,258,18
715,E02000739,ALL,175,205000,210000,0,7,133,35,1,174,138,37
716,E02000740,ALL,160,196000,194000,1,17,79,63,1,159,96,64
717,E02000741,ALL,259,195000,195000,2,5,201,51,3,256,209,50
718,E02000742,ALL,301,197000,200000,0,8,237,56,2,299,245,56
719,E02000743,ALL,235,217000,210000,0,5,92,138,71,164,95,140
720,E02000744,ALL,301,188000,180000,1,7,161,132,57,244,168,133
721,E02000745,ALL,241,210000,215000,9,33,153,46,0,241,192,49
722,E02000746,ALL,305,236000,248000,4,10,58,233,132,173,71,234
723,E02000747,ALL,548,267000,248000,1,3,78,466,164,384,82,466
724,E02000748,ALL,219,202000,200000,10,23,141,45,0,219,173,46
725,E02000749,ALL,251,202000,200000,0,5,128,118,82,169,124,127
726,E02000750,ALL,753,263000,250000,1,1,110,641,205,548,62,691
727,E02000751,ALL,846,481000,415000,234,188,101,323,41,805,518,328
728,E02000752,ALL,370,206000,210000,0,154,155,61,13,357,310,60
729,E02000753,ALL,365,233000,225000,14,92,203,56,0,365,310,55
730,E02000754,ALL,451,305000,305000,11,140,221,79,10,441,369,82
731,E02000755,ALL,368,262000,250000,13,72,214,69,4,364,296,72
732,E02000756,ALL,852,294000,250000,48,183,394,227,10,842,619,233
733,E02000757,ALL,1043,322000,280000,38,197,206,602,157,886,429,614
734,E02000758,ALL,342,271000,274000,21,195,73,53,3,339,287,55
735,E02000759,ALL,788,306000,300000,15,200,321,252,29,759,521,267
736,E02000760,ALL,387,251000,250000,14,113,161,99,3,384,284,103
737,E02000762,ALL,334,323000,338000,18,119,117,80,21,313,253,81
738,E02000763,ALL,360,245000,246000,7,72,166,115,58,302,244,116
739,E02000764,ALL,969,367000,280000,55,150,207,557,11,958,406,563
740,E02000765,ALL,281,280000,288000,3,56,149,73,19,262,206,75
741,E02000767,ALL,330,260000,250000,7,39,216,68,2,328,263,67
742,E02000768,ALL,400,471000,422000,26,149,127,98,23,377,302,98
743,E02000769,ALL,711,218000,232000,10,152,366,183,11,700,531,180
744,E02000770,ALL,294,238000,250000,4,49,159,82,1,293,209,85
745,E02000772,ALL,373,229000,240000,7,24,204,138,88,285,232,141
746,E02000773,ALL,398,245000,238000,1,15,215,167,121,277,227,171
747,E02000774,ALL,202,247000,250000,3,27,145,27,1,201,171,31
748,E02000776,ALL,217,260000,250000,5,17,125,70,0,217,143,74
749,E02000777,ALL,322,383000,411000,13,68,134,107,0,322,214,108
750,E02000779,ALL,225,232000,205000,1,11,102,111,1,224,109,116
751,E02000780,ALL,539,212000,213000,1,12,286,240,147,392,288,251
752,E02000781,ALL,611,271000,250000,28,85,403,95,53,558,518,93
753,E02000782,ALL,424,203000,205000,1,2,180,241,131,293,182,242
754,E02000783,ALL,184,206000,215000,0,1,145,38,0,184,146,38
755,E02000784,ALL,804,1090000,864000,36,205,230,333,1,803,459,345
756,E02000785,ALL,848,718000,593000,64,134,305,345,11,837,502,346
757,E02000786,ALL,1237,651000,515000,22,79,586,550,60,1177,656,581
758,E02000787,ALL,942,534000,455000,20,124,338,460,42,900,474,468
759,E02000788,ALL,900,659000,615000,39,262,327,272,12,888,630,270
760,E02000789,ALL,640,740000,490000,73,65,174,328,1,639,304,336
761,E02000790,ALL,666,689000,542000,40,105,265,256,40,626,395,271
762,E02000791,ALL,707,906000,540000,24,82,120,481,21,686,212,495
763,E02000792,ALL,663,683000,462000,32,96,148,387,13,650,272,391
764,E02000793,ALL,455,323000,312000,33,163,156,103,5,450,356,99
765,E02000794,ALL,617,451000,371000,47,209,156,205,5,612,407,210
766,E02000795,ALL,534,945000,830000,127,121,168,118,2,532,413,121
767,E02000796,ALL,541,315000,308000,30,329,77,105,2,539,436,105
768,E02000797,ALL,849,431000,376000,15,79,442,313,19,830,530,319
769,E02000798,ALL,937,375000,348000,25,212,440,260,21,916,664,273
770,E02000799,ALL,523,595000,478000,40,132,133,218,6,517,297,226
771,E02000800,ALL,319,363000,345000,9,48,149,113,7,312,202,117
772,E02000801,ALL,711,498000,425000,42,107,274,288,33,678,422,289
773,E02000802,ALL,678,475000,400000,69,155,192,262,10,668,409,269
774,E02000803,ALL,649,342000,290000,84,187,257,121,2,647,527,122
775,E02000804,ALL,660,510000,420000,31,117,252,260,13,647,393,267
776,E02000805,ALL,1155,499000,392000,90,170,185,710,192,963,431,724
777,E02000806,ALL,801,456000,388000,115,215,238,233,21,780,567,234
778,E02000807,ALL,849,372000,355000,4,24,162,659,80,769,188,661
779,E02000808,ALL,822,672000,476000,0,2,10,810,213,609,12,810
780,E02000809,ALL,1452,571000,470000,0,2,23,1427,113,1339,19,1433
781,E02000810,ALL,842,338000,310000,0,5,63,774,387,455,67,775
782,E02000812,ALL,589,399000,349000,1,2,24,562,96,493,24,565
783,E02000813,ALL,833,349000,321000,1,3,46,783,494,339,46,787
784,E02000814,ALL,664,340000,318000,4,15,114,531,6,658,126,538
785,E02000815,ALL,314,395000,300000,0,1,10,303,27,287,3,311
786,E02000816,ALL,407,244000,215000,1,8,98,300,5,402,103,304
787,E02000817,ALL,232,272000,280000,1,4,27,200,86,146,34,198
788,E02000818,ALL,247,309000,268000,4,2,38,203,5,242,46,201
789,E02000819,ALL,300,250000,230000,2,5,74,219,22,278,79,221
790,E02000820,ALL,837,345000,317000,0,7,68,762,403,434,74,763
791,E02000821,ALL,136,273000,212000,0,7,26,103,4,132,32,104
792,E02000822,ALL,147,241000,228000,0,3,35,109,1,146,35,112
793,E02000823,ALL,430,327000,300000,3,8,80,339,98,332,85,345
794,E02000824,ALL,145,223000,210000,1,0,26,118,3,142,27,118
795,E02000825,ALL,217,213000,195000,0,2,29,186,7,210,28,189
796,E02000826,ALL,342,289000,250000,0,3,94,245,19,323,96,246
797,E02000827,ALL,273,258000,224000,1,4,29,239,36,237,31,242
798,E02000828,ALL,262,251000,225000,0,8,95,159,2,260,100,162
799,E02000829,ALL,446,281000,250000,3,7,159,277,29,417,166,280
800,E02000830,ALL,710,420000,318000,9,29,199,473,73,637,220,490
801,E02000831,ALL,697,394000,350000,8,61,310,318,21,676,377,320
802,E02000832,ALL,486,301000,271000,5,25,199,257,9,477,224,262
803,E02000833,ALL,422,299000,240000,3,30,94,295,11,411,117,305
804,E02000834,ALL,863,429000,365000,15,104,300,444,13,850,413,450
805,E02000835,ALL,632,365000,323000,4,67,244,317,57,575,309,323
806,E02000836,ALL,781,498000,445000,4,112,373,292,5,776,479,302
807,E02000837,ALL,604,818000,745000,34,171,240,159,3,601,399,205
808,E02000838,ALL,816,393000,320000,14,117,213,472,14,802,339,477
809,E02000839,ALL,562,438000,280000,65,45,102,350,7,555,196,366
810,E02000840,ALL,344,192000,195000,6,22,241,75,28,316,270,74
811,E02000841,ALL,339,197000,198000,2,15,270,52,0,339,285,54
812,E02000842,ALL,451,268000,260000,13,223,143,72,5,446,379,72
813,E02000843,ALL,625,194000,180000,14,89,139,383,55,570,238,387
814,E02000844,ALL,506,221000,220000,14,107,297,88,0,506,411,95
815,E02000845,ALL,769,303000,275000,35,129,418,187,97,672,580,189
816,E02000846,ALL,416,252000,249000,19,167,140,90,1,415,327,89
817,E02000847,ALL,713,295000,275000,70,265,253,125,13,700,584,129
818,E02000848,ALL,496,271000,270000,14,114,261,107,6,490,386,110
819,E02000849,ALL,548,239000,235000,20,182,169,177,0,548,367,181
820,E02000850,ALL,705,242000,242000,31,233,308,133,3,702,573,132
821,E02000851,ALL,678,193000,180000,12,107,115,444,18,660,232,446
822,E02000852,ALL,613,235000,230000,26,172,194,221,13,600,392,221
823,E02000853,ALL,621,237000,235000,27,132,282,180,15,606,443,178
824,E02000854,ALL,580,289000,270000,69,187,170,154,42,538,421,159
825,E02000855,ALL,539,379000,350000,82,226,110,121,1,538,417,122
826,E02000856,ALL,723,249000,200000,57,175,96,395,125,598,321,402
827,E02000857,ALL,853,226000,204000,32,33,101,687,33,820,162,691
828,E02000858,ALL,275,218000,205000,13,43,110,109,18,257,164,111
829,E02000859,ALL,646,288000,240000,94,148,90,314,26,620,338,308
830,E02000860,ALL,774,202000,175000,15,25,51,683,21,753,86,688
831,E02000861,ALL,481,442000,428000,199,162,22,98,6,475,384,97
832,E02000863,ALL,436,350000,345000,134,137,68,97,87,349,340,96
833,E02000864,ALL,390,294000,263000,1,7,63,319,17,373,71,319
834,E02000865,ALL,225,294000,256000,0,2,14,209,16,209,10,215
835,E02000866,ALL,619,417000,380000,2,10,256,351,51,568,258,361
836,E02000867,ALL,955,285000,265000,1,5,85,864,252,703,91,864
837,E02000868,ALL,447,322000,310000,1,1,20,425,121,326,19,428
838,E02000869,ALL,242,424000,372000,0,0,82,160,16,226,80,162
839,E02000870,ALL,324,291000,250000,1,1,41,281,20,304,42,282
840,E02000871,ALL,526,257000,247000,0,0,13,513,354,172,12,514
841,E02000872,ALL,560,395000,355000,0,0,14,546,238,322,14,546
842,E02000873,ALL,270,301000,295000,1,0,28,241,27,243,29,241
843,E02000874,ALL,183,277000,250000,1,0,18,164,16,167,16,167
844,E02000875,ALL,1039,269000,248000,0,3,29,1007,600,439,26,1013
845,E02000876,ALL,327,279000,250000,0,0,37,290,21,306,33,294
846,E02000877,ALL,572,277000,260000,0,2,49,521,320,252,51,521
847,E02000878,ALL,534,485000,400000,2,3,35,494,52,482,40,494
848,E02000879,ALL,324,311000,266000,0,4,41,279,88,236,43,281
849,E02000880,ALL,314,278000,248000,0,1,26,287,41,273,29,285
850,E02000881,ALL,248,264000,247000,0,1,33,214,100,148,32,216
851,E02000882,ALL,431,308000,290000,0,2,65,364,215,216,65,366
852,E02000883,ALL,286,247000,238000,0,4,19,263,116,170,17,269
853,E02000884,ALL,1036,436000,388000,1,3,35,997,517,519,38,998
854,E02000885,ALL,175,288000,248000,0,1,13,161,21,154,14,161
855,E02000886,ALL,687,397000,340000,1,1,36,649,126,561,34,653
856,E02000887,ALL,372,259000,247000,0,3,34,335,107,265,33,339
857,E02000888,ALL,629,400000,359000,2,2,13,612,127,502,14,615
858,E02000889,ALL,646,378000,325000,1,0,64,581,225,421,56,590
859,E02000890,ALL,649,602000,480000,3,1,22,623,8,641,21,628
860,E02000891,ALL,1672,364000,326000,3,3,63,1603,664,1008,73,1599
861,E02000893,ALL,352,320000,285000,1,10,71,270,2,350,76,276
862,E02000894,ALL,921,341000,320000,1,13,143,764,43,878,136,785
863,E02000895,ALL,448,278000,270000,18,224,110,96,9,439,349,99
864,E02000896,ALL,621,319000,288000,40,180,174,227,2,619,389,232
865,E02000897,ALL,477,275000,242000,20,150,194,113,1,476,361,116
866,E02000898,ALL,442,266000,263000,8,152,155,127,0,442,311,131
867,E02000899,ALL,484,260000,250000,8,109,265,102,32,452,383,101
868,E02000900,ALL,423,228000,238000,14,65,243,101,2,421,318,105
869,E02000901,ALL,665,293000,275000,22,124,332,187,81,584,480,185
870,E02000902,ALL,404,238000,245000,5,21,271,107,1,403,299,105
871,E02000903,ALL,324,228000,225000,5,26,226,67,1,323,246,78
872,E02000904,ALL,410,263000,250000,3,73,268,66,0,410,341,69
873,E02000905,ALL,540,249000,245000,3,19,366,152,1,539,349,191
874,E02000906,ALL,510,232000,225000,0,12,245,253,0,510,227,283
875,E02000907,ALL,358,247000,225000,7,19,157,175,16,342,175,183
876,E02000908,ALL,566,213000,210000,3,13,268,282,59,507,261,305
877,E02000909,ALL,545,305000,295000,12,70,280,183,1,544,360,185
878,E02000910,ALL,559,271000,250000,9,35,297,218,21,538,327,232
879,E02000911,ALL,637,231000,215000,1,6,302,328,53,584,286,351
880,E02000912,ALL,420,245000,244000,2,12,322,84,1,419,333,87
881,E02000913,ALL,364,280000,257000,5,29,244,86,1,363,271,93
882,E02000914,ALL,321,236000,216000,5,17,164,135,20,301,182,139
883,E02000915,ALL,366,288000,243000,12,39,126,189,2,364,170,196
884,E02000916,ALL,462,206000,195000,1,7,181,273,2,460,167,295
885,E02000917,ALL,515,220000,210000,5,13,218,279,32,483,213,302
886,E02000918,ALL,338,277000,250000,3,13,189,133,2,336,200,138
887,E02000919,ALL,409,243000,240000,0,14,264,131,3,406,276,133
888,E02000920,ALL,332,220000,225000,3,10,153,166,47,285,164,168
889,E02000921,ALL,312,223000,227000,1,12,213,86,2,310,221,91
890,E02000922,ALL,482,224000,225000,2,12,380,88,3,479,395,87
891,E02000923,ALL,817,757000,510000,6,15,86,710,38,779,94,723
892,E02000924,ALL,881,458000,405000,0,1,41,839,70,811,33,848
893,E02000925,ALL,463,537000,400000,1,12,82,368,69,394,94,369
894,E02000926,ALL,1327,515000,447000,8,59,85,1175,345,982,143,1184
895,E02000927,ALL,630,467000,442000,0,8,310,312,37,593,311,319
896,E02000928,ALL,852,713000,595000,15,68,314,455,21,831,391,461
897,E02000929,ALL,315,276000,250000,0,5,45,265,62,253,48,267
898,E02000930,ALL,1026,527000,473000,4,8,400,614,18,1008,398,628
899,E02000931,ALL,999,673000,580000,5,28,414,552,17,982,423,576
900,E02000932,ALL,1434,553000,475000,15,31,258,1130,235,1199,292,1142
901,E02000933,ALL,830,675000,435000,62,93,154,521,7,823,309,521
902,E02000934,ALL,1084,521000,425000,12,41,320,711,76,1008,352,732
903,E02000935,ALL,144,576000,221000,17,1,21,105,2,142,39,105
904,E02000936,ALL,890,479000,380000,30,22,60,778,118,772,106,784
905,E02000937,ALL,816,832000,600000,29,94,290,403,3,813,412,404
906,E02000938,ALL,933,492000,400000,24,35,311,563,313,620,363,570
907,E02000939,ALL,685,980000,900000,16,68,412,189,0,685,486,199
908,E02000940,ALL,958,338000,310000,3,8,122,825,298,660,125,833
909,E02000941,ALL,1170,612000,470000,5,46,531,588,8,1162,564,606
910,E02000942,ALL,923,587000,530000,33,118,334,438,13,910,481,442
911,E02000943,ALL,943,588000,485000,16,27,310,590,71,872,347,596
912,E02000944,ALL,424,339000,265000,4,21,35,364,23,401,61,363
913,E02000945,ALL,259,311000,225000,15,8,64,172,14,245,87,172
914,E02000946,ALL,768,435000,370000,8,41,216,503,33,735,254,514
915,E02000947,ALL,1104,481000,440000,4,30,513,557,12,1092,531,573
916,E02000948,ALL,1118,444000,375000,7,50,271,790,30,1088,312,806
917,E02000949,ALL,1032,672000,496000,19,139,362,512,17,1015,506,526
918,E02000950,ALL,638,430000,300000,29,22,97,490,1,637,140,498
919,E02000951,ALL,607,491000,358000,5,40,137,425,9,598,177,430
920,E02000952,ALL,459,595000,425000,6,18,148,287,5,454,163,296
921,E02000953,ALL,860,419000,380000,3,18,348,491,70,790,344,516
922,E02000954,ALL,427,413000,385000,1,12,262,152,1,426,265,162
923,E02000955,ALL,439,343000,320000,2,20,294,123,47,392,321,118
924,E02000956,ALL,468,290000,265000,0,12,162,294,65,403,168,300
925,E02000957,ALL,805,314000,285000,2,14,273,516,5,800,274,531
926,E02000958,ALL,430,383000,340000,9,56,188,177,1,429,253,177
927,E02000959,ALL,481,276000,250000,1,19,179,282,14,467,186,295
928,E02000960,ALL,535,1357000,810000,4,20,64,447,14,521,85,450
929,E02000961,ALL,751,1168000,585000,32,51,91,577,44,707,171,580
930,E02000962,ALL,715,799000,510000,5,9,11,690,9,706,26,689
931,E02000963,ALL,422,447000,430000,0,5,216,201,10,412,229,193
932,E02000964,ALL,688,392000,350000,2,4,68,614,17,671,63,625
933,E02000965,ALL,869,595000,535000,1,10,30,828,3,866,35,834
934,E02000966,ALL,981,932000,690000,3,17,82,879,3,978,99,882
935,E02000967,ALL,747,899000,700000,0,2,50,695,26,721,39,708
936,E02000968,ALL,379,420000,340000,0,2,16,361,10,369,19,360
937,E02000969,ALL,348,399000,360000,0,2,4,342,2,346,3,345
938,E02000970,ALL,836,1504000,941000,1,1,57,777,13,823,41,795
939,E02000971,ALL,856,933000,700000,1,1,64,790,10,846,72,784
940,E02000972,ALL,698,1035000,690000,1,0,13,684,69,629,18,680
941,E02000973,ALL,1025,969000,600000,3,20,140,862,6,1019,148,877
942,E02000974,ALL,1091,895000,650000,1,1,104,985,78,1013,77,1014
943,E02000975,ALL,805,964000,650000,0,0,54,751,21,784,55,750
944,E02000976,ALL,790,805000,575000,2,4,40,744,9,781,43,747
945,E02000977,ALL,698,1423000,850000,0,2,23,673,88,610,25,673
946,E02000978,ALL,857,3253000,2000000,2,5,273,577,26,831,240,617
947,E02000979,ALL,739,918000,715000,2,3,27,707,92,647,32,707
948,E02000980,ALL,723,652000,545000,0,1,26,696,3,720,27,696
949,E02000981,ALL,885,779000,565000,2,2,119,762,7,878,117,768
950,E02000982,ALL,688,944000,685000,1,2,83,602,159,529,75,613
951,E02000983,ALL,482,660000,500000,0,0,39,443,25,457,34,448
952,E02003258,ALL,657,200000,190000,268,166,173,50,7,650,599,58
953,E02003259,ALL,337,151000,150000,5,258,47,27,0,337,310,27
954,E02003260,ALL,268,116000,122000,3,56,155,54,0,268,212,56
955,E02003261,ALL,362,198000,172000,111,186,48,17,0,362,343,19
956,E02003262,ALL,392,148000,145000,55,203,93,41,1,391,350,42
957,E02003263,ALL,575,153000,154000,43,269,199,64,11,564,509,66
958,E02003264,ALL,672,228000,220000,189,307,156,20,1,671,652,20
959,E02003265,ALL,561,165000,158000,50,233,198,80,15,546,478,83
960,E02003266,ALL,350,136000,134000,18,163,152,17,0,350,331,19
961,E02003267,ALL,415,168000,165000,30,203,153,29,16,399,387,28
962,E02003268,ALL,478,157000,152000,45,200,197,36,35,443,437,41
963,E02003269,ALL,636,173000,165000,97,347,119,73,20,616,556,80
964,E02003270,ALL,472,154000,155000,39,328,79,26,1,471,447,25
965,E02003271,ALL,699,170000,160000,122,344,188,45,8,691,654,45
966,E02003272,ALL,234,147000,145000,18,102,102,12,1,233,222,12
967,E02003273,ALL,602,155000,155000,37,371,165,29,56,546,517,85
968,E02003274,ALL,261,140000,125000,14,69,139,39,0,261,219,42
969,E02003275,ALL,628,115000,112000,16,56,193,363,41,587,251,377
970,E02003276,ALL,262,126000,126000,5,57,180,20,0,262,243,19
971,E02003277,ALL,410,138000,140000,6,187,152,65,4,406,347,63
972,E02003278,ALL,563,154000,125000,55,115,238,155,19,544,410,153
973,E02003279,ALL,718,200000,190000,197,391,69,61,14,704,655,63
974,E02003280,ALL,668,181000,177000,115,380,126,47,0,668,624,44
975,E02003281,ALL,809,226000,213000,189,400,113,107,16,793,690,119
976,E02003282,ALL,689,203000,195000,137,335,92,125,15,674,560,129
977,E02003283,ALL,758,209000,194000,163,288,187,120,25,733,641,117
978,E02003284,ALL,798,157000,160000,65,296,301,136,4,794,651,147
979,E02003285,ALL,874,149000,148000,38,104,391,341,3,871,509,365
980,E02003286,ALL,870,308000,290000,217,408,58,187,8,862,672,198
981,E02003287,ALL,713,252000,230000,263,178,171,101,82,631,610,103
982,E02003288,ALL,662,134000,130000,25,112,231,294,34,628,358,304
983,E02003289,ALL,1117,238000,230000,102,241,293,481,10,1107,590,527
984,E02003290,ALL,950,247000,178000,177,149,59,565,56,894,367,583
985,E02003291,ALL,886,197000,167000,125,206,354,201,177,709,662,224
986,E02003292,ALL,685,140000,129000,19,107,217,342,5,680,323,362
987,E02003293,ALL,934,174000,145000,29,111,192,602,14,920,295,639
988,E02003294,ALL,849,282000,245000,237,268,93,251,2,847,531,318
989,E02003295,ALL,619,231000,210000,198,254,92,75,1,618,504,115
990,E02003296,ALL,392,222000,200000,68,201,113,10,0,392,381,11
991,E02003297,ALL,347,184000,172000,26,138,133,50,3,344,298,49
992,E02003298,ALL,369,184000,175000,27,185,136,21,12,357,348,21
993,E02003299,ALL,350,305000,260000,137,103,87,23,15,335,327,23
994,E02003300,ALL,505,184000,175000,69,187,172,77,10,495,423,82
995,E02003301,ALL,624,180000,170000,94,142,278,110,114,510,516,108
996,E02003302,ALL,459,152000,156000,11,100,264,84,1,458,372,87
997,E02003303,ALL,408,172000,167000,22,147,192,47,2,406,355,53
998,E02003304,ALL,456,206000,195000,46,235,140,35,6,450,421,35
999,E02003305,ALL,422,233000,230000,77,266,74,5,45,377,417,5
1000,E02003307,ALL,361,173000,167000,22,127,204,8,0,361,354,7
1001,E02003308,ALL,333,162000,160000,20,130,102,81,1,332,249,84
1002,E02003309,ALL,489,188000,175000,50,175,186,78,0,489,408,81
1003,E02003310,ALL,1046,149000,138000,30,89,457,470,440,606,570,476
1004,E02003311,ALL,528,161000,145000,55,69,308,96,1,527,432,96
1005,E02003312,ALL,506,136000,133000,16,20,172,298,76,430,213,293
1006,E02003313,ALL,437,134000,135000,12,93,271,61,23,414,374,63
1007,E02003314,ALL,348,172000,150000,69,142,118,19,31,317,325,23
1008,E02003315,ALL,352,222000,196000,117,139,91,5,15,337,344,8
1009,E02003316,ALL,986,200000,188000,230,379,292,85,289,697,892,94
1010,E02003317,ALL,515,207000,192000,104,189,166,56,173,342,471,44
1011,E02003318,ALL,356,214000,200000,111,161,83,1,4,352,355,1
1012,E02003319,ALL,590,132000,122000,35,70,399,86,53,537,502,88
1013,E02003320,ALL,723,193000,175000,108,77,208,330,247,476,370,353
1014,E02003321,ALL,287,158000,145000,30,125,102,30,0,287,256,31
1015,E02003322,ALL,516,129000,120000,2,41,310,163,139,377,353,163
1016,E02003323,ALL,432,144000,137000,40,65,279,48,81,351,376,56
1017,E02003324,ALL,707,143000,135000,9,183,384,131,215,492,562,145
1018,E02003325,ALL,406,108000,106000,9,23,321,53,3,403,354,52
1019,E02003326,ALL,405,139000,130000,24,67,292,22,0,405,384,21
1020,E02003327,ALL,587,214000,175000,52,70,236,229,46,541,355,232
1021,E02003328,ALL,499,134000,115000,16,46,239,198,74,425,304,195
1022,E02003329,ALL,391,126000,123000,8,43,330,10,3,388,381,10
1023,E02003330,ALL,494,150000,139000,14,103,360,17,15,479,470,24
1024,E02003331,ALL,416,146000,140000,16,167,218,15,0,416,399,17
1025,E02003332,ALL,307,193000,195000,53,125,127,2,2,305,300,7
1026,E02003333,ALL,434,110000,105000,27,26,321,60,35,399,371,63
1027,E02003334,ALL,335,141000,131000,17,37,252,29,10,325,307,28
1028,E02003335,ALL,406,109000,106000,2,52,338,14,2,404,389,17
1029,E02003336,ALL,429,209000,192000,84,254,89,2,49,380,427,2
1030,E02003337,ALL,374,187000,158000,59,168,123,24,19,355,349,25
1031,E02003338,ALL,494,153000,146000,47,110,261,76,6,488,416,78
1032,E02003339,ALL,363,196000,185000,82,104,160,17,0,363,344,19
1033,E02003340,ALL,385,151000,140000,16,228,134,7,2,383,374,11
1034,E02003341,ALL,401,206000,185000,90,159,143,9,18,383,387,14
1035,E02003342,ALL,419,203000,192000,101,205,101,12,5,414,408,11
1036,E02003343,ALL,385,248000,237000,173,153,44,15,7,378,362,23
1037,E02003344,ALL,338,162000,144000,66,75,174,23,2,336,314,24
1038,E02003345,ALL,382,175000,164000,46,96,219,21,0,382,360,22
1039,E02003346,ALL,408,193000,160000,106,181,105,16,45,363,391,17
1040,E02003347,ALL,483,150000,140000,67,117,280,19,0,483,463,20
1041,E02003348,ALL,545,253000,235000,232,198,99,16,17,528,523,22
1042,E02003349,ALL,480,165000,156000,69,104,277,30,1,479,444,36
1043,E02003350,ALL,378,185000,175000,100,135,105,38,0,378,341,37
1044,E02003351,ALL,522,156000,147000,58,153,238,73,0,522,444,78
1045,E02003352,ALL,335,501000,404000,209,57,42,27,15,320,307,28
1046,E02003353,ALL,832,309000,270000,326,179,229,98,128,704,730,102
1047,E02003354,ALL,852,296000,268000,382,139,270,61,0,852,790,62
1048,E02003355,ALL,338,203000,199000,14,81,186,57,6,332,278,60
1049,E02003356,ALL,539,378000,302000,172,199,85,83,9,530,452,87
1050,E02003357,ALL,646,216000,200000,77,106,290,173,104,542,471,175
1051,E02003358,ALL,697,229000,208000,117,179,194,207,182,515,484,213
1052,E02003359,ALL,612,200000,193000,53,110,387,62,0,612,541,71
1053,E02003360,ALL,1139,261000,250000,343,260,403,133,589,550,1011,128
1054,E02003361,ALL,513,198000,192000,45,84,307,77,0,513,430,83
1055,E02003362,ALL,456,191000,186000,45,82,233,96,0,456,347,109
1056,E02003363,ALL,537,301000,250000,171,113,47,206,25,512,325,212
1057,E02003364,ALL,527,249000,230000,161,139,183,44,8,519,480,47
1058,E02003365,ALL,505,299000,275000,210,142,117,36,2,503,467,38
1059,E02003366,ALL,481,248000,235000,151,121,142,67,8,473,409,72
1060,E02003367,ALL,364,408000,350000,201,104,50,9,29,335,347,17
1061,E02003368,ALL,378,306000,249000,168,90,98,22,16,362,352,26
1062,E02003369,ALL,523,499000,415000,223,136,84,80,30,493,439,84
1063,E02003370,ALL,518,310000,282000,251,124,76,67,8,510,444,74
1064,E02003371,ALL,358,267000,250000,117,183,53,5,0,358,352,6
1065,E02003372,ALL,529,260000,230000,139,237,93,60,19,510,467,62
1066,E02003373,ALL,503,435000,390000,331,93,61,18,27,476,482,21
1067,E02003374,ALL,463,215000,205000,101,161,166,35,28,435,426,37
1068,E02003375,ALL,381,262000,220000,96,116,111,58,19,362,317,64
1069,E02003376,ALL,521,266000,235000,117,171,150,83,17,504,424,97
1070,E02003377,ALL,688,379000,298000,313,168,142,65,41,647,609,79
1071,E02003378,ALL,639,284000,235000,147,170,111,211,55,584,425,214
1072,E02003379,ALL,535,216000,205000,135,171,147,82,16,519,450,85
1073,E02003380,ALL,609,207000,200000,117,245,184,63,24,585,541,68
1074,E02003381,ALL,404,328000,285000,218,104,68,14,16,388,391,13
1075,E02003382,ALL,484,211000,191000,129,131,143,81,3,481,402,82
1076,E02003383,ALL,552,244000,230000,195,199,126,32,40,512,517,35
1077,E02003384,ALL,371,490000,405000,198,82,72,19,3,368,350,21
1078,E02003385,ALL,975,229000,199000,160,125,237,453,183,792,515,460
1079,E02003386,ALL,656,249000,225000,125,190,203,138,70,586,518,138
1080,E02003387,ALL,726,318000,279000,275,220,150,81,41,685,633,93
1081,E02003388,ALL,415,354000,309000,175,138,67,35,37,378,376,39
1082,E02003389,ALL,627,315000,288000,260,223,81,63,30,597,562,65
1083,E02003390,ALL,610,447000,410000,357,187,21,45,24,586,561,49
1084,E02003391,ALL,807,307000,275000,151,302,171,183,78,729,621,186
1085,E02003392,ALL,860,229000,220000,38,132,499,191,20,840,662,198
1086,E02003393,ALL,661,248000,225000,160,219,193,89,25,636,567,94
1087,E02003394,ALL,549,180000,176000,16,203,240,90,117,432,450,99
1088,E02003395,ALL,897,184000,175000,5,42,619,231,214,683,641,256
1089,E02003396,ALL,737,189000,177000,46,207,307,177,10,727,557,180
1090,E02003397,ALL,436,224000,210000,54,188,185,9,17,419,428,8
1091,E02003398,ALL,673,186000,175000,7,35,413,218,62,611,448,225
1092,E02003399,ALL,1143,186000,176000,17,40,213,873,267,876,260,883
1093,E02003400,ALL,639,224000,190000,47,128,308,156,76,563,483,156
1094,E02003401,ALL,598,202000,178000,51,99,134,314,20,578,269,329
1095,E02003402,ALL,767,209000,181000,46,68,445,208,78,689,551,216
1096,E02003403,ALL,519,218000,200000,57,207,130,125,39,480,390,129
1097,E02003404,ALL,317,240000,195000,60,129,53,75,14,303,239,78
1098,E02003405,ALL,716,183000,175000,3,214,246,253,136,580,457,259
1099,E02003406,ALL,358,181000,180000,18,220,87,33,18,340,316,42
1100,E02003407,ALL,365,183000,175000,14,76,246,29,0,365,335,30
1101,E02003408,ALL,365,172000,172000,8,134,79,144,0,365,182,183
1102,E02003409,ALL,597,206000,191000,95,127,131,244,1,596,346,251
1103,E02003410,ALL,295,184000,177000,2,108,132,53,7,288,238,57
1104,E02003411,ALL,390,208000,210000,14,82,219,75,56,334,314,76
1105,E02003412,ALL,568,214000,210000,50,245,165,108,82,486,455,113
1106,E02003413,ALL,492,193000,185000,34,108,123,227,139,353,262,230
1107,E02003414,ALL,928,210000,206000,56,225,503,144,215,713,764,164
1108,E02003415,ALL,440,161000,155000,13,81,96,250,19,421,184,256
1109,E02003416,ALL,597,256000,238000,98,159,154,186,84,513,406,191
1110,E02003417,ALL,455,234000,190000,72,95,45,243,20,435,207,248
1111,E02003418,ALL,451,235000,214000,40,132,203,76,11,440,372,79
1112,E02003419,ALL,366,230000,220000,43,89,132,102,0,366,261,105
1113,E02003420,ALL,318,194000,184000,12,66,142,98,5,313,220,98
1114,E02003421,ALL,384,398000,318000,160,132,69,23,6,378,358,26
1115,E02003422,ALL,750,607000,450000,321,213,164,52,18,732,696,54
1116,E02003423,ALL,331,306000,250000,74,128,87,42,35,296,276,55
1117,E02003424,ALL,932,416000,340000,300,74,136,422,176,756,508,424
1118,E02003425,ALL,962,274000,240000,137,182,224,419,164,798,531,431
1119,E02003426,ALL,731,376000,330000,262,252,110,107,26,705,618,113
1120,E02003427,ALL,446,266000,245000,56,164,136,90,4,442,342,104
1121,E02003428,ALL,564,306000,292000,175,254,103,32,8,556,530,34
1122,E02003429,ALL,524,445000,380000,253,124,104,43,39,485,476,48
1123,E02003430,ALL,412,415000,310000,35,64,167,146,41,371,258,154
1124,E02003431,ALL,472,352000,300000,148,122,109,93,2,470,376,96
1125,E02003432,ALL,727,377000,320000,37,146,320,224,49,678,500,227
1126,E02003433,ALL,312,310000,283000,30,118,133,31,0,312,280,32
1127,E02003434,ALL,581,333000,295000,114,185,103,179,29,552,394,187
1128,E02003435,ALL,590,495000,405000,138,88,220,144,41,549,432,158
1129,E02003436,ALL,524,424000,360000,248,147,76,53,14,510,467,57
1130,E02003437,ALL,552,547000,406000,198,119,103,132,68,484,412,140
1131,E02003438,ALL,978,737000,508000,404,189,96,289,110,868,671,307
1132,E02003439,ALL,404,557000,425000,185,85,75,59,26,378,343,61
1133,E02003440,ALL,779,342000,305000,308,206,176,89,25,754,687,92
1134,E02003441,ALL,532,349000,286000,191,211,97,33,19,513,499,33
1135,E02003442,ALL,607,286000,250000,236,163,126,82,0,607,521,86
1136,E02003443,ALL,437,246000,236000,107,121,97,112,68,369,326,111
1137,E02003444,ALL,589,284000,270000,154,311,56,68,58,531,520,69
1138,E02003445,ALL,503,240000,240000,72,301,72,58,2,501,437,66
1139,E02003446,ALL,543,295000,285000,248,177,76,42,22,521,500,43
1140,E02003447,ALL,704,304000,284000,295,147,204,58,54,650,632,72
1141,E02003448,ALL,525,352000,300000,218,163,72,72,59,466,452,73
1142,E02003449,ALL,809,221000,215000,204,171,325,109,1,808,700,109
1143,E02003450,ALL,851,271000,250000,287,279,185,100,38,813,740,111
1144,E02003451,ALL,883,269000,250000,125,155,244,359,184,699,517,366
1145,E02003452,ALL,599,335000,295000,246,136,135,82,115,484,510,89
1146,E02003453,ALL,480,383000,355000,301,94,62,23,23,457,457,23
1147,E02003454,ALL,781,298000,246000,249,174,146,212,168,613,554,227
1148,E02003455,ALL,589,343000,300000,247,165,142,35,123,466,543,46
1149,E02003456,ALL,428,318000,250000,163,114,129,22,14,414,404,24
1150,E02003457,ALL,744,434000,375000,490,122,124,8,22,722,736,8
1151,E02003458,ALL,637,371000,346000,364,157,65,51,15,622,584,53
1152,E02003459,ALL,695,266000,238000,259,169,223,44,7,688,651,44
1153,E02003460,ALL,1236,264000,230000,488,367,279,102,615,621,1123,113
1154,E02003461,ALL,594,197000,180000,145,239,146,64,81,513,526,68
1155,E02003462,ALL,713,181000,168000,133,209,280,91,10,703,618,95
1156,E02003463,ALL,420,209000,172000,167,85,138,30,9,411,365,55
1157,E02003464,ALL,297,147000,140000,58,103,119,17,0,297,270,27
1158,E02003465,ALL,611,207000,175000,185,186,88,152,175,436,410,201
1159,E02003466,ALL,589,157000,153000,12,92,404,81,73,516,508,81
1160,E02003467,ALL,258,156000,145000,50,45,130,33,1,257,213,45
1161,E02003468,ALL,929,193000,178000,132,273,356,168,359,570,754,175
1162,E02003469,ALL,377,186000,170000,150,113,95,19,0,377,347,30
1163,E02003470,ALL,163,120000,123000,5,27,107,24,0,163,133,30
1164,E02003471,ALL,302,156000,143000,77,82,105,38,0,302,239,63
1165,E02003472,ALL,842,141000,142000,11,19,132,680,150,692,131,711
1166,E02003473,ALL,402,190000,185000,199,88,70,45,0,402,318,84
1167,E02003474,ALL,480,234000,212000,217,99,102,62,5,475,385,95
1168,E02003475,ALL,2181,227000,225000,867,500,421,393,1234,947,1706,475
1169,E02003476,ALL,273,119000,123000,20,57,165,31,1,272,232,41
1170,E02003477,ALL,1051,228000,218000,337,305,234,175,301,750,853,198
1171,E02003478,ALL,478,249000,190000,212,154,62,50,6,472,389,89
1172,E02003479,ALL,276,147000,146000,64,69,109,34,0,276,214,62
1173,E02003480,ALL,594,207000,175000,221,162,132,79,21,573,469,125
1174,E02003481,ALL,517,148000,134000,39,51,126,301,240,277,209,308
1175,E02003482,ALL,588,279000,249000,265,130,104,89,155,433,492,96
1176,E02003483,ALL,804,245000,235000,415,159,136,94,88,716,675,129
1177,E02003484,ALL,442,197000,175000,176,95,128,43,1,441,358,84
1178,E02003485,ALL,385,173000,158000,115,115,132,23,2,383,362,23
1179,E02003486,ALL,715,211000,205000,323,182,153,57,27,688,614,101
1180,E02003487,ALL,338,183000,159000,96,130,104,8,7,331,327,11
1181,E02003488,ALL,555,149000,145000,61,182,175,137,92,463,415,140
1182,E02003489,ALL,593,170000,160000,85,250,105,153,145,448,425,168
1183,E02003490,ALL,543,176000,180000,116,148,230,49,294,249,498,45
1184,E02003491,ALL,542,255000,250000,58,396,62,26,0,542,515,27
1185,E02003492,ALL,218,200000,206000,7,120,76,15,1,217,205,13
1186,E02003493,ALL,701,324000,305000,265,196,27,213,1,700,488,213
1187,E02003494,ALL,526,343000,270000,106,249,79,92,0,526,441,85
1188,E02003495,ALL,470,204000,199000,74,240,137,19,5,465,425,45
1189,E02003496,ALL,425,242000,242000,98,191,22,114,0,425,300,125
1190,E02003497,ALL,544,500000,410000,247,195,13,89,10,534,455,89
1191,E02003498,ALL,355,212000,214000,10,62,184,99,0,355,257,98
1192,E02003499,ALL,285,197000,200000,11,185,67,22,2,283,258,27
1193,E02003500,ALL,698,333000,317000,29,62,457,150,1,697,543,155
1194,E02003501,ALL,812,360000,275000,166,75,190,381,11,801,422,390
1195,E02003502,ALL,503,199000,200000,24,162,246,71,1,502,423,80
1196,E02003503,ALL,526,264000,250000,70,311,85,60,0,526,466,60
1197,E02003504,ALL,875,280000,220000,15,72,226,562,15,860,298,577
1198,E02003505,ALL,721,226000,205000,2,16,306,397,7,714,315,406
1199,E02003506,ALL,736,285000,298000,14,81,474,167,4,732,564,172
1200,E02003507,ALL,617,247000,245000,283,185,131,18,8,609,597,20
1201,E02003508,ALL,776,242000,240000,8,31,535,202,21,755,569,207
1202,E02003509,ALL,908,267000,228000,23,48,164,673,12,896,220,688
1203,E02003510,ALL,946,276000,230000,20,57,119,750,7,939,188,758
1204,E02003511,ALL,707,294000,250000,52,215,233,207,9,698,488,219
1205,E02003512,ALL,754,257000,250000,3,12,498,241,1,753,507,247
1206,E02003513,ALL,607,356000,272000,61,165,59,322,28,579,279,328
1207,E02003514,ALL,1003,257000,210000,13,32,130,828,57,946,162,841
1208,E02003515,ALL,230,196000,198000,11,106,63,50,7,223,181,49
1209,E02003516,ALL,1079,247000,222000,10,18,44,1007,7,1072,69,1010
1210,E02003517,ALL,999,283000,250000,10,32,411,546,128,871,448,551
1211,E02003518,ALL,1083,304000,234000,32,85,44,922,36,1047,153,930
1212,E02003519,ALL,928,250000,220000,3,7,101,817,16,912,104,824
1213,E02003520,ALL,737,249000,210000,7,20,205,505,9,728,228,509
1214,E02003521,ALL,920,279000,233000,6,13,265,636,13,907,270,650
1215,E02003522,ALL,853,316000,250000,38,67,167,581,7,846,269,584
1216,E02003523,ALL,1060,306000,270000,523,203,53,281,91,969,780,280
1217,E02003524,ALL,263,117000,120000,4,94,155,10,0,263,251,12
1218,E02003525,ALL,215,126000,128000,1,82,77,55,9,206,159,56
1219,E02003526,ALL,475,257000,238000,159,164,43,109,35,440,367,108
1220,E02003527,ALL,115,150000,150000,0,28,74,13,15,100,101,14
1221,E02003529,ALL,645,171000,174000,11,112,362,160,88,557,486,159
1222,E02003530,ALL,140,146000,135000,2,39,31,68,48,92,72,68
1223,E02003531,ALL,179,176000,160000,37,28,99,15,0,179,164,15
1224,E02003599,ALL,418,174000,167000,118,114,172,14,5,413,392,26
1225,E02003600,ALL,462,179000,156000,92,144,175,51,12,450,407,55
1226,E02003601,ALL,576,230000,203000,191,189,161,35,31,545,533,43
1227,E02003602,ALL,326,280000,242000,163,92,60,11,24,302,317,9
1228,E02003603,ALL,942,170000,160000,128,257,390,167,62,880,763,179
1229,E02003604,ALL,893,216000,208000,292,316,205,80,438,455,825,68
1230,E02003605,ALL,489,297000,220000,194,177,109,9,23,466,482,7
1231,E02003606,ALL,494,305000,258000,250,133,106,5,37,457,487,7
1232,E02003607,ALL,714,258000,208000,213,225,211,65,98,616,643,71
1233,E02003608,ALL,931,215000,195000,252,258,366,55,88,843,862,69
1234,E02003609,ALL,812,242000,219000,259,209,272,72,210,602,741,71
1235,E02003610,ALL,804,260000,230000,269,193,250,92,151,653,694,110
1236,E02003611,ALL,608,247000,225000,227,192,175,14,56,552,584,24
1237,E02003612,ALL,1323,253000,239000,442,393,343,145,530,793,1187,136
1238,E02003613,ALL,464,216000,208000,162,143,103,56,32,432,402,62
1239,E02003614,ALL,634,197000,176000,140,233,234,27,7,627,603,31
1240,E02003615,ALL,889,296000,250000,365,265,209,50,252,637,835,54
1241,E02003616,ALL,366,295000,242000,202,78,77,9,13,353,355,11
1242,E02003617,ALL,547,299000,250000,274,177,79,17,11,536,529,18
1243,E02003618,ALL,621,230000,187000,214,260,141,6,31,590,613,8
1244,E02003619,ALL,1057,268000,230000,527,305,207,18,449,608,1029,28
1245,E02003620,ALL,521,211000,188000,218,190,88,25,1,520,495,26
1246,E02003621,ALL,506,227000,195000,187,258,60,1,4,502,505,1
1247,E02003622,ALL,483,163000,155000,101,176,160,46,0,483,439,44
1248,E02003623,ALL,954,284000,238000,426,245,210,73,316,638,886,68
1249,E02003624,ALL,396,236000,184000,92,111,55,138,12,384,257,139
1250,E02003625,ALL,524,172000,149000,51,107,172,194,27,497,330,194
1251,E02003626,ALL,433,191000,180000,117,172,136,8,1,432,428,5
1252,E02003627,ALL,768,206000,180000,46,196,253,273,103,665,493,275
1253,E02003628,ALL,323,148000,130000,29,109,141,44,0,323,279,44
1254,E02003629,ALL,574,138000,132000,50,201,219,104,7,567,461,113
1255,E02003630,ALL,563,134000,130000,14,128,205,216,157,406,348,215
1256,E02003631,ALL,335,164000,150000,84,85,91,75,56,279,258,77
1257,E02003632,ALL,414,151000,145000,66,162,172,14,2,412,396,18
1258,E02003633,ALL,732,180000,160000,140,335,208,49,285,447,693,39
1259,E02003634,ALL,1143,208000,200000,377,342,331,93,611,532,1051,92
1260,E02003635,ALL,437,222000,207000,210,123,95,9,107,330,431,6
1261,E02003636,ALL,535,219000,194000,133,228,168,6,3,532,523,12
1262,E02003637,ALL,701,260000,225000,275,203,186,37,87,614,659,42
1263,E02003638,ALL,538,232000,194000,159,168,196,15,49,489,521,17
1264,E02003639,ALL,984,168000,153000,126,218,340,300,220,764,674,310
1265,E02003640,ALL,611,203000,165000,127,161,164,159,92,519,452,159
1266,E02003641,ALL,427,206000,195000,119,107,154,47,0,427,384,43
1267,E02003642,ALL,387,124000,125000,11,75,280,21,0,387,361,26
1268,E02003643,ALL,1347,193000,190000,274,413,479,181,466,881,1158,189
1269,E02003644,ALL,609,166000,155000,127,189,241,52,95,514,545,64
1270,E02003645,ALL,367,177000,175000,26,259,47,35,2,365,323,44
1271,E02003646,ALL,707,186000,167000,101,277,204,125,151,556,576,131
1272,E02003647,ALL,623,169000,155000,88,153,228,154,26,597,463,160
1273,E02003648,ALL,330,156000,145000,23,119,75,113,61,269,210,120
1274,E02003649,ALL,465,201000,200000,113,195,99,58,1,464,405,60
1275,E02003650,ALL,470,354000,310000,245,116,91,18,8,462,448,22
1276,E02003651,ALL,473,260000,238000,157,191,118,7,9,464,468,5
1277,E02003652,ALL,711,271000,242000,295,192,191,33,111,600,671,40
1278,E02003653,ALL,622,216000,200000,175,154,215,78,118,504,551,71
1279,E02003654,ALL,380,338000,294000,197,131,42,10,13,367,368,12
1280,E02003655,ALL,732,307000,250000,363,200,157,12,107,625,718,14
1281,E02003656,ALL,552,263000,225000,195,140,184,33,79,473,519,33
1282,E02003657,ALL,407,355000,300000,206,129,68,4,37,370,399,8
1283,E02003658,ALL,568,305000,250000,201,187,158,22,46,522,532,36
1284,E02003659,ALL,963,284000,240000,383,268,233,79,455,508,888,75
1285,E02003660,ALL,805,321000,280000,379,231,189,6,133,672,799,6
1286,E02003661,ALL,345,333000,285000,143,133,56,13,23,322,334,11
1287,E02003662,ALL,523,193000,168000,93,114,211,105,0,523,410,113
1288,E02003663,ALL,666,204000,185000,136,241,211,78,370,296,598,68
1289,E02003664,ALL,507,158000,158000,9,178,216,104,70,437,401,106
1290,E02003665,ALL,409,200000,185000,57,151,158,43,0,409,363,46
1291,E02003666,ALL,520,165000,156000,26,71,191,232,81,439,285,235
1292,E02003667,ALL,994,184000,177000,183,280,392,139,0,994,858,136
1293,E02003668,ALL,593,258000,245000,159,270,114,50,9,584,543,50
1294,E02003669,ALL,375,145000,143000,2,138,51,184,110,265,186,189
1295,E02003670,ALL,846,211000,218000,155,224,360,107,217,629,742,104
1296,E02003671,ALL,444,166000,161000,32,124,258,30,19,425,411,33
1297,E02003672,ALL,740,366000,320000,395,198,108,39,45,695,697,43
1298,E02003673,ALL,662,365000,325000,308,177,125,52,83,579,607,55
1299,E02003674,ALL,393,429000,368000,229,101,50,13,10,383,378,15
1300,E02003675,ALL,807,322000,285000,208,275,177,147,234,573,658,149
1301,E02003676,ALL,444,579000,490000,252,122,45,25,7,437,417,27
1302,E02003677,ALL,625,289000,260000,169,208,178,70,46,579,551,74
1303,E02003678,ALL,461,298000,249000,109,145,150,57,6,455,402,59
1304,E02003679,ALL,601,240000,220000,47,121,267,166,40,561,432,169
1305,E02003680,ALL,720,447000,370000,354,157,152,57,7,713,654,66
1306,E02003681,ALL,854,473000,380000,307,175,154,218,97,757,630,224
1307,E02003682,ALL,668,428000,370000,192,237,119,120,19,649,542,126
1308,E02003683,ALL,530,550000,412000,237,128,77,88,155,375,435,95
1309,E02003685,ALL,546,628000,494000,353,102,60,31,18,528,503,43
1310,E02003686,ALL,491,493000,480000,324,68,51,48,3,488,439,52
1311,E02003687,ALL,400,526000,420000,176,136,46,42,15,385,359,41
1312,E02003688,ALL,1093,715000,530000,489,217,167,220,150,943,868,225
1313,E02003689,ALL,688,866000,789000,415,54,57,162,93,595,521,167
1314,E02003690,ALL,605,368000,310000,173,101,81,250,157,448,312,293
1315,E02003691,ALL,459,543000,475000,223,60,91,85,17,442,355,104
1316,E02003692,ALL,564,481000,354000,226,148,79,111,30,534,442,122
1317,E02003693,ALL,469,489000,431000,208,83,88,90,70,399,345,124
1318,E02003694,ALL,566,277000,250000,133,197,115,121,51,515,447,119
1319,E02003695,ALL,672,363000,310000,179,246,127,120,19,653,536,136
1320,E02003696,ALL,691,335000,275000,222,286,88,95,77,614,596,95
1321,E02003697,ALL,350,526000,475000,235,66,47,2,8,342,348,2
1322,E02003698,ALL,572,405000,370000,327,154,71,20,26,546,550,22
1323,E02003699,ALL,390,314000,250000,137,117,92,44,11,379,345,45
1324,E02003701,ALL,775,246000,230000,150,288,233,104,97,678,669,106
1325,E02003702,ALL,445,582000,440000,229,124,62,30,10,435,413,32
1326,E02003703,ALL,735,273000,225000,162,197,152,224,185,550,509,226
1327,E02003704,ALL,446,432000,350000,188,143,40,75,16,430,368,78
1328,E02003705,ALL,388,201000,198000,21,212,70,85,27,361,300,88
1329,E02003706,ALL,446,211000,205000,93,158,76,119,58,388,322,124
1330,E02003707,ALL,424,207000,206000,69,179,71,105,18,406,305,119
1331,E02003708,ALL,370,158000,155000,19,123,89,139,17,353,225,145
1332,E02003709,ALL,299,186000,185000,17,178,51,53,2,297,248,51
1333,E02003710,ALL,595,275000,238000,196,158,54,187,115,480,407,188
1334,E02003711,ALL,862,222000,200000,63,188,178,433,213,649,421,441
1335,E02003712,ALL,493,256000,225000,145,124,174,50,21,472,435,58
1336,E02003713,ALL,410,359000,344000,201,124,50,35,6,404,373,37
1337,E02003714,ALL,553,302000,250000,132,190,150,81,9,544,463,90
1338,E02003715,ALL,361,549000,480000,267,58,30,6,8,353,339,22
1339,E02003716,ALL,439,424000,328000,128,138,96,77,12,427,363,76
1340,E02003717,ALL,784,459000,388000,271,182,189,142,46,738,637,147
1341,E02003718,ALL,548,414000,320000,109,136,186,117,39,509,427,121
1342,E02003719,ALL,573,192000,183000,30,127,224,192,105,468,368,205
1343,E02003720,ALL,547,269000,247000,72,154,207,114,21,526,425,122
1344,E02003721,ALL,557,262000,245000,50,127,155,225,62,495,319,238
1345,E02003722,ALL,475,363000,298000,45,135,152,143,20,455,333,142
1346,E02003723,ALL,409,358000,280000,60,72,121,156,109,300,252,157
1347,E02003724,ALL,669,243000,228000,28,257,177,207,89,580,442,227
1348,E02003725,ALL,734,496000,400000,88,40,176,430,274,460,300,434
1349,E02003726,ALL,540,364000,295000,28,54,298,160,24,516,376,164
1350,E02003727,ALL,860,269000,273000,44,122,508,186,84,776,671,189
1351,E02003728,ALL,695,268000,260000,32,209,122,332,45,650,355,340
1352,E02003729,ALL,631,255000,244000,101,254,190,86,56,575,534,97
1353,E02003730,ALL,1310,423000,325000,203,142,296,669,725,585,626,684
1354,E02003731,ALL,503,490000,410000,150,173,82,98,47,456,405,98
1355,E02003733,ALL,339,188000,158000,140,110,78,11,15,324,329,10
1356,E02003736,ALL,570,222000,192000,292,176,93,9,23,547,549,21
1357,E02003737,ALL,1073,167000,152000,276,317,363,117,291,782,923,150
1358,E02003738,ALL,320,233000,201000,150,93,72,5,18,302,308,12
1359,E02003739,ALL,591,240000,216000,311,119,125,36,6,585,538,53
1360,E02003740,ALL,361,305000,260000,164,102,80,15,51,310,340,21
1361,E02003756,ALL,8,388000,330000,7,1,0,0,0,8,8,0
1362,E02003757,ALL,248,191000,182000,128,47,50,23,5,243,225,23
1363,E02003758,ALL,595,214000,170000,256,166,153,20,24,571,572,23
1364,E02003759,ALL,463,225000,200000,237,170,53,3,13,450,460,3
1365,E02003760,ALL,406,131000,120000,30,85,276,15,47,359,381,25
1366,E02003761,ALL,507,202000,187000,283,110,98,16,73,434,493,14
1367,E02003762,ALL,566,229000,193000,261,179,94,32,28,538,533,33
1368,E02003763,ALL,912,174000,160000,250,225,379,58,62,850,854,58
1369,E02003764,ALL,991,169000,160000,277,187,235,292,205,786,689,302
1370,E02003765,ALL,610,215000,190000,136,197,154,123,116,494,463,147
1371,E02003766,ALL,595,203000,185000,213,146,154,82,132,463,522,73
1372,E02003767,ALL,407,330000,270000,263,98,43,3,15,392,404,3
1373,E02003768,ALL,880,287000,232000,448,214,144,74,136,744,802,78
1374,E02003769,ALL,451,245000,210000,243,138,55,15,11,440,421,30
1375,E02003770,ALL,1283,236000,215000,542,271,325,145,749,534,1139,144
1376,E02003771,ALL,571,185000,164000,114,167,150,140,54,517,427,144
1377,E02003772,ALL,656,208000,190000,253,153,168,82,28,628,577,79
1378,E02003773,ALL,901,170000,160000,177,238,406,80,119,782,817,84
1379,E02003774,ALL,395,189000,169000,96,127,136,36,9,386,359,36
1380,E02003775,ALL,523,245000,228000,285,110,95,33,32,491,485,38
1381,E02003776,ALL,524,247000,220000,222,120,169,13,2,522,507,17
1382,E02003777,ALL,810,254000,232000,387,219,156,48,241,569,758,52
1383,E02003778,ALL,421,253000,230000,166,116,132,7,78,343,410,11
1384,E02003779,ALL,436,202000,175000,123,140,160,13,1,435,403,33
1385,E02003780,ALL,1059,256000,235000,216,295,236,312,389,670,714,345
1386,E02003781,ALL,471,274000,247000,201,130,112,28,21,450,436,35
1387,E02003783,ALL,421,359000,320000,176,136,68,41,15,406,357,64
1388,E02003784,ALL,570,307000,250000,274,186,95,15,3,567,535,35
1389,E02003785,ALL,669,257000,234000,205,172,198,94,126,543,552,117
1390,E02003786,ALL,566,402000,300000,216,193,70,87,87,479,475,91
1391,E02003787,ALL,478,302000,239000,224,129,115,10,0,478,461,17
1392,E02003788,ALL,435,383000,310000,242,128,61,4,23,412,415,20
1393,E02003789,ALL,494,225000,212000,112,221,142,19,5,489,466,28
1394,E02003790,ALL,602,308000,250000,282,193,116,11,18,584,585,17
1395,E02003791,ALL,514,346000,300000,244,151,110,9,29,485,502,12
1396,E02003792,ALL,633,302000,250000,266,211,117,39,54,579,586,47
1397,E02003793,ALL,443,317000,264000,190,152,87,14,18,425,422,21
1398,E02004356,ALL,472,161000,156000,101,180,158,33,8,464,437,35
1399,E02004357,ALL,437,148000,144000,59,105,244,29,1,436,408,29
1400,E02004358,ALL,628,169000,165000,160,212,194,62,3,625,563,65
1401,E02004359,ALL,473,221000,207000,188,140,118,27,2,471,448,25
1402,E02004361,ALL,602,263000,240000,301,185,58,58,5,597,546,56
1403,E02004362,ALL,741,173000,171000,14,246,370,111,8,733,630,111
1404,E02004363,ALL,608,194000,156000,142,54,69,343,0,608,265,343
1405,E02004364,ALL,921,203000,190000,81,161,297,382,4,917,534,387
1406,E02004365,ALL,625,131000,130000,3,22,294,306,60,565,321,304
1407,E02004366,ALL,1006,184000,160000,19,34,101,852,38,968,152,854
1408,E02004367,ALL,1049,275000,233000,153,72,104,720,76,973,330,719
1409,E02004368,ALL,659,197000,185000,315,137,155,52,5,654,608,51
1410,E02004369,ALL,832,203000,190000,413,262,62,95,14,818,736,96
1411,E02004370,ALL,401,149000,135000,56,119,212,14,48,353,388,13
1412,E02004371,ALL,512,154000,136000,81,110,263,58,4,508,455,57
1413,E02004372,ALL,347,136000,132000,35,98,160,54,10,337,293,54
1414,E02004373,ALL,576,162000,150000,95,216,176,89,14,562,488,88
1415,E02004374,ALL,685,186000,163000,67,117,368,133,3,682,556,129
1416,E02004375,ALL,667,172000,150000,107,87,213,260,21,646,406,261
1417,E02004376,ALL,617,140000,124000,18,29,265,305,14,603,313,304
1418,E02004377,ALL,848,175000,159000,233,291,107,217,3,845,632,216
1419,E02004378,ALL,766,113000,97000,4,25,134,603,7,759,150,616
1420,E02004379,ALL,484,414000,335000,266,129,71,18,26,458,467,17
1421,E02004380,ALL,703,456000,365000,287,132,117,167,131,572,541,162
1422,E02004381,ALL,868,297000,242000,69,183,379,237,25,843,632,236
1423,E02004382,ALL,376,303000,250000,112,156,68,40,1,375,336,40
1424,E02004383,ALL,598,364000,320000,103,172,246,77,4,594,523,75
1425,E02004384,ALL,681,224000,222000,288,169,93,131,4,677,554,127
1426,E02004385,ALL,728,200000,200000,279,237,102,110,5,723,621,107
1427,E02004386,ALL,473,188000,180000,111,122,156,84,13,460,385,88
1428,E02004387,ALL,399,172000,166000,61,166,127,45,3,396,354,45
1429,E02004388,ALL,729,200000,200000,249,226,159,95,74,655,630,99
1430,E02004389,ALL,912,250000,240000,508,223,95,86,41,871,828,84
1431,E02004390,ALL,749,261000,240000,412,183,112,42,27,722,701,48
1432,E02004391,ALL,726,189000,173000,91,88,184,363,26,700,369,357
1433,E02004392,ALL,632,336000,275000,281,177,155,19,7,625,606,26
1434,E02004393,ALL,596,302000,250000,357,118,87,34,60,536,560,36
1435,E02004394,ALL,520,354000,285000,272,135,91,22,12,508,501,19
1436,E02004395,ALL,747,246000,217000,175,203,279,90,58,689,654,93
1437,E02004396,ALL,759,306000,262000,530,130,69,30,14,745,729,30
1438,E02004397,ALL,695,283000,240000,304,151,140,100,18,677,592,103
1439,E02004398,ALL,488,156000,144000,103,192,136,57,4,484,431,57
1440,E02004399,ALL,942,172000,172000,351,144,132,315,49,893,629,313
1441,E02004400,ALL,1175,284000,260000,839,122,57,157,44,1131,1013,162
1442,E02004401,ALL,995,220000,200000,401,192,48,354,21,974,639,356
1443,E02004402,ALL,1135,146000,130000,80,64,135,856,40,1095,286,849
1444,E02004403,ALL,405,412000,333000,171,120,67,47,5,400,358,47
1445,E02004404,ALL,418,458000,356000,177,134,91,16,6,412,398,20
1446,E02004405,ALL,595,268000,260000,259,171,76,89,96,499,500,95
1447,E02004406,ALL,666,367000,314000,406,84,44,132,31,635,529,137
1448,E02004407,ALL,662,462000,386000,300,153,109,100,76,586,563,99
1449,E02004408,ALL,581,234000,220000,185,196,144,56,63,518,502,79
1450,E02004409,ALL,337,529000,420000,229,57,35,16,4,333,313,24
1451,E02004410,ALL,617,414000,360000,345,182,48,42,44,573,580,37
1452,E02004411,ALL,817,224000,198000,210,211,243,153,47,770,659,158
1453,E02004412,ALL,808,242000,215000,321,197,132,158,53,755,648,160
1454,E02004413,ALL,476,319000,260000,243,145,56,32,7,469,445,31
1455,E02004414,ALL,712,241000,230000,214,238,182,78,193,519,636,76
1456,E02004415,ALL,546,393000,335000,289,159,83,15,193,353,526,20
1457,E02004416,ALL,417,333000,270000,255,117,34,11,9,408,407,10
1458,E02004417,ALL,688,198000,184000,242,239,159,48,113,575,641,47
1459,E02004418,ALL,450,198000,186000,165,165,89,31,27,423,421,29
1460,E02004419,ALL,316,167000,148000,68,100,113,35,11,305,280,36
1461,E02004420,ALL,1157,303000,248000,534,335,232,56,402,755,1106,51
1462,E02004421,ALL,982,186000,178000,239,464,110,169,118,864,805,177
1463,E02004422,ALL,926,220000,209000,429,285,144,68,38,888,852,74
1464,E02004423,ALL,737,222000,200000,310,311,53,63,1,736,671,66
1465,E02004424,ALL,553,378000,325000,272,185,67,29,11,542,524,29
1466,E02004425,ALL,670,261000,245000,145,266,179,80,13,657,588,82
1467,E02004426,ALL,667,329000,250000,224,199,121,123,35,632,544,123
1468,E02004427,ALL,703,327000,290000,242,258,95,108,60,643,590,113
1469,E02004428,ALL,552,218000,200000,141,202,78,131,150,402,419,133
1470,E02004429,ALL,516,274000,217000,152,256,30,78,37,479,438,78
1471,E02004430,ALL,615,211000,200000,159,297,139,20,2,613,595,20
1472,E02004431,ALL,790,199000,187000,182,248,298,62,42,748,719,71
1473,E02004432,ALL,412,315000,250000,162,164,56,30,13,399,384,28
1474,E02004433,ALL,633,193000,178000,128,123,199,183,59,574,443,190
1475,E02004434,ALL,540,161000,140000,111,112,189,128,5,535,400,140
1476,E02004435,ALL,672,163000,155000,41,118,419,94,249,423,584,88
1477,E02004436,ALL,234,125000,128000,3,17,176,38,1,233,192,42
1478,E02004437,ALL,555,194000,180000,112,106,222,115,159,396,439,116
1479,E02004438,ALL,516,149000,145000,9,68,273,166,165,351,349,167
1480,E02004439,ALL,272,145000,135000,9,28,180,55,32,240,234,38
1481,E02004440,ALL,451,163000,152000,14,48,330,59,89,362,394,57
1482,E02004441,ALL,291,159000,145000,43,71,135,42,3,288,251,40
1483,E02004442,ALL,269,133000,131000,14,31,182,42,0,269,229,40
1484,E02004443,ALL,593,174000,155000,53,52,238,250,211,382,336,257
1485,E02004444,ALL,582,240000,225000,247,97,150,88,2,580,492,90
1486,E02004445,ALL,405,148000,144000,48,67,191,99,1,404,301,104
1487,E02004446,ALL,455,268000,224000,246,142,65,2,4,451,452,3
1488,E02004447,ALL,323,344000,285000,204,78,38,3,3,320,322,1
1489,E02004448,ALL,485,239000,200000,181,174,98,32,23,462,455,30
1490,E02004449,ALL,707,159000,148000,83,213,271,140,75,632,569,138
1491,E02004450,ALL,364,329000,268000,191,132,37,4,4,360,359,5
1492,E02004451,ALL,654,225000,190000,211,231,196,16,20,634,616,38
1493,E02004452,ALL,771,222000,205000,328,225,149,69,151,620,701,70
1494,E02004453,ALL,390,173000,154000,44,158,128,60,50,340,332,58
1495,E02004454,ALL,809,163000,150000,108,183,196,322,124,685,490,319
1496,E02004455,ALL,545,243000,218000,212,190,111,32,57,488,511,34
1497,E02004456,ALL,756,165000,155000,112,269,268,107,127,629,632,124
1498,E02004457,ALL,666,205000,181000,167,259,192,48,67,599,617,49
1499,E02004458,ALL,794,246000,222000,336,205,207,46,14,780,738,56
1500,E02004459,ALL,807,277000,236000,272,289,173,73,26,781,730,77
1501,E02004460,ALL,569,184000,168000,59,257,181,72,34,535,501,68
1502,E02004461,ALL,268,148000,142000,10,31,209,18,1,267,251,17
1503,E02004462,ALL,898,174000,156000,107,134,329,328,112,786,557,341
1504,E02004463,ALL,502,257000,217000,174,178,113,37,13,489,462,40
1505,E02004464,ALL,523,380000,325000,292,163,62,6,2,521,515,8
1506,E02004465,ALL,446,409000,325000,140,166,74,66,0,446,381,65
1507,E02004466,ALL,507,268000,248000,79,243,139,46,5,502,457,50
1508,E02004467,ALL,686,292000,250000,113,225,215,133,186,500,530,156
1509,E02004468,ALL,867,566000,490000,520,194,29,124,8,859,739,128
1510,E02004469,ALL,496,338000,298000,165,212,67,52,0,496,442,54
1511,E02004470,ALL,1458,249000,225000,117,193,411,737,274,1184,717,741
1512,E02004471,ALL,746,294000,245000,117,161,130,338,157,589,412,334
1513,E02004472,ALL,484,377000,278000,154,193,79,58,2,482,423,61
1514,E02004473,ALL,454,198000,195000,88,260,46,60,7,447,391,63
1515,E02004474,ALL,529,233000,205000,150,313,33,33,12,517,495,34
1516,E02004475,ALL,459,222000,210000,160,230,26,43,20,439,415,44
1517,E02004476,ALL,556,288000,239000,272,219,11,54,16,540,501,55
1518,E02004477,ALL,531,263000,240000,218,279,27,7,19,512,522,9
1519,E02004478,ALL,504,204000,185000,125,150,65,164,10,494,328,176
1520,E02004479,ALL,631,232000,210000,175,354,39,63,39,592,562,69
1521,E02004480,ALL,425,184000,168000,227,117,52,29,1,424,395,30
1522,E02004481,ALL,422,164000,159000,243,138,33,8,2,420,413,9
1523,E02004482,ALL,344,157000,154000,74,148,113,9,0,344,332,12
1524,E02004483,ALL,546,191000,180000,306,179,27,34,22,524,511,35
1525,E02004484,ALL,565,171000,160000,364,148,11,42,17,548,523,42
1526,E02004485,ALL,428,316000,250000,195,100,106,27,8,420,401,27
1527,E02004486,ALL,643,259000,246000,191,275,124,53,40,603,590,53
1528,E02004487,ALL,395,232000,195000,109,141,107,38,6,389,354,41
1529,E02004488,ALL,634,199000,205000,95,204,179,156,0,634,474,160
1530,E02004489,ALL,682,330000,272000,325,182,117,58,21,661,618,64
1531,E02004490,ALL,312,193000,178000,29,134,88,61,4,308,249,63
1532,E02004491,ALL,548,246000,210000,157,162,158,71,10,538,470,78
1533,E02004492,ALL,909,212000,195000,165,250,273,221,52,857,683,226
1534,E02004493,ALL,813,232000,205000,120,241,236,216,23,790,594,219
1535,E02004494,ALL,1175,192000,185000,44,115,335,681,131,1044,486,689
1536,E02004495,ALL,502,305000,250000,133,220,105,44,21,481,453,49
1537,E02004496,ALL,684,271000,250000,146,341,110,87,75,609,590,94
1538,E02004497,ALL,585,274000,249000,192,189,98,106,20,565,458,127
1539,E02004498,ALL,813,239000,215000,164,241,221,187,179,634,622,191
1540,E02004499,ALL,445,213000,200000,31,168,235,11,0,445,433,12
1541,E02004500,ALL,590,349000,310000,339,126,95,30,10,580,562,28
1542,E02004501,ALL,393,287000,245000,136,143,87,27,2,391,364,29
1543,E02004502,ALL,422,484000,395000,236,138,36,12,6,416,404,18
1544,E02004503,ALL,646,210000,213000,185,226,116,119,8,638,511,135
1545,E02004504,ALL,630,237000,218000,313,79,155,83,3,627,532,98
1546,E02004505,ALL,306,255000,235000,122,146,20,18,4,302,288,18
1547,E02004506,ALL,503,355000,290000,314,138,28,23,68,435,479,24
1548,E02004507,ALL,792,178000,160000,228,165,285,114,0,792,677,115
1549,E02004508,ALL,436,261000,236000,228,138,44,26,24,412,408,28
1550,E02004509,ALL,1514,193000,185000,349,360,443,362,654,860,1155,359
1551,E02004512,ALL,1129,178000,158000,121,213,362,433,199,930,694,435
1552,E02004513,ALL,680,127000,127000,36,88,163,393,247,433,288,392
1553,E02004514,ALL,458,272000,211000,199,114,65,80,12,446,379,79
1554,E02004515,ALL,461,274000,228000,245,155,29,32,1,460,430,31
1555,E02004516,ALL,1135,148000,140000,77,220,727,111,269,866,1050,85
1556,E02004517,ALL,753,204000,197000,305,223,150,75,110,643,682,71
1557,E02004518,ALL,1024,214000,194000,169,328,224,303,469,555,729,295
1558,E02004519,ALL,566,216000,208000,249,250,30,37,1,565,528,38
1559,E02004520,ALL,534,167000,155000,93,140,203,98,134,400,432,102
1560,E02004521,ALL,659,163000,150000,127,222,174,136,17,642,524,135
1561,E02004522,ALL,779,232000,205000,253,289,149,88,91,688,694,85
1562,E02004523,ALL,768,159000,150000,154,264,246,104,230,538,671,97
1563,E02004524,ALL,557,304000,250000,350,149,42,16,25,532,540,17
1564,E02004525,ALL,663,213000,188000,227,270,87,79,52,611,584,79
1565,E02004526,ALL,691,262000,241000,422,139,62,68,34,657,621,70
1566,E02004527,ALL,710,270000,240000,168,163,189,190,71,639,519,191
1567,E02004528,ALL,491,389000,335000,243,169,71,8,8,483,483,8
1568,E02004529,ALL,338,528000,452000,196,104,28,10,29,309,323,15
1569,E02004530,ALL,468,294000,275000,103,199,79,87,33,435,379,89
1570,E02004531,ALL,585,394000,348000,138,213,141,93,99,486,485,100
1571,E02004532,ALL,563,357000,317000,119,147,128,169,28,535,385,178
1572,E02004533,ALL,373,217000,215000,12,144,153,64,0,373,305,68
1573,E02004534,ALL,623,222000,205000,77,130,238,178,1,622,435,188
1574,E02004535,ALL,344,328000,241000,62,85,119,78,23,321,265,79
1575,E02004536,ALL,419,482000,430000,123,187,60,49,6,413,368,51
1576,E02004537,ALL,604,211000,215000,7,178,252,167,0,604,428,176
1577,E02004538,ALL,844,425000,340000,214,242,209,179,175,669,661,183
1578,E02004539,ALL,535,264000,248000,47,153,225,110,0,535,416,119
1579,E02004540,ALL,505,458000,346000,143,116,118,128,9,496,374,131
1580,E02004541,ALL,1001,377000,340000,148,303,199,351,26,975,646,355
1581,E02004542,ALL,398,554000,440000,162,93,77,66,25,373,329,69
1582,E02004543,ALL,358,418000,370000,98,97,70,93,13,345,254,104
1583,E02004544,ALL,652,259000,234000,134,117,238,163,202,450,483,169
1584,E02004545,ALL,320,164000,160000,14,41,190,75,0,320,245,75
1585,E02004546,ALL,364,169000,156000,19,49,206,90,35,329,274,90
1586,E02004547,ALL,527,176000,163000,17,59,275,176,152,375,346,181
1587,E02004548,ALL,959,220000,210000,249,192,434,84,0,959,866,93
1588,E02004549,ALL,335,168000,158000,23,21,252,39,3,332,295,40
1589,E02004550,ALL,348,150000,150000,12,34,204,98,3,345,255,93
1590,E02004551,ALL,335,163000,155000,8,42,218,67,3,332,263,72
1591,E02004552,ALL,350,186000,170000,42,52,184,72,1,349,277,73
1592,E02004553,ALL,338,160000,150000,25,58,202,53,0,338,282,56
1593,E02004554,ALL,358,173000,160000,30,41,222,65,3,355,291,67
1594,E02004555,ALL,384,243000,210000,177,124,66,17,13,371,366,18
1595,E02004556,ALL,425,408000,315000,276,99,28,22,13,412,407,18
1596,E02004557,ALL,640,227000,201000,245,183,180,32,79,561,598,42
1597,E02004558,ALL,550,204000,178000,99,130,177,144,35,515,385,165
1598,E02004559,ALL,506,222000,209000,169,187,143,7,1,505,498,8
1599,E02004560,ALL,517,219000,197000,283,149,58,27,23,494,489,28
1600,E02004561,ALL,632,280000,240000,416,152,49,15,26,606,612,20
1601,E02004562,ALL,670,211000,182000,230,187,198,55,1,669,611,59
1602,E02004563,ALL,353,231000,220000,125,192,22,14,2,351,339,14
1603,E02004564,ALL,570,233000,215000,237,259,46,28,31,539,543,27
1604,E02004565,ALL,1093,262000,230000,387,571,80,55,40,1053,1034,59
1605,E02004566,ALL,292,221000,175000,72,92,62,66,9,283,226,66
1606,E02004567,ALL,597,256000,234000,199,296,53,49,14,583,545,52
1607,E02004568,ALL,706,231000,207000,187,311,158,50,26,680,657,49
1608,E02004569,ALL,607,190000,178000,130,246,100,131,27,580,477,130
1609,E02004570,ALL,723,244000,221000,180,363,34,146,30,693,576,147
1610,E02004571,ALL,603,254000,228000,176,328,51,48,21,582,553,50
1611,E02004572,ALL,447,200000,185000,113,210,93,31,1,446,414,33
1612,E02004575,ALL,880,210000,182000,303,290,173,114,53,827,764,116
1613,E02004576,ALL,8,287000,230000,5,2,1,0,0,8,8,0
1614,E02004577,ALL,318,272000,215000,164,108,34,12,8,310,295,23
1615,E02004579,ALL,462,208000,185000,276,149,37,0,18,444,461,1
1616,E02004580,ALL,78,203000,185000,46,25,4,3,1,77,72,6
1617,E02004581,ALL,567,218000,188000,272,238,42,15,21,546,553,14
1618,E02004582,ALL,616,152000,140000,241,324,36,15,35,581,601,15
1619,E02004583,ALL,699,167000,154000,234,261,136,68,10,689,630,69
1620,E02004584,ALL,775,168000,161000,421,215,26,113,6,769,658,117
1621,E02004585,ALL,721,156000,145000,378,262,71,10,109,612,711,10
1622,E02004586,ALL,714,157000,140000,273,166,83,192,34,680,526,188
1623,E02004587,ALL,486,131000,126000,185,155,108,38,1,485,446,40
1624,E02004588,ALL,462,114000,110000,46,105,80,231,22,440,247,215
1625,E02004589,ALL,525,144000,132000,184,147,86,108,5,520,413,112
1626,E02004590,ALL,656,121000,115000,400,185,50,21,5,651,630,26
1627,E02004591,ALL,492,372000,310000,213,136,105,38,7,485,451,41
1628,E02004592,ALL,1186,259000,220000,224,287,368,307,128,1058,876,310
1629,E02004593,ALL,581,444000,375000,330,155,95,1,52,529,579,2
1630,E02004594,ALL,453,383000,320000,250,112,84,7,15,438,442,11
1631,E02004595,ALL,1334,325000,287000,573,348,327,86,412,922,1243,91
1632,E02004596,ALL,1004,326000,300000,515,258,215,16,493,511,975,29
1633,E02004597,ALL,841,259000,249000,332,188,137,184,238,603,654,187
1634,E02004598,ALL,787,334000,265000,377,210,165,35,92,695,750,37
1635,E02004599,ALL,474,418000,362000,287,114,62,11,11,463,462,12
1636,E02004675,ALL,557,215000,201000,116,215,187,39,55,502,512,45
1637,E02004676,ALL,563,283000,248000,255,114,160,34,16,547,520,43
1638,E02004677,ALL,415,464000,382000,248,95,60,12,73,342,401,14
1639,E02004678,ALL,488,356000,250000,210,135,107,36,16,472,450,38
1640,E02004679,ALL,654,326000,256000,291,160,152,51,139,515,610,44
1641,E02004680,ALL,1078,247000,235000,319,223,425,111,349,729,975,103
1642,E02004681,ALL,1141,182000,170000,165,123,583,270,552,589,873,268
1643,E02004682,ALL,625,229000,215000,207,110,186,122,8,617,500,125
1644,E02004683,ALL,384,181000,175000,12,133,133,106,16,368,274,110
1645,E02004684,ALL,1008,206000,205000,161,147,521,179,452,556,830,178
1646,E02004685,ALL,666,172000,162000,45,92,187,342,151,515,268,398
1647,E02004686,ALL,731,184000,170000,40,104,303,284,196,535,442,289
1648,E02004687,ALL,449,203000,176000,107,75,230,37,76,373,411,38
1649,E02004688,ALL,409,176000,165000,43,125,200,41,0,409,364,45
1650,E02004689,ALL,381,304000,280000,215,102,54,10,12,369,370,11
1651,E02004690,ALL,693,203000,180000,80,223,228,162,103,590,528,165
1652,E02004691,ALL,460,452000,360000,291,87,54,28,23,437,432,28
1653,E02004692,ALL,526,290000,270000,313,157,44,12,7,519,511,15
1654,E02004693,ALL,519,178000,169000,64,85,308,62,29,490,455,64
1655,E02004694,ALL,474,313000,250000,155,127,161,31,44,430,440,34
1656,E02004695,ALL,772,244000,242000,339,126,260,47,0,772,722,50
1657,E02004696,ALL,454,309000,266000,165,119,128,42,69,385,406,48
1658,E02004697,ALL,471,432000,365000,218,132,92,29,80,391,442,29
1659,E02004698,ALL,390,208000,188000,36,88,101,165,28,362,221,169
1660,E02004699,ALL,983,257000,237000,243,244,294,202,42,941,770,213
1661,E02004700,ALL,323,229000,165000,67,70,106,80,29,294,242,81
1662,E02004702,ALL,635,197000,178000,147,131,291,66,44,591,570,65
1663,E02004703,ALL,927,446000,388000,636,166,95,30,153,774,894,33
1664,E02004704,ALL,362,342000,268000,184,77,89,12,1,361,351,11
1665,E02004705,ALL,819,357000,310000,332,149,157,181,128,691,621,198
1666,E02004706,ALL,600,359000,285000,252,177,117,54,32,568,540,60
1667,E02004707,ALL,832,416000,367000,397,164,169,102,37,795,720,112
1668,E02004708,ALL,775,260000,228000,110,158,261,246,38,737,528,247
1669,E02004709,ALL,620,252000,238000,309,170,74,67,86,534,556,64
1670,E02004710,ALL,464,276000,245000,249,111,100,4,57,407,460,4
1671,E02004719,ALL,2,268000,268000,0,2,0,0,0,2,2,0
1672,E02004751,ALL,525,290000,245000,158,177,178,12,5,520,513,12
1673,E02004752,ALL,580,304000,250000,178,169,194,39,1,579,541,39
1674,E02004753,ALL,704,269000,233000,244,138,273,49,9,695,653,51
1675,E02004754,ALL,516,416000,350000,203,81,188,44,105,411,467,49
1676,E02004755,ALL,1274,294000,250000,380,216,265,413,28,1246,851,423
1677,E02004756,ALL,645,328000,296000,326,122,157,40,5,640,587,58
1678,E02004757,ALL,596,373000,357000,380,134,45,37,16,580,558,38
1679,E02004758,ALL,635,417000,350000,306,158,109,62,142,493,571,64
1680,E02004759,ALL,692,290000,270000,245,285,89,73,25,667,616,76
1681,E02004760,ALL,715,406000,340000,347,119,211,38,129,586,668,47
1682,E02004761,ALL,354,418000,345000,152,79,89,34,3,351,317,37
1683,E02004764,ALL,555,211000,202000,227,243,47,38,45,510,519,36
1684,E02004765,ALL,504,217000,200000,182,147,129,46,17,487,458,46
1685,E02004766,ALL,437,174000,165000,76,136,112,113,47,390,326,111
1686,E02004767,ALL,286,139000,133000,1,54,182,49,50,236,236,50
1687,E02004768,ALL,346,177000,160000,75,70,178,23,1,345,323,23
1688,E02004769,ALL,239,127000,128000,0,73,130,36,7,232,206,33
1689,E02004770,ALL,295,134000,135000,5,82,181,27,4,291,268,27
1690,E02004771,ALL,369,135000,133000,13,117,190,49,12,357,318,51
1691,E02004772,ALL,700,206000,197000,183,273,175,69,62,638,631,69
1692,E02004774,ALL,888,318000,268000,348,229,195,116,123,765,757,131
1693,E02004775,ALL,716,238000,205000,257,122,189,148,34,682,569,147
1694,E02004776,ALL,300,282000,250000,161,81,36,22,2,298,279,21
1695,E02004777,ALL,347,231000,212000,155,77,50,65,6,341,284,63
1696,E02004778,ALL,551,218000,210000,276,103,38,134,11,540,417,134
1697,E02004802,ALL,382,211000,200000,46,183,78,75,9,373,306,76
1698,E02004803,ALL,319,175000,166000,10,74,205,30,2,317,287,32
1699,E02004804,ALL,556,213000,210000,71,200,261,24,6,550,531,25
1700,E02004805,ALL,933,246000,228000,219,156,176,382,319,614,552,381
1701,E02004806,ALL,684,248000,240000,204,236,205,39,18,666,640,44
1702,E02004807,ALL,798,201000,195000,80,295,188,235,83,715,559,239
1703,E02004808,ALL,1028,212000,203000,154,201,260,413,304,724,619,409
1704,E02004809,ALL,305,139000,135000,1,4,77,223,12,293,82,223
1705,E02004810,ALL,614,188000,188000,43,205,232,134,6,608,479,135
1706,E02004811,ALL,629,209000,190000,96,140,213,180,14,615,454,175
1707,E02004812,ALL,494,228000,220000,112,180,118,84,28,466,407,87
1708,E02004813,ALL,333,188000,184000,16,123,162,32,1,332,300,33
1709,E02004814,ALL,352,291000,235000,198,80,71,3,1,351,347,5
1710,E02004815,ALL,295,134000,128000,12,38,217,28,0,295,274,21
1711,E02004816,ALL,1102,218000,208000,386,261,305,150,602,500,978,124
1712,E02004817,ALL,317,161000,152000,25,101,111,80,20,297,236,81
1713,E02004819,ALL,209,196000,168000,58,41,49,61,12,197,141,68
1714,E02004821,ALL,183,476000,450000,102,59,18,4,2,181,179,4
1715,E02004829,ALL,366,355000,319000,145,110,97,14,50,316,350,16
1716,E02004830,ALL,506,408000,330000,241,128,92,45,49,457,459,47
1717,E02004831,ALL,674,422000,352000,302,194,124,54,75,599,616,58
1718,E02004832,ALL,643,367000,310000,257,157,179,50,41,602,585,58
1719,E02004833,ALL,772,403000,334000,175,188,249,160,101,671,604,168
1720,E02004834,ALL,492,333000,268000,40,90,241,121,48,444,349,143
1721,E02004835,ALL,1190,381000,320000,89,96,456,549,174,1016,634,556
1722,E02004836,ALL,236,385000,239000,41,107,35,53,9,227,183,53
1723,E02004837,ALL,516,346000,290000,244,96,149,27,15,501,490,26
1724,E02004838,ALL,219,555000,428000,117,54,40,8,13,206,210,9
1725,E02004839,ALL,525,431000,375000,288,127,91,19,44,481,504,21
1726,E02004840,ALL,821,269000,232000,271,225,227,98,50,771,721,100
1727,E02004841,ALL,120,358000,320000,55,41,17,7,10,110,111,9
1728,E02004842,ALL,744,265000,233000,272,223,152,97,182,562,662,82
1729,E02004843,ALL,440,270000,247000,72,137,166,65,2,438,376,64
1730,E02004844,ALL,505,219000,217000,40,176,219,70,9,496,434,71
1731,E02004845,ALL,833,234000,187000,117,123,177,416,125,708,418,415
1732,E02004846,ALL,480,406000,383000,183,118,76,103,23,457,376,104
1733,E02004847,ALL,887,226000,210000,57,173,356,301,234,653,585,302
1734,E02004848,ALL,587,274000,250000,89,181,226,91,157,430,504,83
1735,E02004849,ALL,441,404000,365000,207,136,70,28,5,436,405,36
1736,E02004850,ALL,455,218000,222000,30,144,185,96,10,445,359,96
1737,E02004851,ALL,390,215000,208000,39,35,249,67,2,388,318,72
1738,E02004852,ALL,524,213000,218000,25,171,159,169,2,522,350,174
1739,E02004853,ALL,374,234000,226000,35,113,185,41,3,371,332,42
1740,E02004854,ALL,533,207000,210000,26,142,199,166,30,503,364,169
1741,E02004855,ALL,391,177000,175000,4,33,173,181,45,346,207,184
1742,E02004856,ALL,433,329000,250000,88,119,189,37,12,421,397,36
1743,E02004857,ALL,544,319000,285000,106,124,232,82,21,523,457,87
1744,E02004858,ALL,396,289000,249000,90,109,183,14,0,396,378,18
1745,E02004859,ALL,391,444000,378000,168,80,107,36,8,383,343,48
1746,E02004860,ALL,422,180000,178000,36,76,116,194,24,398,227,195
1747,E02004861,ALL,484,531000,386000,213,106,125,40,11,473,441,43
1748,E02004862,ALL,385,173000,175000,14,40,258,73,15,370,315,70
1749,E02004863,ALL,352,176000,174000,17,52,178,105,13,339,247,105
1750,E02004864,ALL,753,404000,323000,160,141,251,201,41,712,537,216
1751,E02004865,ALL,397,225000,207000,41,64,206,86,10,387,310,87
1752,E02004866,ALL,384,230000,205000,62,61,227,34,2,382,351,33
1753,E02004867,ALL,568,468000,387000,171,153,114,130,78,490,435,133
1754,E02004868,ALL,319,240000,227000,47,107,108,57,2,317,259,60
1755,E02004869,ALL,564,426000,375000,121,114,199,130,15,549,434,130
1756,E02004870,ALL,1098,210000,197000,65,157,248,628,326,772,467,631
1757,E02004871,ALL,302,231000,214000,30,70,161,41,0,302,259,43
1758,E02004872,ALL,478,304000,264000,158,101,145,74,48,430,405,73
1759,E02004873,ALL,1099,273000,245000,175,225,315,384,99,1000,709,390
1760,E02004874,ALL,379,226000,218000,76,131,116,56,3,376,321,58
1761,E02004875,ALL,598,258000,234000,74,156,268,100,94,504,491,107
1762,E02004876,ALL,583,511000,380000,266,131,121,65,10,573,516,67
1763,E02004877,ALL,403,383000,335000,152,119,66,66,11,392,334,69
1764,E02004878,ALL,575,324000,285000,184,142,225,24,121,454,553,22
1765,E02004879,ALL,435,431000,352000,204,99,104,28,20,415,402,33
1766,E02004880,ALL,744,390000,340000,367,139,162,76,44,700,656,88
1767,E02004881,ALL,719,265000,222000,144,143,137,295,115,604,426,293
1768,E02004882,ALL,564,293000,245000,117,174,127,146,78,486,417,147
1769,E02004883,ALL,383,340000,264000,99,104,124,56,2,381,320,63
1770,E02004884,ALL,848,229000,215000,159,228,287,174,46,802,671,177
1771,E02004885,ALL,640,312000,275000,283,159,146,52,4,636,586,54
1772,E02004886,ALL,324,486000,372000,127,100,90,7,18,306,317,7
1773,E02004887,ALL,453,478000,375000,167,102,130,54,53,400,394,59
1774,E02004888,ALL,743,311000,275000,223,213,175,132,68,675,607,136
1775,E02004889,ALL,921,253000,240000,65,279,296,281,82,839,620,301
1776,E02004890,ALL,801,245000,220000,100,138,215,348,59,742,444,357
1777,E02004891,ALL,796,344000,290000,122,199,345,130,76,720,662,134
1778,E02004892,ALL,379,281000,222000,42,93,175,69,2,377,297,82
1779,E02004893,ALL,550,282000,245000,103,142,237,68,18,532,477,73
1780,E02004894,ALL,1089,305000,241000,114,115,318,542,204,885,533,556
1781,E02004895,ALL,653,326000,270000,161,144,202,146,45,608,497,156
1782,E02004896,ALL,603,361000,325000,177,194,70,162,18,585,432,171
1783,E02004897,ALL,443,313000,312000,45,284,24,90,5,438,351,92
1784,E02004898,ALL,401,269000,250000,27,178,88,108,3,398,290,111
1785,E02004899,ALL,406,415000,350000,135,110,127,34,16,390,365,41
1786,E02004900,ALL,611,769000,600000,320,101,55,135,22,589,472,139
1787,E02004901,ALL,470,244000,230000,12,140,156,162,103,367,303,167
1788,E02004902,ALL,469,257000,235000,30,82,251,106,4,465,361,108
1789,E02004903,ALL,483,299000,270000,67,150,125,141,134,349,341,142
1790,E02004904,ALL,407,241000,232000,26,79,215,87,5,402,320,87
1791,E02004905,ALL,516,532000,368000,144,70,103,199,63,453,312,204
1792,E02004906,ALL,718,270000,250000,27,228,226,237,109,609,477,241
1793,E02004907,ALL,833,356000,320000,150,177,227,279,125,708,547,286
1794,E02004908,ALL,704,403000,331000,188,156,122,238,28,676,465,239
1795,E02004909,ALL,456,199000,180000,75,92,169,120,35,421,334,122
1796,E02004910,ALL,1045,257000,215000,311,266,295,173,90,955,865,180
1797,E02004911,ALL,398,187000,175000,23,102,207,66,28,370,321,77
1798,E02004912,ALL,851,220000,194000,114,252,297,188,105,746,647,204
1799,E02004913,ALL,1207,313000,248000,397,307,402,101,114,1093,1100,107
1800,E02004914,ALL,669,223000,200000,85,141,263,180,208,461,240,429
1801,E02004915,ALL,414,186000,175000,33,104,169,108,72,342,142,272
1802,E02004916,ALL,493,338000,295000,193,112,66,122,25,468,282,211
1803,E02004917,ALL,319,221000,178000,95,24,157,43,1,318,188,131
1804,E02004918,ALL,847,224000,209000,47,189,275,336,120,727,506,341
1805,E02004919,ALL,488,226000,217000,53,229,177,29,6,482,454,34
1806,E02004920,ALL,962,265000,221000,202,211,185,364,159,803,582,380
1807,E02004921,ALL,726,288000,250000,136,239,155,196,60,666,529,197
1808,E02004922,ALL,512,376000,300000,220,138,128,26,16,496,481,31
1809,E02004923,ALL,792,362000,282000,257,210,228,97,21,771,691,101
1810,E02004924,ALL,672,510000,475000,255,209,112,96,21,651,575,97
1811,E02004925,ALL,652,483000,385000,182,227,150,93,17,635,554,98
1812,E02004926,ALL,791,681000,568000,242,215,90,244,48,743,539,252
1813,E02004927,ALL,513,444000,390000,201,149,104,59,50,463,453,60
1814,E02004928,ALL,591,634000,422000,261,162,119,49,13,578,539,52
1815,E02004929,ALL,504,429000,346000,173,124,141,66,15,489,440,64
1816,E02004930,ALL,602,339000,275000,145,135,212,110,5,597,479,123
1817,E02004931,ALL,494,369000,328000,56,230,63,145,1,493,346,148
1818,E02004932,ALL,622,378000,348000,73,223,266,60,9,613,557,65
1819,E02004933,ALL,567,571000,475000,179,135,203,50,10,557,519,48
1820,E02004934,ALL,964,379000,285000,112,113,205,534,77,887,436,528
1821,E02004935,ALL,1274,338000,295000,50,166,397,661,293,981,612,662
1822,E02004936,ALL,587,339000,330000,67,203,201,116,42,545,470,117
1823,E02004937,ALL,718,503000,460000,190,140,285,103,140,578,605,113
1824,E02004938,ALL,422,376000,355000,153,141,81,47,24,398,372,50
1825,E02004939,ALL,384,367000,291000,74,110,109,91,3,381,281,103
1826,E02004940,ALL,542,306000,273000,27,152,204,159,3,539,378,164
1827,E02004941,ALL,668,266000,242000,76,137,247,208,40,628,452,216
1828,E02004942,ALL,480,339000,320000,142,132,130,76,89,391,408,72
1829,E02004943,ALL,569,413000,392000,265,207,43,54,15,554,518,51
1830,E02004944,ALL,436,180000,162000,36,60,236,104,171,265,331,105
1831,E02004945,ALL,898,231000,191000,174,195,253,276,185,713,616,282
1832,E02004946,ALL,306,173000,169000,27,28,198,53,0,306,254,52
1833,E02004947,ALL,499,203000,190000,127,147,218,7,0,499,495,4
1834,E02004948,ALL,301,168000,165000,20,37,154,90,2,299,211,90
1835,E02004949,ALL,510,165000,160000,13,59,233,205,105,405,300,210
1836,E02004950,ALL,340,171000,163000,27,41,235,37,0,340,299,41
1837,E02004951,ALL,315,152000,155000,9,29,179,98,1,314,218,97
1838,E02004952,ALL,392,183000,165000,73,39,221,59,6,386,335,57
1839,E02004953,ALL,295,170000,158000,13,65,204,13,11,284,282,13
1840,E02004954,ALL,351,188000,170000,35,67,210,39,21,330,313,38
1841,E02004955,ALL,345,205000,187000,54,35,227,29,48,297,318,27
1842,E02004956,ALL,642,316000,270000,137,201,151,153,11,631,483,159
1843,E02004957,ALL,679,288000,250000,126,195,263,95,60,619,576,103
1844,E02004958,ALL,615,425000,385000,169,284,95,67,112,503,549,66
1845,E02004959,ALL,605,599000,475000,304,34,29,238,59,546,347,258
1846,E02004960,ALL,486,564000,500000,232,107,39,108,30,456,374,112
1847,E02004961,ALL,812,366000,327000,129,363,213,107,79,733,701,111
1848,E02004962,ALL,703,373000,310000,179,172,186,166,32,671,532,171
1849,E02004963,ALL,367,273000,225000,46,162,136,23,3,364,344,23
1850,E02004964,ALL,396,285000,250000,43,177,123,53,39,357,343,53
1851,E02004965,ALL,456,267000,250000,83,235,91,47,3,453,404,52
1852,E02004966,ALL,382,837000,730000,244,47,15,76,30,352,306,76
1853,E02004967,ALL,385,193000,194000,5,100,201,79,0,385,306,79
1854,E02004968,ALL,489,238000,230000,42,140,146,161,42,447,328,161
1855,E02004969,ALL,453,261000,245000,70,186,109,88,27,426,364,89
1856,E02004970,ALL,607,207000,205000,16,137,104,350,192,415,255,352
1857,E02004971,ALL,603,220000,210000,33,188,136,246,176,427,346,257
1858,E02004972,ALL,398,263000,270000,8,232,48,110,0,398,286,112
1859,E02004973,ALL,752,202000,205000,2,60,543,147,21,731,605,147
1860,E02004974,ALL,923,330000,250000,166,97,172,488,295,628,429,494
1861,E02004975,ALL,627,424000,396000,221,119,39,248,78,549,377,250
1862,E02004976,ALL,1021,192000,192000,4,44,346,627,297,724,389,632
1863,E02004977,ALL,489,213000,210000,7,36,392,54,1,488,432,57
1864,E02004978,ALL,512,201000,196000,9,73,149,281,73,439,221,291
1865,E02004979,ALL,544,328000,250000,97,121,191,135,51,493,408,136
1866,E02004980,ALL,482,479000,430000,295,85,64,38,18,464,446,36
1867,E02004981,ALL,570,348000,285000,146,136,202,86,55,515,485,85
1868,E02004982,ALL,374,340000,275000,94,82,162,36,6,368,260,114
1869,E02004983,ALL,328,205000,210000,9,48,190,81,0,328,231,97
1870,E02004984,ALL,475,218000,198000,92,60,184,139,1,474,341,134
1871,E02004985,ALL,468,355000,323000,67,132,143,126,32,436,197,271
1872,E02004986,ALL,498,195000,195000,7,86,213,192,157,341,295,203
1873,E02004987,ALL,413,243000,223000,52,104,239,18,28,385,356,57
1874,E02004988,ALL,498,221000,210000,12,111,233,142,0,498,338,160
1875,E02004989,ALL,562,232000,206000,44,135,201,182,110,452,378,184
1876,E02004990,ALL,423,310000,245000,73,73,176,101,53,370,300,123
1877,E02004991,ALL,362,189000,185000,20,48,175,119,56,306,237,125
1878,E02004992,ALL,395,187000,185000,15,53,267,60,0,395,331,64
1879,E02004993,ALL,308,260000,240000,41,83,134,50,2,306,254,54
1880,E02004994,ALL,441,594000,499000,191,145,29,76,27,414,365,76
1881,E02004995,ALL,418,577000,473000,291,62,16,49,14,404,363,55
1882,E02004996,ALL,623,288000,248000,256,155,177,35,37,586,567,56
1883,E02004997,ALL,469,339000,285000,244,126,79,20,2,467,449,20
1884,E02004998,ALL,486,227000,199000,193,215,62,16,9,477,464,22
1885,E02004999,ALL,1173,181000,165000,253,316,385,219,260,913,947,226
1886,E02005000,ALL,870,154000,150000,67,209,414,180,256,614,684,186
1887,E02005001,ALL,612,191000,175000,167,252,168,25,42,570,586,26
1888,E02005002,ALL,652,150000,141000,63,224,299,66,38,614,572,80
1889,E02005003,ALL,620,155000,143000,80,212,241,87,125,495,522,98
1890,E02005004,ALL,876,189000,180000,336,202,277,61,50,826,797,79
1891,E02005005,ALL,730,276000,240000,382,169,158,21,274,456,709,21
1892,E02005006,ALL,293,384000,280000,150,78,60,5,0,293,285,8
1893,E02005007,ALL,680,254000,209000,291,187,170,32,44,636,639,41
1894,E02005008,ALL,670,314000,265000,299,149,150,72,10,660,590,80
1895,E02005009,ALL,356,328000,250000,163,122,69,2,3,353,354,2
1896,E02005010,ALL,633,165000,148000,109,94,151,279,7,626,351,282
1897,E02005011,ALL,622,222000,222000,360,146,94,22,39,583,589,33
1898,E02005012,ALL,681,189000,175000,286,230,113,52,22,659,632,49
1899,E02005013,ALL,719,191000,175000,333,252,92,42,27,692,680,39
1900,E02005014,ALL,872,269000,240000,439,285,55,93,9,863,784,88
1901,E02005015,ALL,835,194000,180000,282,293,171,89,157,678,746,89
1902,E02005016,ALL,726,245000,220000,255,244,111,116,51,675,609,117
1903,E02005017,ALL,1047,235000,215000,157,186,516,188,43,1004,856,191
1904,E02005018,ALL,768,242000,216000,356,243,109,60,107,661,707,61
1905,E02005019,ALL,386,273000,220000,154,122,92,18,22,364,367,19
1906,E02005020,ALL,421,205000,170000,74,257,77,13,10,411,407,14
1907,E02005021,ALL,427,283000,250000,163,184,60,20,3,424,408,19
1908,E02005022,ALL,394,235000,220000,98,108,140,48,1,393,344,50
1909,E02005023,ALL,488,204000,185000,12,102,192,182,135,353,299,189
1910,E02005025,ALL,681,261000,233000,161,186,175,159,63,618,517,164
1911,E02005026,ALL,605,263000,215000,223,164,163,55,29,576,551,54
1912,E02005027,ALL,336,305000,248000,148,117,49,22,3,333,309,27
1913,E02005028,ALL,659,179000,185000,6,84,372,197,379,280,455,204
1914,E02005029,ALL,981,191000,180000,79,170,303,429,239,742,544,437
1915,E02005030,ALL,768,198000,185000,63,143,393,169,123,645,602,166
1916,E02005031,ALL,537,177000,164000,30,63,248,196,115,422,341,196
1917,E02005032,ALL,684,154000,154000,16,117,411,140,3,681,542,142
1918,E02005033,ALL,658,189000,175000,21,84,230,323,212,446,305,353
1919,E02005034,ALL,461,230000,225000,55,223,154,29,13,448,429,32
1920,E02005035,ALL,472,200000,199000,54,173,157,88,41,431,384,88
1921,E02005036,ALL,286,187000,175000,13,82,167,24,6,280,257,29
1922,E02005037,ALL,471,310000,275000,111,177,158,25,10,461,446,25
1923,E02005038,ALL,370,282000,242000,121,145,87,17,12,358,351,19
1924,E02005039,ALL,331,211000,196000,33,166,120,12,1,330,318,13
1925,E02005040,ALL,433,336000,320000,233,107,48,45,85,348,386,47
1926,E02005041,ALL,233,290000,235000,94,75,56,8,12,221,222,11
1927,E02005046,ALL,188,133000,124000,7,89,88,4,3,185,184,4
1928,E02005048,ALL,13,415000,385000,10,2,1,0,0,13,13,0
1929,E02005055,ALL,370,140000,135000,14,52,222,82,19,351,285,85
1930,E02005056,ALL,492,154000,140000,16,65,176,235,12,480,255,237
1931,E02005057,ALL,654,152000,144000,45,129,255,225,100,554,431,223
1932,E02005058,ALL,441,158000,150000,27,51,343,20,25,416,420,21
1933,E02005059,ALL,600,211000,192000,55,139,322,84,0,600,514,86
1934,E02005060,ALL,476,191000,180000,37,198,150,91,111,365,386,90
1935,E02005061,ALL,327,170000,166000,28,175,93,31,6,321,291,36
1936,E02005062,ALL,362,191000,187000,9,199,135,19,0,362,344,18
1937,E02005063,ALL,379,228000,195000,89,128,133,29,51,328,348,31
1938,E02005064,ALL,415,311000,250000,176,164,70,5,14,401,410,5
1939,E02005065,ALL,503,170000,165000,20,116,322,45,118,385,447,56
1940,E02005066,ALL,518,291000,265000,193,271,36,18,3,515,500,18
1941,E02005067,ALL,366,348000,299000,196,57,111,2,6,360,365,1
1942,E02005068,ALL,494,233000,199000,183,107,186,18,16,478,477,17
1943,E02005069,ALL,717,220000,200000,157,230,246,84,35,682,627,90
1944,E02005070,ALL,679,232000,218000,167,375,98,39,22,657,641,38
1945,E02005071,ALL,771,148000,145000,12,82,357,320,98,673,450,321
1946,E02005072,ALL,613,263000,242000,228,228,103,54,26,587,555,58
1947,E02005073,ALL,1106,168000,150000,73,135,315,583,308,798,523,583
1948,E02005074,ALL,764,271000,231000,240,342,148,34,29,735,726,38
1949,E02005075,ALL,692,206000,197000,107,186,290,109,52,640,577,115
1950,E02005076,ALL,612,168000,160000,36,165,343,68,44,568,545,67
1951,E02005077,ALL,462,192000,178000,44,225,137,56,65,397,377,85
1952,E02005078,ALL,513,310000,250000,220,141,109,43,42,471,456,57
1953,E02005079,ALL,651,240000,221000,206,238,138,69,146,505,574,77
1954,E02005080,ALL,554,174000,165000,60,210,238,46,131,423,504,50
1955,E02005081,ALL,402,293000,250000,118,156,99,29,8,394,364,38
1956,E02005082,ALL,799,244000,212000,271,227,240,61,165,634,730,69
1957,E02005083,ALL,584,242000,217000,168,248,127,41,110,474,531,53
1958,E02005084,ALL,419,327000,275000,172,132,84,31,58,361,385,34
1959,E02005085,ALL,383,339000,265000,113,126,114,30,22,361,345,38
1960,E02005086,ALL,411,252000,220000,101,176,125,9,14,397,400,11
1961,E02005087,ALL,464,237000,218000,98,189,133,44,23,441,419,45
1962,E02005088,ALL,458,179000,175000,33,162,186,77,23,435,367,91
1963,E02005089,ALL,324,245000,219000,46,133,115,30,1,323,293,31
1964,E02005090,ALL,332,379000,360000,197,86,44,5,8,324,327,5
1965,E02005091,ALL,670,257000,185000,115,91,165,299,185,485,356,314
1966,E02005093,ALL,330,325000,250000,154,124,45,7,4,326,322,8
1967,E02005094,ALL,691,389000,310000,230,164,205,92,75,616,592,99
1968,E02005095,ALL,553,455000,375000,258,197,85,13,47,506,528,25
1969,E02005096,ALL,752,362000,276000,149,262,235,106,13,739,635,117
1970,E02005097,ALL,690,656000,525000,431,146,85,28,22,668,658,32
1971,E02005098,ALL,782,658000,487000,347,105,124,206,65,717,567,215
1972,E02005099,ALL,573,476000,340000,200,160,171,42,48,525,523,50
1973,E02005100,ALL,646,265000,233000,144,145,257,100,66,580,535,111
1974,E02005101,ALL,364,536000,462000,161,77,72,54,32,332,308,56
1975,E02005102,ALL,411,280000,245000,211,132,44,24,7,404,383,28
1976,E02005103,ALL,155,186000,165000,39,76,31,9,55,100,145,10
1977,E02005106,ALL,120,173000,170000,16,72,31,1,5,115,120,0
1978,E02005109,ALL,676,305000,270000,333,154,64,125,56,620,544,132
1979,E02005110,ALL,511,240000,219000,301,175,33,2,2,509,507,4
1980,E02005111,ALL,703,196000,180000,90,178,246,189,12,691,512,191
1981,E02005112,ALL,511,198000,170000,201,247,48,15,5,506,496,15
1982,E02005113,ALL,641,210000,199000,328,139,97,77,12,629,558,83
1983,E02005114,ALL,431,171000,162000,166,181,78,6,1,430,426,5
1984,E02005115,ALL,342,106000,100000,12,42,262,26,10,332,319,23
1985,E02005116,ALL,259,111000,110000,6,89,131,33,2,257,226,33
1986,E02005117,ALL,461,184000,173000,251,143,45,22,68,393,436,25
1987,E02005118,ALL,832,157000,155000,206,256,306,64,300,532,763,69
1988,E02005119,ALL,343,152000,140000,92,134,112,5,38,305,339,4
1989,E02005120,ALL,512,174000,145000,277,118,102,15,27,485,496,16
1990,E02005121,ALL,914,174000,167000,267,294,294,59,97,817,853,61
1991,E02005122,ALL,411,233000,197000,142,129,131,9,12,399,400,11
1992,E02005123,ALL,826,189000,165000,235,260,263,68,73,753,749,77
1993,E02005124,ALL,482,120000,118000,17,81,252,132,2,480,350,132
1994,E02005125,ALL,624,144000,139000,45,144,369,66,205,419,557,67
1995,E02005126,ALL,536,178000,168000,74,305,144,13,0,536,521,15
1996,E02005127,ALL,627,241000,215000,228,216,126,57,56,571,572,55
1997,E02005128,ALL,635,190000,170000,90,219,279,47,42,593,587,48
1998,E02005129,ALL,1111,181000,160000,57,167,568,319,216,895,793,318
1999,E02005130,ALL,437,256000,185000,127,122,163,25,16,421,407,30
2000,E02005131,ALL,367,294000,233000,138,122,88,19,30,337,347,20
2001,E02005139,ALL,154,220000,204000,68,19,19,48,2,152,103,51
2002,E02005145,ALL,72,236000,196000,23,32,9,8,0,72,63,9
2003,E02005149,ALL,735,206000,185000,159,223,331,22,13,722,714,21
2004,E02005150,ALL,829,179000,165000,74,246,418,91,153,676,731,98
2005,E02005151,ALL,894,207000,192000,179,310,328,77,30,864,810,84
2006,E02005153,ALL,510,222000,205000,74,288,122,26,44,466,481,29
2007,E02005154,ALL,830,426000,304000,323,231,214,62,33,797,764,66
2008,E02005155,ALL,1245,341000,310000,541,302,297,105,412,833,1130,115
2009,E02005156,ALL,459,298000,242000,144,159,118,38,20,439,415,44
2010,E02005157,ALL,290,304000,250000,68,166,48,8,4,286,277,13
2011,E02005158,ALL,509,400000,315000,210,210,51,38,29,480,472,37
2012,E02005159,ALL,463,327000,290000,172,254,29,8,10,453,447,16
2013,E02005160,ALL,1060,251000,209000,115,232,237,476,117,943,576,484
2014,E02005161,ALL,727,259000,232000,92,266,270,99,86,641,620,107
2015,E02005162,ALL,602,259000,230000,169,219,170,44,11,591,557,45
2016,E02005163,ALL,655,308000,245000,154,232,194,75,7,648,578,77
2017,E02005164,ALL,585,247000,205000,103,235,146,101,0,585,477,108
2018,E02005165,ALL,496,334000,284000,214,167,80,35,8,488,462,34
2019,E02005166,ALL,351,225000,186000,47,98,116,90,4,347,255,96
2020,E02005167,ALL,545,482000,390000,254,164,101,26,21,524,512,33
2021,E02005168,ALL,788,337000,269000,128,273,110,277,49,739,515,273
2022,E02005169,ALL,1056,255000,183000,59,94,196,707,137,919,337,719
2023,E02005170,ALL,1009,320000,250000,149,276,248,336,59,950,664,345
2024,E02005171,ALL,473,274000,200000,51,98,188,136,43,430,333,140
2025,E02005172,ALL,473,450000,372000,209,147,92,25,7,466,445,28
2026,E02005173,ALL,879,434000,360000,299,116,184,280,20,859,594,285
2027,E02005174,ALL,408,346000,271000,158,129,102,19,2,406,387,21
2028,E02005175,ALL,520,346000,257000,203,138,139,40,5,515,481,39
2029,E02005623,ALL,282,222000,190000,119,99,46,18,15,267,255,27
2030,E02005632,ALL,286,221000,200000,160,82,44,0,3,283,285,1
2031,E02005633,ALL,636,145000,130000,235,268,124,9,17,619,626,10
2032,E02005634,ALL,651,138000,130000,215,212,188,36,128,523,621,30
2033,E02005635,ALL,753,165000,148000,283,230,200,40,48,705,715,38
2034,E02005636,ALL,981,148000,135000,302,324,289,66,232,749,917,64
2035,E02005637,ALL,676,110000,102000,67,124,345,140,40,636,536,140
2036,E02005638,ALL,738,170000,157000,332,322,83,1,0,738,737,1
2037,E02005650,ALL,238,141000,140000,46,124,61,7,0,238,231,7
2038,E02005651,ALL,506,157000,148000,135,282,58,31,40,466,477,29
2039,E02005652,ALL,132,134000,125000,14,58,48,12,7,125,118,14
2040,E02005653,ALL,363,110000,97000,72,82,185,24,0,363,348,15
2041,E02005654,ALL,446,128000,110000,116,137,175,18,9,437,421,25
2042,E02005655,ALL,431,164000,155000,145,167,97,22,1,430,391,40
2043,E02005656,ALL,206,110000,100000,32,36,131,7,0,206,203,3
2044,E02005657,ALL,386,159000,138000,51,149,143,43,12,374,342,44
2045,E02005658,ALL,327,119000,116000,9,72,245,1,0,327,326,1
2046,E02005659,ALL,471,153000,147000,31,304,88,48,78,393,413,58
2047,E02005660,ALL,278,154000,126000,106,74,93,5,7,271,271,7
2048,E02005661,ALL,365,129000,118000,9,122,170,64,59,306,301,64
2049,E02005662,ALL,454,157000,145000,12,117,294,31,3,451,424,30
2050,E02005664,ALL,455,141000,125000,12,75,307,61,4,451,391,64
2051,E02005665,ALL,545,170000,140000,219,160,150,16,67,478,528,17
2052,E02005666,ALL,294,105000,105000,4,113,154,23,0,294,261,33
2053,E02005667,ALL,518,164000,150000,163,179,122,54,133,385,466,52
2054,E02005668,ALL,522,171000,160000,126,253,88,55,143,379,465,57
2055,E02005669,ALL,425,249000,225000,261,113,27,24,12,413,394,31
2056,E02005670,ALL,497,99000,94000,2,11,292,192,88,409,304,193
2057,E02005671,ALL,626,148000,135000,8,22,557,39,5,621,587,39
2058,E02005672,ALL,473,115000,112000,2,11,378,82,1,472,391,82
2059,E02005673,ALL,586,131000,115000,23,204,298,61,4,582,525,61
2060,E02005674,ALL,522,146000,125000,55,53,202,212,40,482,313,209
2061,E02005675,ALL,355,134000,126000,82,151,112,10,1,354,341,14
2062,E02005676,ALL,394,143000,145000,85,208,90,11,0,394,379,15
2063,E02005677,ALL,632,165000,136000,138,139,265,90,36,596,542,90
2064,E02005678,ALL,1232,201000,190000,473,223,294,242,406,826,973,259
2065,E02005679,ALL,745,180000,162000,375,186,157,27,0,745,716,29
2066,E02005680,ALL,650,261000,227000,402,125,111,12,13,637,637,13
2067,E02005681,ALL,298,260000,200000,154,97,45,2,18,280,295,3
2068,E02005682,ALL,392,292000,249000,226,111,53,2,28,364,390,2
2069,E02005683,ALL,1118,224000,194000,435,354,184,145,144,974,961,157
2070,E02005684,ALL,688,284000,246000,380,155,136,17,98,590,671,17
2071,E02005685,ALL,672,219000,185000,229,257,115,71,31,641,576,96
2072,E02005686,ALL,87,266000,218000,50,23,14,0,12,75,87,0
2073,E02005687,ALL,476,309000,270000,257,131,82,6,59,417,469,7
2074,E02005688,ALL,724,248000,218000,302,292,116,14,96,628,697,27
2075,E02005689,ALL,682,220000,210000,355,193,121,13,6,676,668,14
2076,E02005690,ALL,578,184000,170000,118,138,134,188,134,444,383,195
2077,E02005691,ALL,424,301000,245000,191,130,95,8,13,411,413,11
2078,E02005692,ALL,323,158000,122000,83,124,98,18,23,300,301,22
2079,E02005693,ALL,414,146000,142000,159,172,71,12,9,405,403,11
2080,E02005694,ALL,505,162000,145000,293,150,57,5,1,504,499,6
2081,E02005695,ALL,525,107000,104000,23,76,330,96,82,443,423,102
2082,E02005696,ALL,202,98000,93000,7,81,111,3,0,202,198,4
2083,E02005697,ALL,343,117000,104000,33,85,166,59,30,313,282,61
2084,E02005698,ALL,245,133000,126000,53,122,68,2,1,244,242,3
2085,E02005699,ALL,498,134000,121000,141,225,120,12,54,444,480,18
2086,E02005700,ALL,625,229000,180000,240,222,146,17,20,605,602,23
2087,E02005701,ALL,837,190000,155000,283,314,212,28,56,781,804,33
2088,E02005928,ALL,254,325000,265000,112,61,40,41,29,225,211,43
2089,E02005930,ALL,452,390000,330000,225,102,98,27,11,441,418,34
2090,E02005931,ALL,603,271000,235000,193,160,219,31,52,551,572,31
2091,E02005932,ALL,678,228000,213000,273,114,265,26,6,672,654,24
2092,E02005933,ALL,564,196000,185000,89,228,237,10,15,549,552,12
2093,E02005934,ALL,584,211000,198000,151,235,195,3,0,584,580,4
2094,E02005935,ALL,770,209000,190000,186,126,281,177,11,759,591,179
2095,E02005936,ALL,717,382000,325000,359,199,148,11,187,530,701,16
2096,E02005937,ALL,515,267000,235000,137,157,131,90,30,485,417,98
2097,E02005938,ALL,372,247000,238000,55,220,61,36,15,357,331,41
2098,E02005939,ALL,590,261000,237000,146,236,138,70,68,522,500,90
2099,E02005940,ALL,519,427000,320000,127,153,68,171,50,469,343,176
2100,E02005941,ALL,579,502000,425000,85,192,137,165,30,549,410,169
2101,E02005942,ALL,589,719000,552000,59,124,181,225,4,585,357,232
2102,E02005943,ALL,386,310000,276000,59,192,103,32,5,381,352,34
2103,E02005944,ALL,337,222000,210000,20,153,77,87,17,320,244,93
2104,E02005945,ALL,690,368000,310000,151,245,120,174,29,661,508,182
2105,E02005946,ALL,631,284000,250000,87,318,91,135,10,621,495,136
2106,E02005947,ALL,334,648000,416000,15,35,82,202,19,315,124,210
2107,E02005948,ALL,463,352000,335000,16,57,281,109,8,455,349,114
2108,E02005949,ALL,282,254000,225000,28,79,100,75,7,275,206,76
2109,E02005950,ALL,583,352000,325000,37,118,334,94,5,578,486,97
2110,E02005951,ALL,421,314000,295000,16,79,182,144,0,421,273,148
2111,E02005952,ALL,861,233000,237000,38,292,238,293,58,803,562,299
2112,E02005953,ALL,337,318000,290000,10,72,222,33,2,335,307,30
2113,E02005954,ALL,626,284000,246000,65,267,214,80,52,574,536,90
2114,E02005955,ALL,647,222000,216000,34,261,222,130,46,601,517,130
2115,E02005956,ALL,188,175000,175000,0,52,115,21,0,188,162,26
2116,E02005957,ALL,257,179000,185000,9,78,147,23,1,256,221,36
2117,E02005958,ALL,515,245000,227000,113,117,201,84,7,508,413,102
2118,E02005959,ALL,225,388000,350000,127,62,27,9,2,223,215,10
2119,E02005960,ALL,591,316000,272000,137,191,161,102,92,499,484,107
2120,E02005961,ALL,406,373000,315000,191,114,66,35,13,393,369,37
2121,E02005962,ALL,675,331000,263000,236,234,155,50,120,555,615,60
2122,E02005963,ALL,398,374000,265000,136,137,106,19,2,396,377,21
2123,E02005964,ALL,510,357000,300000,211,213,78,8,7,503,500,10
2124,E02005965,ALL,340,479000,359000,127,112,84,17,14,326,310,30
2125,E02005966,ALL,848,216000,198000,212,212,401,23,0,848,808,40
2126,E02005967,ALL,687,226000,220000,151,259,168,109,310,377,580,107
2127,E02005968,ALL,367,385000,320000,161,84,97,25,32,335,342,25
2128,E02005969,ALL,742,296000,250000,148,232,243,119,30,712,616,126
2129,E02005970,ALL,476,185000,175000,46,164,155,111,19,457,358,118
2130,E02005971,ALL,388,215000,210000,55,225,76,32,5,383,351,37
2131,E02005972,ALL,784,382000,320000,250,243,138,153,184,600,627,157
2132,E02005973,ALL,607,442000,375000,173,103,186,145,6,601,454,153
2133,E02005974,ALL,717,472000,375000,158,126,243,190,68,649,518,199
2134,E02005975,ALL,541,503000,425000,322,112,65,42,20,521,498,43
2135,E02005976,ALL,330,831000,695000,236,67,24,3,3,327,325,5
2136,E02005977,ALL,384,411000,366000,217,105,47,15,10,374,362,22
2137,E02005978,ALL,600,401000,334000,317,137,83,63,133,467,527,73
2138,E02005979,ALL,672,318000,270000,211,311,43,107,57,615,566,106
2139,E02005980,ALL,474,437000,323000,285,105,47,37,12,462,436,38
2140,E02005981,ALL,682,260000,240000,240,240,148,54,0,682,624,58
2141,E02005982,ALL,490,261000,228000,118,150,163,59,5,485,428,62
2142,E02005983,ALL,998,252000,220000,94,225,331,348,114,884,608,390
2143,E02005984,ALL,464,432000,355000,273,137,52,2,19,445,463,1
2144,E02005985,ALL,527,224000,208000,89,162,179,97,0,527,420,107
2145,E02005986,ALL,191,268000,220000,69,51,63,8,0,191,181,10
2146,E02005987,ALL,495,349000,285000,244,157,63,31,21,474,462,33
2147,E02005988,ALL,462,222000,200000,154,115,173,20,7,455,435,27
2148,E02005991,ALL,744,228000,210000,155,215,168,206,80,664,526,218
2149,E02005992,ALL,758,343000,296000,329,197,175,57,167,591,683,75
2150,E02005994,ALL,124,309000,250000,65,40,18,1,0,124,123,1
2151,E02005996,ALL,697,352000,301000,234,184,191,88,88,609,597,100
2152,E02005997,ALL,116,356000,298000,63,34,19,0,0,116,115,1
2153,E02005998,ALL,446,336000,290000,196,117,101,32,62,384,412,34
2154,E02005999,ALL,180,320000,278000,82,48,43,7,13,167,169,11
2155,E02006000,ALL,1050,243000,218000,216,282,336,216,25,1025,832,218
2156,E02006001,ALL,330,208000,194000,67,101,132,30,18,312,303,27
2157,E02006002,ALL,1050,207000,195000,128,240,285,397,204,846,613,437
2158,E02006003,ALL,308,318000,250000,109,106,89,4,12,296,299,9
2159,E02006007,ALL,182,385000,308000,104,38,29,11,4,178,170,12
2160,E02006227,ALL,498,321000,277000,252,121,115,10,17,481,483,15
2161,E02006228,ALL,479,216000,178000,201,144,120,14,45,434,464,15
2162,E02006229,ALL,512,235000,200000,205,133,147,27,41,471,480,32
2163,E02006230,ALL,699,225000,193000,299,212,172,16,81,618,684,15
2164,E02006231,ALL,16,363000,352000,14,2,0,0,0,16,16,0
2165,E02006232,ALL,496,245000,210000,247,129,106,14,57,439,481,15
2166,E02006233,ALL,922,167000,152000,205,183,434,100,43,879,801,121
2167,E02006234,ALL,750,182000,160000,229,258,217,46,205,545,699,51
2168,E02006235,ALL,524,341000,276000,287,117,115,5,2,522,518,6
2169,E02006236,ALL,689,273000,235000,429,174,76,10,21,668,669,20
2170,E02006237,ALL,3,487000,405000,3,0,0,0,0,3,3,0
2171,E02006240,ALL,25,285000,272000,16,8,0,1,2,23,25,0
2172,E02006242,ALL,1117,202000,180000,410,276,363,68,612,505,1032,85
2173,E02006243,ALL,791,178000,142000,142,146,397,106,47,744,657,134
2174,E02006266,ALL,2,617000,617000,2,0,0,0,0,2,2,0
2175,E02006276,ALL,61,239000,190000,25,23,11,2,1,60,59,2
2176,E02006278,ALL,90,236000,202000,13,17,45,15,9,81,75,15
2177,E02006279,ALL,577,199000,175000,170,235,148,24,6,571,547,30
2178,E02006280,ALL,531,276000,240000,301,128,82,20,24,507,508,23
2179,E02006281,ALL,438,224000,192000,157,89,124,68,59,379,372,66
2180,E02006282,ALL,468,296000,243000,288,108,61,11,8,460,455,13
2181,E02006283,ALL,431,282000,216000,214,155,62,0,3,428,430,1
2182,E02006284,ALL,537,160000,153000,124,156,219,38,18,519,489,48
2183,E02006285,ALL,674,168000,156000,209,140,296,29,65,609,647,27
2184,E02006286,ALL,772,149000,135000,161,150,409,52,34,738,709,63
2185,E02006317,ALL,468,316000,300000,73,147,175,73,4,464,380,88
2186,E02006318,ALL,674,622000,475000,206,158,134,176,23,651,494,180
2187,E02006319,ALL,519,279000,250000,55,197,208,59,1,518,457,62
2188,E02006320,ALL,546,266000,250000,61,179,190,116,27,519,428,118
2189,E02006321,ALL,626,535000,489000,144,168,124,190,18,608,425,201
2190,E02006322,ALL,604,528000,465000,129,166,227,82,23,581,517,87
2191,E02006323,ALL,773,440000,300000,179,146,102,346,103,670,422,351
2192,E02006324,ALL,685,368000,340000,122,310,148,105,75,610,574,111
2193,E02006325,ALL,934,553000,552000,405,220,78,231,166,768,700,234
2194,E02006326,ALL,707,448000,352000,184,169,136,218,66,641,482,225
2195,E02006327,ALL,757,544000,422000,213,83,211,250,32,725,486,271
2196,E02006328,ALL,1128,465000,375000,246,228,263,391,40,1088,722,406
2197,E02006329,ALL,742,980000,750000,331,101,109,201,89,653,537,205
2198,E02006330,ALL,838,602000,330000,245,317,155,121,83,755,696,142
2199,E02006331,ALL,595,626000,540000,255,210,76,54,10,585,538,57
2200,E02006332,ALL,634,948000,500000,232,89,112,201,70,564,422,212
2201,E02006333,ALL,888,807000,500000,386,200,167,135,43,845,747,141
2202,E02006334,ALL,841,1132000,815000,583,141,36,81,53,788,750,91
2203,E02006335,ALL,543,354000,328000,148,183,104,108,14,529,428,115
2204,E02006336,ALL,535,251000,245000,24,209,122,180,37,498,333,202
2205,E02006337,ALL,572,366000,370000,81,392,53,46,30,542,524,48
2206,E02006338,ALL,511,318000,316000,117,228,137,29,15,496,468,43
2207,E02006339,ALL,1171,336000,310000,269,253,283,366,413,758,786,385
2208,E02006341,ALL,760,318000,290000,127,262,177,194,9,751,561,199
2209,E02006342,ALL,905,289000,245000,98,102,94,611,170,735,284,621
2210,E02006343,ALL,649,462000,377000,291,170,98,90,35,614,546,103
2211,E02006344,ALL,583,523000,420000,306,187,64,26,35,548,553,30
2212,E02006345,ALL,307,475000,405000,179,94,21,13,7,300,290,17
2213,E02006346,ALL,789,658000,580000,531,150,47,61,50,739,701,88
2214,E02006347,ALL,651,236000,220000,158,196,218,79,1,650,569,82
2215,E02006348,ALL,636,332000,290000,170,259,141,66,42,594,563,73
2216,E02006349,ALL,757,275000,250000,160,228,207,162,24,733,573,184
2217,E02006350,ALL,348,238000,240000,12,179,106,51,13,335,295,53
2218,E02006351,ALL,696,317000,275000,163,212,203,118,48,648,576,120
2219,E02006352,ALL,389,275000,270000,98,244,31,16,8,381,363,26
2220,E02006353,ALL,445,213000,205000,68,194,114,69,14,431,370,75
2221,E02006354,ALL,894,481000,418000,353,165,136,240,124,770,629,265
2222,E02006355,ALL,262,246000,243000,15,193,17,37,1,261,220,42
2223,E02006356,ALL,1386,331000,280000,115,264,185,822,169,1217,537,849
2224,E02006357,ALL,521,261000,235000,159,172,134,56,2,519,463,58
2225,E02006358,ALL,500,348000,322000,103,216,86,95,9,491,396,104
2226,E02006359,ALL,605,584000,430000,211,82,83,229,20,585,371,234
2227,E02006360,ALL,634,556000,394000,256,158,146,74,27,607,549,85
2228,E02006361,ALL,402,640000,495000,218,103,53,28,22,380,372,30
2229,E02006362,ALL,563,475000,420000,201,221,45,96,22,541,458,105
2230,E02006363,ALL,514,444000,400000,237,129,55,93,25,489,416,98
2231,E02006364,ALL,592,263000,228000,64,146,108,274,25,567,319,273
2232,E02006365,ALL,693,426000,369000,247,104,118,224,116,577,464,229
2233,E02006366,ALL,592,486000,409000,300,198,58,36,19,573,555,37
2234,E02006367,ALL,418,487000,445000,260,58,40,60,8,410,358,60
2235,E02006368,ALL,443,454000,425000,237,112,50,44,28,415,391,52
2236,E02006369,ALL,330,513000,415000,147,117,49,17,2,328,311,19
2237,E02006370,ALL,563,357000,295000,88,143,193,139,30,533,418,145
2238,E02006371,ALL,651,370000,300000,163,137,137,214,59,592,427,224
2239,E02006372,ALL,420,295000,250000,85,126,159,50,7,413,363,57
2240,E02006373,ALL,447,496000,400000,182,142,85,38,18,429,408,39
2241,E02006374,ALL,409,420000,345000,189,130,63,27,3,406,372,37
2242,E02006375,ALL,640,411000,395000,267,240,35,98,146,494,540,100
2243,E02006376,ALL,689,355000,325000,150,224,74,241,1,688,417,272
2244,E02006377,ALL,455,426000,405000,228,128,47,52,44,411,401,54
2245,E02006378,ALL,622,458000,352000,288,154,104,76,27,595,539,83
2246,E02006379,ALL,465,242000,220000,42,158,169,96,17,448,356,109
2247,E02006380,ALL,607,482000,410000,230,148,89,140,43,564,463,144
2248,E02006381,ALL,646,734000,428000,318,121,87,120,92,554,521,125
2249,E02006382,ALL,445,227000,215000,36,173,170,66,9,436,377,68
2250,E02006383,ALL,1071,433000,321000,309,152,164,446,133,938,614,457
2251,E02006384,ALL,939,280000,213000,155,168,137,479,114,825,457,482
2252,E02006385,ALL,1308,240000,220000,115,268,332,593,355,953,714,594
2253,E02006386,ALL,771,414000,370000,226,169,179,197,48,723,573,198
2254,E02006387,ALL,459,340000,275000,99,205,81,74,9,450,380,79
2255,E02006388,ALL,734,237000,225000,100,264,158,212,48,686,511,223
2256,E02006389,ALL,427,309000,265000,100,231,41,55,8,419,369,58
2257,E02006390,ALL,511,252000,244000,116,231,114,50,13,498,462,49
2258,E02006391,ALL,789,306000,295000,245,224,275,45,356,433,750,39
2259,E02006392,ALL,788,222000,196000,130,244,66,348,28,760,430,358
2260,E02006393,ALL,591,276000,250000,79,182,110,220,41,550,369,222
2261,E02006394,ALL,554,454000,309000,181,140,135,98,62,492,453,101
2262,E02006395,ALL,712,252000,248000,116,289,164,143,68,644,544,168
2263,E02006396,ALL,404,369000,330000,148,95,104,57,43,361,347,57
2264,E02006397,ALL,605,952000,518000,278,91,88,148,54,551,451,154
2265,E02006398,ALL,651,248000,235000,70,195,197,189,7,644,457,194
2266,E02006399,ALL,1055,279000,250000,233,333,181,308,122,933,734,321
2267,E02006400,ALL,387,398000,345000,143,114,67,63,9,378,317,70
2268,E02006401,ALL,847,253000,232000,165,230,140,312,119,728,519,328
2269,E02006402,ALL,769,331000,290000,258,350,92,69,28,741,686,83
2270,E02006403,ALL,316,197000,194000,29,92,94,101,0,316,197,119
2271,E02006404,ALL,444,216000,216000,24,168,154,98,75,369,327,117
2272,E02006405,ALL,859,257000,249000,160,295,122,282,98,761,566,293
2273,E02006406,ALL,654,260000,242000,50,151,182,271,34,620,378,276
2274,E02006407,ALL,666,260000,246000,108,274,77,207,63,603,453,213
2275,E02006408,ALL,700,232000,224000,110,213,140,237,45,655,450,250
2276,E02006409,ALL,416,250000,246000,22,199,142,53,16,400,354,62
2277,E02006410,ALL,480,240000,242000,30,153,193,104,2,478,374,106
2278,E02006411,ALL,598,298000,277000,104,232,91,171,10,588,413,185
2279,E02006412,ALL,575,416000,380000,209,139,103,124,43,532,447,128
2280,E02006413,ALL,431,315000,290000,100,154,126,51,17,414,378,53
2281,E02006414,ALL,456,318000,284000,94,194,112,56,36,420,392,64
2282,E02006415,ALL,669,366000,322000,191,163,102,213,70,599,431,238
2283,E02006416,ALL,598,523000,415000,333,166,59,40,5,593,552,46
2284,E02006417,ALL,556,270000,250000,133,186,133,104,108,448,433,123
2285,E02006418,ALL,603,338000,315000,287,99,102,115,33,570,479,124
2286,E02006419,ALL,451,251000,223000,77,188,77,109,9,442,331,120
2287,E02006420,ALL,640,444000,430000,396,34,19,191,79,561,450,190
2288,E02006421,ALL,555,374000,344000,282,118,124,31,12,543,523,32
2289,E02006422,ALL,451,309000,270000,194,79,155,23,10,441,428,23
2290,E02006423,ALL,867,274000,225000,215,243,76,333,91,776,531,336
2291,E02006424,ALL,470,402000,339000,259,114,22,75,19,451,393,77
2292,E02006425,ALL,425,279000,250000,147,126,104,48,48,377,377,48
2293,E02006426,ALL,408,270000,250000,146,141,68,53,3,405,349,59
2294,E02006427,ALL,498,289000,250000,148,157,129,64,40,458,422,76
2295,E02006429,ALL,757,341000,250000,222,137,91,307,56,701,445,312
2296,E02006430,ALL,797,285000,250000,154,259,246,138,69,728,654,143
2297,E02006431,ALL,1040,344000,248000,300,252,64,424,130,910,607,433
2298,E02006432,ALL,426,372000,330000,181,101,53,91,62,364,334,92
2299,E02006433,ALL,730,534000,415000,292,144,100,194,66,664,534,196
2300,E02006434,ALL,367,402000,307000,130,144,84,9,1,366,358,9
2301,E02006435,ALL,401,387000,335000,130,118,106,47,17,384,350,51
2302,E02006436,ALL,418,303000,250000,84,163,117,54,18,400,361,57
2303,E02006437,ALL,596,408000,334000,249,175,113,59,51,545,537,59
2304,E02006438,ALL,521,369000,325000,316,121,56,28,39,482,492,29
2305,E02006439,ALL,479,261000,240000,135,166,117,61,6,473,415,64
2306,E02006440,ALL,582,296000,276000,266,151,125,40,4,578,537,45
2307,E02006441,ALL,837,327000,270000,168,149,257,263,109,728,563,274
2308,E02006442,ALL,556,641000,550000,310,84,28,134,73,483,418,138
2309,E02006443,ALL,576,266000,250000,128,202,134,112,12,564,459,117
2310,E02006444,ALL,569,402000,343000,237,192,46,94,41,528,473,96
2311,E02006445,ALL,783,358000,300000,167,194,155,267,58,725,500,283
2312,E02006446,ALL,533,633000,440000,248,147,72,66,6,527,467,66
2313,E02006447,ALL,562,424000,356000,251,170,118,23,20,542,533,29
2314,E02006448,ALL,605,411000,333000,246,152,136,71,18,587,534,71
2315,E02006449,ALL,492,405000,350000,184,146,99,63,18,474,411,81
2316,E02006450,ALL,428,657000,485000,202,105,62,59,10,418,366,62
2317,E02006451,ALL,896,381000,327000,375,233,149,139,15,881,694,202
2318,E02006453,ALL,562,469000,375000,230,175,73,84,13,549,443,119
2319,E02006454,ALL,596,477000,335000,230,128,104,134,44,552,449,147
2320,E02006455,ALL,533,336000,280000,199,116,93,125,6,527,404,129
2321,E02006456,ALL,767,267000,250000,91,250,229,197,58,709,564,203
2322,E02006457,ALL,806,513000,469000,450,92,53,211,49,757,591,215
2323,E02006458,ALL,739,494000,470000,411,154,49,125,48,691,607,132
2324,E02006459,ALL,506,208000,211000,10,155,174,167,19,487,330,176
2325,E02006460,ALL,771,222000,210000,104,122,408,137,0,771,631,140
2326,E02006461,ALL,620,464000,363000,247,108,83,182,55,565,434,186
2327,E02006462,ALL,732,279000,245000,179,188,201,164,4,728,568,164
2328,E02006463,ALL,1548,242000,215000,130,140,185,1093,563,985,435,1113
2329,E02006464,ALL,494,295000,250000,85,169,145,95,4,490,397,97
2330,E02006465,ALL,561,459000,365000,251,67,118,125,35,526,415,146
2331,E02006466,ALL,788,287000,250000,149,315,168,156,136,652,625,163
2332,E02006467,ALL,519,472000,380000,243,151,69,56,49,470,460,59
2333,E02006534,ALL,616,232000,230000,107,346,107,56,14,602,558,58
2334,E02006535,ALL,663,271000,250000,125,222,208,108,121,542,554,109
2335,E02006536,ALL,537,220000,210000,127,264,126,20,4,533,519,18
2336,E02006537,ALL,629,212000,201000,52,169,251,157,20,609,471,158
2337,E02006538,ALL,996,262000,232000,173,146,253,424,50,946,558,438
2338,E02006539,ALL,568,195000,190000,100,275,139,54,9,559,514,54
2339,E02006540,ALL,402,191000,180000,66,156,125,55,8,394,349,53
2340,E02006541,ALL,735,174000,173000,106,210,138,281,16,719,458,277
2341,E02006542,ALL,541,366000,316000,169,85,189,98,17,524,434,107
2342,E02006543,ALL,498,270000,231000,189,128,149,32,9,489,466,32
2343,E02006544,ALL,786,274000,230000,328,200,148,110,46,740,672,114
2344,E02006545,ALL,717,171000,165000,98,198,326,95,129,588,613,104
2345,E02006546,ALL,981,256000,223000,331,286,217,147,42,939,831,150
2346,E02006547,ALL,402,222000,188000,115,125,135,27,16,386,368,34
2347,E02006548,ALL,938,203000,185000,249,221,391,77,47,891,860,78
2348,E02006549,ALL,716,333000,300000,513,113,26,64,13,703,668,48
2349,E02006550,ALL,914,203000,195000,217,321,177,199,19,895,716,198
2350,E02006551,ALL,1223,300000,260000,529,119,171,404,67,1156,780,443
2351,E02006552,ALL,673,149000,133000,18,43,246,366,4,669,314,359
2352,E02006553,ALL,851,192000,177000,157,294,321,79,203,648,771,80
2353,E02006554,ALL,679,230000,205000,283,131,121,144,8,671,526,153
2354,E02006555,ALL,504,163000,159000,62,173,155,114,1,503,385,119
2355,E02006556,ALL,1017,264000,240000,535,233,154,95,195,822,923,94
2356,E02006557,ALL,448,177000,168000,90,153,106,99,27,421,334,114
2357,E02006558,ALL,904,168000,144000,116,71,119,598,63,841,309,595
2358,E02006559,ALL,941,289000,250000,568,127,85,161,10,931,778,163
2359,E02006560,ALL,963,216000,200000,357,336,193,77,28,935,890,73
2360,E02006561,ALL,507,450000,336000,256,137,77,37,11,496,460,47
2361,E02006562,ALL,454,507000,478000,313,77,49,15,31,423,438,16
2362,E02006563,ALL,332,566000,420000,192,83,46,11,3,329,318,14
2363,E02006564,ALL,686,316000,250000,223,122,185,156,52,634,519,167
2364,E02006565,ALL,509,501000,372000,249,122,104,34,5,504,468,41
2365,E02006566,ALL,651,395000,344000,275,142,148,86,136,515,482,169
2366,E02006567,ALL,487,364000,265000,158,187,101,41,35,452,425,62
2367,E02006568,ALL,1020,254000,245000,81,201,378,360,235,785,653,367
2368,E02006569,ALL,629,408000,320000,322,133,142,32,78,551,592,37
2369,E02006570,ALL,1094,269000,226000,121,143,370,460,147,947,630,464
2370,E02006571,ALL,726,302000,260000,274,194,172,86,68,658,643,83
2371,E02006572,ALL,651,259000,222000,157,178,219,97,86,565,553,98
2372,E02006573,ALL,1100,384000,284000,628,232,129,111,29,1071,980,120
2373,E02006574,ALL,1094,223000,205000,445,368,156,125,16,1078,970,124
2374,E02006575,ALL,329,191000,183000,16,99,185,29,32,297,298,31
2375,E02006576,ALL,586,248000,226000,205,88,208,85,0,586,501,85
2376,E02006577,ALL,450,202000,190000,41,100,190,119,15,435,328,122
2377,E02006578,ALL,1015,179000,168000,54,81,196,684,463,552,331,684
2378,E02006579,ALL,418,222000,210000,60,162,136,60,10,408,359,59
2379,E02006580,ALL,514,205000,185000,59,136,249,70,2,512,442,72
2380,E02006581,ALL,603,201000,190000,78,147,223,155,68,535,449,154
2381,E02006582,ALL,736,272000,254000,307,120,180,129,107,629,604,132
2382,E02006583,ALL,632,218000,210000,69,190,285,88,33,599,541,91
2383,E02006584,ALL,329,159000,165000,5,17,220,87,15,314,240,89
2384,E02006585,ALL,323,186000,185000,2,43,224,54,0,323,267,56
2385,E02006586,ALL,330,155000,158000,7,21,269,33,0,330,296,34
2386,E02006587,ALL,391,165000,156000,23,72,232,64,4,387,332,59
2387,E02006588,ALL,591,300000,237000,164,121,159,147,17,574,435,156
2388,E02006589,ALL,854,293000,250000,332,224,271,27,12,842,823,31
2389,E02006590,ALL,703,278000,232000,135,126,222,220,19,684,459,244
2390,E02006591,ALL,737,241000,224000,135,209,120,273,16,721,459,278
2391,E02006592,ALL,361,484000,378000,195,100,27,39,15,346,316,45
2392,E02006593,ALL,896,247000,235000,87,309,141,359,69,827,526,370
2393,E02006594,ALL,778,310000,270000,202,255,262,59,188,590,721,57
2394,E02006595,ALL,588,415000,380000,335,104,91,58,76,512,517,71
2395,E02006596,ALL,771,280000,250000,294,161,231,85,74,697,683,88
2396,E02006597,ALL,880,300000,250000,257,227,254,142,146,734,744,136
2397,E02006598,ALL,363,344000,265000,132,112,99,20,11,352,342,21
2398,E02006599,ALL,643,477000,442000,540,52,28,23,3,640,620,23
2399,E02006600,ALL,1085,289000,246000,349,225,284,227,199,886,828,257
2400,E02006601,ALL,624,358000,295000,267,161,142,54,69,555,563,61
2401,E02006602,ALL,624,384000,348000,394,137,54,39,34,590,581,43
2402,E02006603,ALL,762,311000,275000,264,185,196,117,13,749,641,121
2403,E02006604,ALL,1115,228000,210000,203,273,193,446,96,1019,663,452
2404,E02006605,ALL,404,309000,275000,162,125,69,48,17,387,356,48
2405,E02006606,ALL,695,292000,250000,260,124,266,45,50,645,643,52
2406,E02006607,ALL,646,308000,285000,260,179,63,144,100,546,492,154
2407,E02006608,ALL,428,365000,308000,199,160,50,19,74,354,408,20
2408,E02006609,ALL,391,451000,340000,173,139,48,31,3,388,353,38
2409,E02006610,ALL,444,423000,370000,187,121,79,57,33,411,385,59
2410,E02006611,ALL,957,354000,315000,350,252,228,127,107,850,839,118
2411,E02006612,ALL,1232,254000,210000,199,196,254,583,143,1089,657,575
2412,E02006613,ALL,625,230000,217000,93,204,173,155,150,475,468,157
2413,E02006614,ALL,916,339000,288000,318,233,177,188,162,754,714,202
2414,E02006615,ALL,617,234000,220000,163,136,276,42,47,570,566,51
2415,E02006616,ALL,688,246000,225000,188,267,181,52,86,602,631,57
2416,E02006617,ALL,773,206000,193000,68,247,227,231,15,758,534,239
2417,E02006618,ALL,549,322000,280000,280,180,72,17,74,475,533,16
2418,E02006619,ALL,526,376000,301000,187,184,115,40,9,517,481,45
2419,E02006620,ALL,939,334000,295000,384,312,120,123,146,793,811,128
2420,E02006621,ALL,768,295000,274000,513,202,15,38,9,759,731,37
2421,E02006622,ALL,664,231000,220000,205,250,100,109,3,661,571,93
2422,E02006623,ALL,649,188000,182000,94,270,214,71,17,632,577,72
2423,E02006624,ALL,661,277000,250000,248,227,49,137,34,627,557,104
2424,E02006625,ALL,647,195000,191000,62,131,324,130,1,646,523,124
2425,E02006626,ALL,500,183000,175000,88,175,181,56,15,485,441,59
2426,E02006627,ALL,730,204000,207000,111,354,82,183,25,705,554,176
2427,E02006628,ALL,789,178000,175000,24,112,419,234,18,771,572,217
2428,E02006629,ALL,538,191000,182000,53,151,220,114,2,536,430,108
2429,E02006630,ALL,1042,173000,145000,45,81,61,855,61,981,251,791
2430,E02006631,ALL,1120,193000,161000,42,64,288,726,120,1000,413,707
2431,E02006632,ALL,960,227000,200000,164,152,120,524,42,918,496,464
2432,E02006633,ALL,885,272000,262000,377,238,41,229,1,884,739,146
2433,E02006634,ALL,23,494000,488000,10,4,8,1,0,23,23,0
2434,E02006640,ALL,55,645000,515000,35,16,4,0,6,49,55,0
2435,E02006782,ALL,480,296000,268000,53,176,211,40,15,465,439,41
2436,E02006783,ALL,304,187000,182000,4,16,257,27,3,301,277,27
2437,E02006784,ALL,340,218000,199000,4,52,224,60,3,337,279,61
2438,E02006785,ALL,361,209000,214000,11,191,66,93,0,361,269,92
2439,E02006786,ALL,295,190000,185000,5,29,239,22,4,291,271,24
2440,E02006787,ALL,534,329000,325000,14,146,307,67,4,530,464,70
2441,E02006788,ALL,318,214000,215000,4,39,245,30,2,316,292,26
2442,E02006789,ALL,481,347000,310000,225,111,65,80,29,452,401,80
2443,E02006790,ALL,579,328000,282000,169,201,83,126,24,555,446,133
2444,E02006791,ALL,716,537000,447000,12,49,235,420,68,648,272,444
2445,E02006792,ALL,701,555000,420000,15,73,125,488,26,675,202,499
2446,E02006793,ALL,215,177000,178000,0,22,93,100,2,213,115,100
2447,E02006794,ALL,155,211000,200000,1,14,66,74,12,143,79,76
2448,E02006795,ALL,317,286000,295000,4,67,188,58,0,317,259,58
2449,E02006796,ALL,637,262000,255000,54,234,145,204,13,624,421,216
2450,E02006798,ALL,318,207000,199000,0,5,52,261,79,239,58,260
2451,E02006799,ALL,433,182000,180000,2,71,317,43,61,372,390,43
2452,E02006800,ALL,467,236000,233000,10,67,297,93,1,466,372,95
2453,E02006801,ALL,489,508000,445000,3,2,29,455,53,436,33,456
2454,E02006802,ALL,309,421000,346000,2,2,50,255,17,292,48,261
2455,E02006821,ALL,428,220000,210000,96,179,103,50,0,428,377,51
2456,E02006822,ALL,575,200000,185000,137,241,151,46,7,568,529,46
2457,E02006823,ALL,684,593000,440000,395,137,90,62,17,667,604,80
2458,E02006824,ALL,765,341000,285000,244,254,149,118,68,697,620,145
2459,E02006825,ALL,440,331000,277000,280,108,39,13,34,406,427,13
2460,E02006826,ALL,841,188000,162000,130,221,324,166,53,788,677,164
2461,E02006829,ALL,512,291000,250000,244,123,100,45,28,484,466,46
2462,E02006830,ALL,338,175000,170000,62,109,138,29,9,329,308,30
2463,E02006831,ALL,464,206000,198000,170,152,68,74,19,445,390,74
2464,E02006832,ALL,462,200000,180000,51,59,331,21,0,462,430,32
2465,E02006833,ALL,788,345000,282000,313,189,200,86,109,679,701,87
2466,E02006836,ALL,602,486000,370000,263,66,128,145,3,599,457,145
2467,E02006837,ALL,825,450000,445000,416,124,69,216,32,793,585,240
2468,E02006838,ALL,602,407000,379000,418,86,32,66,17,585,538,64
2469,E02006839,ALL,667,500000,410000,339,131,53,144,70,597,518,149
2470,E02006853,ALL,1419,332000,307000,0,2,23,1394,907,512,27,1392
2471,E02006854,ALL,2134,457000,380000,0,3,2,2129,1107,1027,6,2128
2472,E02006855,ALL,513,193000,180000,29,118,234,132,81,432,381,132
2473,E02006856,ALL,1217,206000,185000,39,184,391,603,223,994,618,599
2474,E02006857,ALL,892,176000,175000,138,211,293,250,123,769,637,255
2475,E02006858,ALL,857,230000,221000,79,74,247,457,19,838,391,466
2476,E02006859,ALL,548,204000,187000,106,64,192,186,0,548,362,186
2477,E02006873,ALL,1151,220000,205000,369,186,471,125,515,636,972,179
2478,E02006874,ALL,859,261000,227000,383,201,227,48,254,605,781,78
2479,E02006882,ALL,415,331000,338000,10,226,127,52,2,413,361,54
2480,E02006886,ALL,313,379000,330000,99,98,29,87,81,232,227,86
2481,E02006918,ALL,511,221000,205000,0,2,31,478,182,329,30,481
2482,E02006921,ALL,129,293000,225000,1,0,27,101,0,129,28,101
2483,E02006922,ALL,958,174000,165000,301,401,153,103,19,939,845,113
2484,E02006924,ALL,570,286000,295000,6,92,261,211,41,529,355,215
2485,E02006925,ALL,528,342000,335000,38,198,229,63,1,527,466,62
2486,E02006926,ALL,585,216000,205000,185,103,192,105,2,583,478,107
2487,E02006927,ALL,763,374000,292000,56,94,205,408,226,537,345,418
2488,E02006928,ALL,1211,362000,334000,0,1,28,1182,831,380,29,1182
2489,E02006929,ALL,642,334000,310000,2,3,152,485,177,465,152,490
2490,E02006930,ALL,625,410000,371000,2,19,396,208,67,558,415,210
2491,E02006931,ALL,841,502000,415000,20,34,394,393,99,742,436,405
2492,E02000001,2009,157,452000,410000,0,0,1,156,8,149,0,157
2493,E02000001,2010,235,517000,450000,0,0,3,232,43,192,1,234
2494,E02000001,2011,256,541000,465000,0,0,4,252,26,230,2,254
2495,E02000001,2012,195,540000,485000,0,0,1,194,10,185,1,194
2496,E02000001,2013,432,775000,615000,0,0,1,431,232,200,2,430
2497,E02000001,2014,162,686000,529000,0,0,0,162,84,78,0,162
2498,E02000002,2009,45,179000,190000,1,9,23,12,0,45,33,12
2499,E02000002,2010,61,179000,173000,2,12,32,15,0,61,45,16
2500,E02000002,2011,51,192000,185000,1,18,24,8,0,51,41,10
2501,E02000002,2012,42,190000,182000,1,13,17,11,0,42,31,11
2502,E02000002,2013,64,189000,190000,2,21,26,15,0,64,49,15
2503,E02000002,2014,17,203000,218000,1,6,6,4,0,17,13,4
2504,E02000003,2009,80,181000,188000,2,7,46,25,2,78,54,26
2505,E02000003,2010,98,203000,215000,2,16,53,27,6,92,69,29
2506,E02000003,2011,89,193000,200000,2,10,57,20,1,88,69,20
2507,E02000003,2012,114,197000,206000,3,14,68,29,2,112,84,30
2508,E02000003,2013,113,206000,225000,5,20,48,40,14,99,73,40
2509,E02000003,2014,51,235000,250000,4,10,23,14,1,50,37,14
2510,E02000004,2009,54,186000,182000,0,7,42,5,1,53,50,4
2511,E02000004,2010,61,193000,192000,3,9,37,12,0,61,48,13
2512,E02000004,2011,72,196000,194000,0,16,45,11,0,72,60,12
2513,E02000004,2012,58,203000,205000,1,10,41,6,0,58,52,6
2514,E02000004,2013,71,207000,210000,1,26,35,9,0,71,62,9
2515,E02000004,2014,33,214000,223000,1,8,17,7,1,32,26,7
2516,E02000005,2009,60,165000,166000,1,5,48,6,0,60,55,5
2517,E02000005,2010,58,172000,169000,0,2,55,1,0,58,57,1
2518,E02000005,2011,81,169000,165000,0,6,70,5,0,81,76,5
2519,E02000005,2012,59,166000,167000,0,2,49,8,0,59,51,8
2520,E02000005,2013,82,183000,180000,0,3,73,6,1,81,76,6
2521,E02000005,2014,26,206000,215000,0,1,22,3,0,26,22,4
2522,E02000007,2009,40,151000,155000,0,7,25,8,1,39,33,7
2523,E02000007,2010,75,180000,165000,7,16,28,24,32,43,51,24
2524,E02000007,2011,76,163000,154000,7,20,18,31,32,44,45,31
2525,E02000007,2012,48,164000,172000,0,12,29,7,0,48,41,7
2526,E02000007,2013,59,170000,168000,0,12,33,14,1,58,44,15
2527,E02000007,2014,25,189000,195000,1,3,16,5,0,25,19,6
2528,E02000008,2009,78,154000,153000,0,14,60,4,0,78,77,1
2529,E02000008,2010,74,157000,159000,0,6,61,7,0,74,65,9
2530,E02000008,2011,76,165000,160000,1,9,60,6,0,76,70,6
2531,E02000008,2012,83,163000,162000,0,6,71,6,0,83,77,6
2532,E02000008,2013,93,174000,176000,0,6,80,7,0,93,86,7
2533,E02000008,2014,44,190000,190000,0,5,32,7,0,44,38,6
2534,E02000009,2009,46,159000,158000,0,6,34,6,2,44,41,5
2535,E02000009,2010,134,188000,181000,0,8,43,83,87,47,51,83
2536,E02000009,2011,151,182000,171000,1,7,58,85,99,52,66,85
2537,E02000009,2012,130,177000,172000,0,12,39,79,78,52,52,78
2538,E02000009,2013,212,182000,180000,0,10,65,137,114,98,75,137
2539,E02000009,2014,33,196000,200000,0,5,22,6,0,33,27,6
2540,E02000010,2009,59,151000,150000,0,5,49,5,0,59,55,4
2541,E02000010,2010,56,159000,160000,0,3,48,5,0,56,51,5
2542,E02000010,2011,45,159000,158000,0,3,39,3,0,45,42,3
2543,E02000010,2012,59,161000,163000,0,5,46,8,0,59,51,8
2544,E02000010,2013,58,172000,174000,0,5,48,5,0,58,52,6
2545,E02000010,2014,25,198000,200000,0,1,22,2,0,25,23,2
2546,E02000011,2009,49,167000,165000,2,10,27,10,0,49,40,9
2547,E02000011,2010,61,181000,182000,5,7,36,13,0,61,48,13
2548,E02000011,2011,53,180000,184000,4,5,36,8,0,53,44,9
2549,E02000011,2012,48,175000,172000,2,12,24,10,0,48,38,10
2550,E02000011,2013,64,197000,203000,1,9,45,9,0,64,55,9
2551,E02000011,2014,37,224000,220000,3,7,24,3,0,37,34,3
2552,E02000012,2009,75,259000,255000,1,7,60,7,1,74,68,7
2553,E02000012,2010,84,259000,269000,1,13,59,11,0,84,73,11
2554,E02000012,2011,104,256000,250000,1,12,74,17,0,104,86,18
2555,E02000012,2012,96,262000,260000,0,11,71,14,0,96,82,14
2556,E02000012,2013,96,264000,267000,0,4,76,16,0,96,79,17
2557,E02000012,2014,32,305000,295000,0,0,30,2,1,31,30,2
2558,E02000013,2009,42,153000,149000,0,2,37,3,0,42,39,3
2559,E02000013,2010,61,177000,167000,1,9,47,4,0,61,57,4
2560,E02000013,2011,40,162000,156000,0,5,33,2,0,40,39,1
2561,E02000013,2012,58,179000,172000,0,12,42,4,0,58,54,4
2562,E02000013,2013,76,179000,180000,0,9,58,9,0,76,67,9
2563,E02000013,2014,19,218000,205000,1,2,16,0,0,19,19,0
2564,E02000014,2009,49,159000,155000,0,5,43,1,0,49,47,2
2565,E02000014,2010,53,161000,160000,0,5,46,2,0,53,50,3
2566,E02000014,2011,65,159000,159000,1,7,52,5,0,65,61,4
2567,E02000014,2012,56,166000,163000,0,5,50,1,0,56,55,1
2568,E02000014,2013,79,174000,175000,0,4,69,6,0,79,73,6
2569,E02000014,2014,30,190000,191000,0,0,29,1,0,30,29,1
2570,E02000015,2009,21,142000,145000,0,1,11,9,0,21,12,9
2571,E02000015,2010,29,143000,150000,0,6,11,12,0,29,17,12
2572,E02000015,2011,32,150000,140000,1,5,11,15,0,32,17,15
2573,E02000015,2012,31,137000,130000,2,8,4,17,0,31,14,17
2574,E02000015,2013,55,152000,140000,4,10,11,30,1,54,25,30
2575,E02000015,2014,26,174000,172000,0,9,9,8,0,26,18,8
2576,E02000016,2009,105,147000,144000,0,0,5,100,83,22,5,100
2577,E02000016,2010,112,150000,138000,0,1,10,101,59,53,11,101
2578,E02000016,2011,78,160000,153000,0,0,8,70,57,21,8,70
2579,E02000016,2012,29,140000,132000,0,0,4,25,1,28,4,25
2580,E02000016,2013,50,161000,149000,0,0,16,34,3,47,15,35
2581,E02000016,2014,29,169000,160000,0,0,6,23,0,29,5,24
2582,E02000017,2009,47,209000,215000,0,3,39,5,0,47,42,5
2583,E02000017,2010,55,212000,219000,0,1,49,5,0,55,51,4
2584,E02000017,2011,63,222000,225000,2,5,50,6,0,63,57,6
2585,E02000017,2012,53,203000,210000,0,2,40,11,0,53,42,11
2586,E02000017,2013,85,207000,208000,0,4,63,18,0,85,67,18
2587,E02000017,2014,22,237000,250000,0,0,19,3,0,22,19,3
2588,E02000018,2009,59,152000,154000,0,4,47,8,1,58,51,8
2589,E02000018,2010,66,170000,164000,2,4,53,7,0,66,58,8
2590,E02000018,2011,38,159000,156000,0,4,28,6,0,38,32,6
2591,E02000018,2012,47,160000,161000,0,2,39,6,0,47,41,6
2592,E02000018,2013,63,172000,175000,0,2,52,9,0,63,53,10
2593,E02000018,2014,21,194000,195000,0,0,20,1,0,21,20,1
2594,E02000019,2009,62,151000,150000,0,7,48,7,4,58,55,7
2595,E02000019,2010,55,164000,162000,0,0,48,7,0,55,48,7
2596,E02000019,2011,53,160000,155000,0,5,44,4,0,53,49,4
2597,E02000019,2012,44,168000,166000,0,3,41,0,0,44,44,0
2598,E02000019,2013,65,171000,172000,0,5,51,9,0,65,56,9
2599,E02000019,2014,31,189000,190000,0,2,26,3,0,31,28,3
2600,E02000020,2009,44,177000,174000,0,4,37,3,0,44,41,3
2601,E02000020,2010,63,180000,183000,0,7,51,5,0,63,55,8
2602,E02000020,2011,60,168000,171000,0,7,45,8,1,59,50,10
2603,E02000020,2012,113,197000,215000,7,11,71,24,47,66,48,65
2604,E02000020,2013,167,199000,200000,2,7,108,50,87,80,63,104
2605,E02000020,2014,25,217000,225000,0,1,21,3,0,25,21,4
2606,E02000021,2009,61,149000,150000,0,2,54,5,0,61,57,4
2607,E02000021,2010,57,160000,157000,0,7,42,8,0,57,49,8
2608,E02000021,2011,51,155000,152000,0,2,45,4,0,51,47,4
2609,E02000021,2012,44,155000,160000,0,4,32,8,0,44,36,8
2610,E02000021,2013,49,168000,170000,0,5,40,4,0,49,45,4
2611,E02000021,2014,27,184000,185000,0,2,23,2,0,27,25,2
2612,E02000022,2009,105,136000,145000,0,1,1,103,14,91,2,103
2613,E02000022,2010,29,133000,140000,0,1,2,26,0,29,2,27
2614,E02000022,2011,24,132000,135000,0,2,1,21,0,24,3,21
2615,E02000022,2012,29,137000,130000,0,4,3,22,0,29,7,22
2616,E02000022,2013,26,139000,138000,0,1,3,22,0,26,4,22
2617,E02000022,2014,13,160000,160000,0,0,2,11,0,13,2,11
2618,E02000023,2009,20,176000,177000,1,1,16,2,0,20,18,2
2619,E02000023,2010,29,159000,160000,0,4,17,8,0,29,19,10
2620,E02000023,2011,28,163000,167000,0,5,18,5,0,28,23,5
2621,E02000023,2012,16,158000,165000,0,0,12,4,0,16,12,4
2622,E02000023,2013,36,157000,166000,0,4,15,17,1,35,19,17
2623,E02000023,2014,13,151000,130000,0,1,5,7,0,13,6,7
2624,E02000024,2009,120,390000,324000,13,35,39,33,0,120,85,35
2625,E02000024,2010,173,397000,336000,26,44,37,66,25,148,107,66
2626,E02000024,2011,131,413000,370000,22,41,31,37,5,126,92,39
2627,E02000024,2012,157,437000,380000,23,50,33,51,13,144,106,51
2628,E02000024,2013,190,460000,376000,23,47,49,71,21,169,119,71
2629,E02000024,2014,74,547000,462000,10,19,20,25,3,71,50,24
2630,E02000025,2009,98,275000,240000,7,31,12,48,1,97,50,48
2631,E02000025,2010,127,305000,250000,10,29,15,73,0,127,52,75
2632,E02000025,2011,112,308000,262000,9,31,14,58,0,112,54,58
2633,E02000025,2012,117,340000,308000,14,39,7,57,0,117,57,60
2634,E02000025,2013,125,374000,338000,16,37,16,56,0,125,69,56
2635,E02000025,2014,43,369000,298000,4,8,5,26,0,43,17,26
2636,E02000026,2009,74,324000,320000,3,33,20,18,0,74,55,19
2637,E02000026,2010,100,364000,347000,10,47,16,27,0,100,71,29
2638,E02000026,2011,68,367000,352000,8,29,14,17,0,68,50,18
2639,E02000026,2012,80,360000,342000,12,25,17,26,0,80,53,27
2640,E02000026,2013,100,406000,395000,12,41,18,29,0,100,70,30
2641,E02000026,2014,25,493000,484000,3,13,3,6,1,24,19,6
2642,E02000027,2009,61,270000,250000,3,24,23,11,0,61,48,13
2643,E02000027,2010,86,301000,284000,12,32,20,22,0,86,64,22
2644,E02000027,2011,79,304000,280000,6,31,26,16,0,79,62,17
2645,E02000027,2012,79,306000,300000,4,28,23,24,1,78,53,26
2646,E02000027,2013,93,330000,330000,6,32,24,31,1,92,62,31
2647,E02000027,2014,44,333000,318000,1,11,13,19,8,36,22,22
2648,E02000028,2009,89,309000,280000,8,29,9,43,4,85,47,42
2649,E02000028,2010,80,369000,274000,8,26,6,40,0,80,40,40
2650,E02000028,2011,99,369000,330000,7,39,12,41,4,95,57,42
2651,E02000028,2012,70,405000,369000,7,26,10,27,3,67,42,28
2652,E02000028,2013,97,385000,354000,5,34,11,47,9,88,49,48
2653,E02000028,2014,41,386000,338000,4,10,4,23,1,40,18,23
2654,E02000029,2009,89,251000,250000,3,26,26,34,2,87,57,32
2655,E02000029,2010,107,307000,273000,6,39,26,36,4,103,69,38
2656,E02000029,2011,96,285000,264000,3,28,26,39,0,96,53,43
2657,E02000029,2012,99,316000,319000,4,30,29,36,4,95,63,36
2658,E02000029,2013,122,315000,280000,6,37,26,53,0,122,68,54
2659,E02000029,2014,53,357000,365000,5,9,18,21,0,53,31,22
2660,E02000030,2009,100,662000,500000,37,43,14,6,0,100,94,6
2661,E02000030,2010,121,896000,605000,59,40,14,8,1,120,107,14
2662,E02000030,2011,88,766000,609000,38,33,12,5,1,87,83,5
2663,E02000030,2012,96,866000,675000,45,30,13,8,2,94,87,9
2664,E02000030,2013,119,890000,646000,54,40,15,10,2,117,110,9
2665,E02000030,2014,43,861000,652000,15,13,6,9,2,41,34,9
2666,E02000031,2009,59,418000,350000,9,17,7,26,0,59,32,27
2667,E02000031,2010,82,408000,318000,14,21,8,39,1,81,43,39
2668,E02000031,2011,85,488000,401000,12,34,4,35,0,85,47,38
2669,E02000031,2012,84,484000,442000,12,26,10,36,1,83,48,36
2670,E02000031,2013,124,491000,378000,22,29,33,40,14,110,84,40
2671,E02000031,2014,46,584000,521000,9,12,8,17,0,46,29,17
2672,E02000032,2009,66,354000,350000,4,48,9,5,0,66,61,5
2673,E02000032,2010,79,405000,404000,6,48,21,4,0,79,75,4
2674,E02000032,2011,60,402000,398000,2,40,16,2,0,60,56,4
2675,E02000032,2012,69,440000,437000,9,39,17,4,0,69,65,4
2676,E02000032,2013,59,445000,458000,4,38,10,7,0,59,52,7
2677,E02000032,2014,33,535000,525000,3,22,7,1,0,33,32,1
2678,E02000033,2009,86,266000,275000,1,26,36,23,0,86,64,22
2679,E02000033,2010,99,278000,291000,4,37,26,32,0,99,68,31
2680,E02000033,2011,80,301000,308000,1,27,31,21,0,80,59,21
2681,E02000033,2012,87,306000,305000,1,30,25,31,0,87,56,31
2682,E02000033,2013,122,336000,334000,2,44,37,39,6,116,82,40
2683,E02000033,2014,36,311000,313000,1,9,8,18,1,35,17,19
2684,E02000034,2009,83,304000,250000,7,30,7,39,0,83,43,40
2685,E02000034,2010,105,350000,271000,4,32,22,47,0,105,56,49
2686,E02000034,2011,100,323000,244000,7,23,14,56,0,100,45,55
2687,E02000034,2012,90,373000,275000,6,24,13,47,1,89,42,48
2688,E02000034,2013,116,360000,268000,7,32,11,66,1,115,51,65
2689,E02000034,2014,41,399000,280000,2,9,6,24,0,41,17,24
2690,E02000035,2009,67,337000,250000,2,15,6,44,0,67,23,44
2691,E02000035,2010,117,398000,320000,9,28,20,60,0,117,57,60
2692,E02000035,2011,101,394000,330000,12,11,23,55,9,92,46,55
2693,E02000035,2012,106,393000,328000,10,10,16,70,12,94,35,71
2694,E02000035,2013,120,480000,390000,7,23,19,71,11,109,48,72
2695,E02000035,2014,46,434000,388000,1,7,5,33,5,41,13,33
2696,E02000036,2009,80,292000,290000,6,44,14,16,1,79,64,16
2697,E02000036,2010,130,290000,286000,8,59,12,51,14,116,77,53
2698,E02000036,2011,113,298000,282000,8,47,6,52,16,97,58,55
2699,E02000036,2012,110,350000,342000,9,58,14,29,0,110,79,31
2700,E02000036,2013,119,337000,315000,8,52,22,37,0,119,79,40
2701,E02000036,2014,41,337000,285000,3,15,3,20,0,41,21,20
2702,E02000037,2009,65,415000,412000,14,35,3,13,8,57,52,13
2703,E02000037,2010,120,367000,390000,7,56,5,52,37,83,68,52
2704,E02000037,2011,101,394000,320000,15,35,3,48,33,68,52,49
2705,E02000037,2012,118,400000,300000,20,32,1,65,53,65,53,65
2706,E02000037,2013,84,455000,416000,22,29,7,26,7,77,58,26
2707,E02000037,2014,42,553000,530000,11,23,1,7,0,42,35,7
2708,E02000038,2009,83,313000,315000,2,23,19,39,2,81,44,39
2709,E02000038,2010,129,345000,338000,5,31,28,65,1,128,65,64
2710,E02000038,2011,149,347000,318000,7,35,34,73,0,149,75,74
2711,E02000038,2012,122,379000,384000,6,30,33,53,2,120,69,53
2712,E02000038,2013,136,413000,405000,5,29,33,69,3,133,67,69
2713,E02000038,2014,42,445000,462000,4,15,7,16,0,42,27,15
2714,E02000039,2009,68,469000,398000,23,14,10,21,0,68,48,20
2715,E02000039,2010,93,571000,410000,20,28,14,31,1,92,62,31
2716,E02000039,2011,87,558000,425000,23,20,15,29,0,87,56,31
2717,E02000039,2012,82,552000,331000,27,9,5,41,2,80,42,40
2718,E02000039,2013,95,660000,470000,32,20,11,32,4,91,63,32
2719,E02000039,2014,31,545000,405000,6,5,4,16,4,27,15,16
2720,E02000040,2009,111,337000,250000,10,28,9,64,57,54,37,74
2721,E02000040,2010,121,461000,335000,25,31,8,57,37,84,60,61
2722,E02000040,2011,124,445000,368000,16,36,20,52,45,79,69,55
2723,E02000040,2012,87,437000,403000,10,26,24,27,19,68,56,31
2724,E02000040,2013,106,568000,482000,17,33,15,41,23,83,63,43
2725,E02000040,2014,38,566000,401000,2,8,9,19,8,30,17,21
2726,E02000041,2009,84,306000,290000,8,41,12,23,0,84,61,23
2727,E02000041,2010,84,324000,300000,4,36,19,25,0,84,58,26
2728,E02000041,2011,72,358000,338000,4,38,13,17,4,68,55,17
2729,E02000041,2012,59,344000,300000,5,25,10,19,0,59,39,20
2730,E02000041,2013,58,388000,350000,8,25,14,11,0,58,45,13
2731,E02000041,2014,40,434000,415000,5,18,8,9,0,40,30,10
2732,E02000042,2009,108,283000,250000,5,16,27,60,0,108,44,64
2733,E02000042,2010,133,329000,285000,2,19,34,78,1,132,51,82
2734,E02000042,2011,131,313000,280000,3,17,24,87,0,131,42,89
2735,E02000042,2012,112,315000,276000,0,15,17,80,7,105,31,81
2736,E02000042,2013,149,384000,323000,6,24,29,90,6,143,58,91
2737,E02000042,2014,57,370000,335000,0,4,12,41,1,56,14,43
2738,E02000043,2009,70,460000,442000,8,35,11,16,0,70,53,17
2739,E02000043,2010,76,474000,492000,7,40,13,16,0,76,57,19
2740,E02000043,2011,71,534000,538000,7,47,2,15,0,71,56,15
2741,E02000043,2012,78,524000,528000,5,42,8,23,2,76,54,24
2742,E02000043,2013,77,609000,618000,12,43,6,16,3,74,60,17
2743,E02000043,2014,21,573000,625000,0,11,3,7,0,21,14,7
2744,E02000044,2009,49,254000,210000,1,11,24,13,0,49,37,12
2745,E02000044,2010,72,294000,241000,3,17,34,18,0,72,55,17
2746,E02000044,2011,55,323000,247000,5,10,28,12,0,55,41,14
2747,E02000044,2012,73,320000,250000,5,12,32,24,6,67,49,24
2748,E02000044,2013,98,314000,250000,2,17,34,45,17,81,53,45
2749,E02000044,2014,30,417000,298000,5,4,14,7,0,30,22,8
2750,E02000045,2009,82,251000,220000,0,15,23,44,1,81,35,47
2751,E02000045,2010,99,302000,272000,4,15,28,52,4,95,47,52
2752,E02000045,2011,112,310000,269000,4,21,25,62,6,106,48,64
2753,E02000045,2012,88,296000,246000,3,14,18,53,0,88,34,54
2754,E02000045,2013,140,339000,292000,5,22,37,76,0,140,62,78
2755,E02000045,2014,52,325000,250000,2,3,11,36,0,52,16,36
2756,E02000046,2009,58,356000,304000,1,10,11,36,1,57,22,36
2757,E02000046,2010,98,379000,329000,1,24,25,48,0,98,49,49
2758,E02000046,2011,62,406000,318000,3,12,13,34,0,62,27,35
2759,E02000046,2012,67,422000,365000,2,15,13,37,1,66,29,38
2760,E02000046,2013,91,462000,357000,1,20,19,51,0,91,37,54
2761,E02000046,2014,17,412000,328000,0,4,2,11,0,17,6,11
2762,E02000047,2009,115,208000,191000,0,11,36,68,65,50,46,69
2763,E02000047,2010,110,221000,222000,0,17,25,68,54,56,42,68
2764,E02000047,2011,67,237000,230000,0,12,34,21,4,63,46,21
2765,E02000047,2012,57,225000,234000,0,11,24,22,0,57,35,22
2766,E02000047,2013,90,246000,242000,0,16,42,32,0,90,58,32
2767,E02000047,2014,35,268000,250000,0,3,18,14,0,35,20,15
2768,E02000048,2009,108,386000,321000,9,39,16,44,12,96,63,45
2769,E02000048,2010,136,445000,340000,14,53,12,57,4,132,78,58
2770,E02000048,2011,136,429000,364000,12,44,21,59,8,128,76,60
2771,E02000048,2012,131,411000,365000,9,54,19,49,13,118,82,49
2772,E02000048,2013,148,473000,388000,10,56,18,64,6,142,84,64
2773,E02000048,2014,55,526000,432000,2,17,9,27,5,50,28,27
2774,E02000049,2009,18,169000,168000,0,3,6,9,0,18,9,9
2775,E02000049,2010,20,202000,220000,0,1,9,10,1,19,12,8
2776,E02000049,2011,32,214000,218000,0,2,8,22,9,23,10,22
2777,E02000049,2012,59,225000,238000,0,1,18,40,35,24,16,43
2778,E02000049,2013,21,205000,205000,0,1,9,11,0,21,11,10
2779,E02000049,2014,10,238000,247000,0,0,5,5,0,10,5,5
2780,E02000050,2009,62,359000,316000,1,10,25,26,0,62,37,25
2781,E02000050,2010,116,382000,335000,4,16,46,50,0,116,66,50
2782,E02000050,2011,107,329000,270000,2,9,36,60,9,98,44,63
2783,E02000050,2012,120,374000,290000,1,20,34,65,2,118,50,70
2784,E02000050,2013,101,404000,304000,1,14,34,52,1,100,45,56
2785,E02000050,2014,37,433000,312000,0,5,11,21,7,30,16,21
2786,E02000051,2009,81,495000,365000,10,12,7,52,12,69,27,54
2787,E02000051,2010,120,565000,422000,18,18,9,75,2,118,45,75
2788,E02000051,2011,99,549000,350000,17,13,4,65,0,99,33,66
2789,E02000051,2012,100,584000,435000,15,17,1,67,15,85,33,67
2790,E02000051,2013,117,667000,540000,20,21,7,69,0,117,48,69
2791,E02000051,2014,51,635000,465000,7,6,1,37,1,50,14,37
2792,E02000052,2009,128,356000,296000,2,12,42,72,0,128,55,73
2793,E02000052,2010,126,404000,342000,1,14,49,62,0,126,59,67
2794,E02000052,2011,129,422000,356000,2,15,42,70,0,129,55,74
2795,E02000052,2012,157,432000,380000,0,20,51,86,0,157,67,90
2796,E02000052,2013,133,464000,407000,1,15,40,77,3,130,52,81
2797,E02000052,2014,36,361000,275000,1,0,7,28,0,36,8,28
2798,E02000053,2009,123,237000,232000,0,14,5,104,81,42,20,103
2799,E02000053,2010,94,247000,219000,0,10,14,70,42,52,24,70
2800,E02000053,2011,202,261000,250000,1,16,7,178,135,67,24,178
2801,E02000053,2012,394,273000,261000,0,14,20,360,325,69,33,361
2802,E02000053,2013,458,282000,270000,0,16,10,432,356,102,25,433
2803,E02000053,2014,93,269000,265000,1,4,3,85,52,41,7,86
2804,E02000054,2009,57,325000,239000,8,16,0,33,6,51,24,33
2805,E02000054,2010,81,385000,293000,13,25,2,41,0,81,38,43
2806,E02000054,2011,86,468000,322000,16,24,2,44,2,84,41,45
2807,E02000054,2012,78,339000,253000,5,21,3,49,1,77,27,51
2808,E02000054,2013,103,440000,330000,17,31,2,53,0,103,50,53
2809,E02000054,2014,37,322000,245000,2,9,0,26,0,37,10,27
2810,E02000055,2009,78,389000,301000,8,20,9,41,1,77,37,41
2811,E02000055,2010,103,465000,300000,22,12,11,58,1,102,45,58
2812,E02000055,2011,129,445000,325000,18,19,7,85,8,121,42,87
2813,E02000055,2012,102,481000,358000,16,16,13,57,8,94,45,57
2814,E02000055,2013,123,466000,340000,15,15,14,79,1,122,43,80
2815,E02000055,2014,26,410000,312000,4,2,0,20,0,26,6,20
2816,E02000056,2009,107,1157000,1000000,21,29,1,56,20,87,44,63
2817,E02000056,2010,134,1246000,850000,37,49,5,43,3,131,81,53
2818,E02000056,2011,98,1427000,875000,21,31,4,42,2,96,53,45
2819,E02000056,2012,99,1304000,960000,21,38,5,35,1,98,60,39
2820,E02000056,2013,124,1445000,992000,29,38,6,51,2,122,69,55
2821,E02000056,2014,50,2038000,1128000,11,20,3,16,0,50,29,21
2822,E02000057,2009,57,412000,334000,13,12,11,21,0,57,36,21
2823,E02000057,2010,81,366000,300000,12,15,9,45,1,80,35,46
2824,E02000057,2011,80,449000,390000,20,14,18,28,0,80,52,28
2825,E02000057,2012,55,452000,365000,9,14,8,24,1,54,30,25
2826,E02000057,2013,58,561000,485000,14,16,11,17,0,58,41,17
2827,E02000057,2014,20,615000,462000,2,7,5,6,0,20,13,7
2828,E02000058,2009,91,463000,420000,7,30,18,36,2,89,51,40
2829,E02000058,2010,137,589000,550000,11,61,24,41,2,135,88,49
2830,E02000058,2011,114,608000,568000,17,41,23,33,4,110,73,41
2831,E02000058,2012,104,751000,612000,12,39,19,34,1,103,64,40
2832,E02000058,2013,142,748000,618000,16,34,38,54,2,140,81,61
2833,E02000058,2014,58,842000,714000,5,22,16,15,1,57,38,20
2834,E02000059,2009,80,219000,235000,3,8,29,40,2,78,42,38
2835,E02000059,2010,100,280000,250000,0,18,38,44,0,100,57,43
2836,E02000059,2011,71,263000,250000,0,12,30,29,1,70,43,28
2837,E02000059,2012,94,253000,246000,1,13,26,54,18,76,39,55
2838,E02000059,2013,210,245000,244000,0,7,30,173,113,97,37,173
2839,E02000059,2014,37,270000,248000,1,4,4,28,2,35,9,28
2840,E02000060,2009,53,511000,500000,7,22,9,15,0,53,39,14
2841,E02000060,2010,70,521000,495000,4,30,8,28,4,66,40,30
2842,E02000060,2011,75,549000,543000,13,31,4,27,17,58,48,27
2843,E02000060,2012,69,597000,575000,11,31,11,16,0,69,53,16
2844,E02000060,2013,72,638000,628000,10,25,9,28,1,71,44,28
2845,E02000060,2014,33,882000,790000,8,12,3,10,1,32,22,11
2846,E02000061,2009,68,776000,554000,11,23,2,32,0,68,35,33
2847,E02000061,2010,112,896000,538000,17,30,5,60,21,91,51,61
2848,E02000061,2011,119,894000,480000,9,32,4,74,30,89,41,78
2849,E02000061,2012,82,1214000,890000,6,32,4,40,13,69,40,42
2850,E02000061,2013,108,1225000,772000,23,27,4,54,13,95,57,51
2851,E02000061,2014,34,976000,739000,4,10,2,18,7,27,16,18
2852,E02000062,2009,38,268000,250000,1,10,18,9,0,38,30,8
2853,E02000062,2010,46,286000,286000,1,12,14,19,0,46,31,15
2854,E02000062,2011,38,258000,272000,0,6,16,16,0,38,20,18
2855,E02000062,2012,48,291000,300000,1,16,13,18,0,48,30,18
2856,E02000062,2013,51,306000,306000,0,14,18,19,0,51,31,20
2857,E02000062,2014,17,340000,360000,0,5,6,6,0,17,11,6
2858,E02000063,2009,41,329000,315000,1,25,4,11,0,41,30,11
2859,E02000063,2010,62,368000,370000,4,35,8,15,0,62,47,15
2860,E02000063,2011,81,330000,350000,0,40,9,32,0,81,49,32
2861,E02000063,2012,43,355000,320000,0,21,5,17,0,43,26,17
2862,E02000063,2013,85,391000,345000,1,41,9,34,0,85,49,36
2863,E02000063,2014,21,394000,325000,1,8,1,11,0,21,10,11
2864,E02000064,2009,28,374000,265000,0,3,7,18,0,28,11,17
2865,E02000064,2010,76,648000,356000,8,11,11,46,21,55,29,47
2866,E02000064,2011,52,468000,320000,2,11,7,32,7,45,16,36
2867,E02000064,2012,50,830000,360000,5,7,11,27,2,48,23,27
2868,E02000064,2013,72,735000,390000,3,15,15,39,0,72,33,39
2869,E02000064,2014,23,672000,410000,0,4,2,17,0,23,6,17
2870,E02000065,2009,31,139000,134000,0,2,18,11,0,31,21,10
2871,E02000065,2010,45,145000,149000,0,2,29,14,0,45,31,14
2872,E02000065,2011,27,142000,145000,0,4,17,6,0,27,20,7
2873,E02000065,2012,43,145000,150000,0,3,27,13,0,43,29,14
2874,E02000065,2013,62,148000,156000,1,6,32,23,0,62,40,22
2875,E02000065,2014,26,164000,165000,2,4,12,8,0,26,18,8
2876,E02000066,2009,31,163000,165000,1,0,23,7,0,31,27,4
2877,E02000066,2010,36,152000,153000,0,5,21,10,0,36,26,10
2878,E02000066,2011,66,133000,126000,1,2,25,38,23,43,28,38
2879,E02000066,2012,43,152000,152000,2,3,27,11,2,41,30,13
2880,E02000066,2013,52,156000,150000,1,5,29,17,0,52,33,19
2881,E02000066,2014,23,189000,185000,2,2,13,6,0,23,17,6
2882,E02000067,2009,70,160000,157000,3,10,38,19,0,70,50,20
2883,E02000067,2010,87,166000,165000,2,16,39,30,0,87,57,30
2884,E02000067,2011,73,157000,155000,1,14,33,25,0,73,47,26
2885,E02000067,2012,160,151000,145000,5,13,46,96,64,96,64,96
2886,E02000067,2013,186,158000,147000,3,18,46,119,62,124,67,119
2887,E02000067,2014,59,181000,185000,1,8,28,22,0,59,36,23
2888,E02000068,2009,54,149000,150000,0,13,25,16,1,53,39,15
2889,E02000068,2010,48,164000,152000,2,9,18,19,0,48,28,20
2890,E02000068,2011,59,165000,155000,1,7,31,20,1,58,40,19
2891,E02000068,2012,60,158000,156000,1,11,27,21,0,60,39,21
2892,E02000068,2013,89,163000,159000,2,13,36,38,1,88,51,38
2893,E02000068,2014,36,170000,160000,0,3,13,20,0,36,16,20
2894,E02000069,2009,54,178000,163000,3,15,12,24,0,54,30,24
2895,E02000069,2010,59,168000,155000,3,15,12,29,0,59,30,29
2896,E02000069,2011,71,177000,161000,5,17,18,31,0,71,40,31
2897,E02000069,2012,83,192000,176000,9,24,16,34,0,83,47,36
2898,E02000069,2013,58,202000,188000,2,22,15,19,0,58,39,19
2899,E02000069,2014,39,204000,187000,4,14,8,13,0,39,26,13
2900,E02000070,2009,69,204000,201000,4,25,30,10,0,69,61,8
2901,E02000070,2010,86,218000,222000,6,46,23,11,0,86,75,11
2902,E02000070,2011,103,232000,228000,8,55,31,9,0,103,94,9
2903,E02000070,2012,81,225000,227000,6,43,22,10,0,81,71,10
2904,E02000070,2013,106,231000,243000,5,62,26,13,0,106,92,14
2905,E02000070,2014,43,233000,248000,4,18,7,14,0,43,30,13
2906,E02000071,2009,71,195000,185000,4,28,32,7,0,71,66,5
2907,E02000071,2010,71,207000,192000,2,29,39,1,0,71,69,2
2908,E02000071,2011,87,203000,214000,4,36,38,9,0,87,78,9
2909,E02000071,2012,65,201000,187000,1,23,35,6,0,65,59,6
2910,E02000071,2013,94,220000,219000,2,49,40,3,0,94,89,5
2911,E02000071,2014,36,239000,250000,2,19,13,2,0,36,34,2
2912,E02000072,2009,56,168000,160000,1,14,36,5,0,56,50,6
2913,E02000072,2010,66,149000,161000,1,20,31,14,0,66,53,13
2914,E02000072,2011,72,151000,158000,0,20,37,15,0,72,55,17
2915,E02000072,2012,65,149000,156000,2,12,38,13,0,65,52,13
2916,E02000072,2013,103,163000,162000,0,17,64,22,6,97,81,22
2917,E02000072,2014,54,183000,172000,1,5,27,21,16,38,33,21
2918,E02000073,2009,95,220000,220000,1,59,27,8,0,95,86,9
2919,E02000073,2010,111,250000,246000,3,89,17,2,0,111,109,2
2920,E02000073,2011,117,239000,242000,4,89,19,5,0,117,111,6
2921,E02000073,2012,103,251000,250000,2,88,9,4,0,103,99,4
2922,E02000073,2013,142,255000,250000,2,116,18,6,0,142,134,8
2923,E02000073,2014,56,276000,270000,0,46,7,3,0,56,53,3
2924,E02000074,2009,44,169000,161000,1,21,14,8,0,44,36,8
2925,E02000074,2010,68,174000,168000,2,36,17,13,0,68,55,13
2926,E02000074,2011,61,165000,163000,1,35,13,12,0,61,49,12
2927,E02000074,2012,137,157000,157000,0,39,15,83,76,61,53,84
2928,E02000074,2013,96,167000,163000,0,40,17,39,24,72,57,39
2929,E02000074,2014,23,189000,182000,0,10,9,4,0,23,18,5
2930,E02000075,2009,85,226000,225000,2,50,23,10,0,85,74,11
2931,E02000075,2010,73,242000,243000,3,44,17,9,0,73,64,9
2932,E02000075,2011,83,249000,250000,4,50,17,12,0,83,71,12
2933,E02000075,2012,101,255000,250000,7,65,15,14,0,101,86,15
2934,E02000075,2013,111,263000,260000,12,62,20,17,0,111,94,17
2935,E02000075,2014,41,283000,275000,7,23,6,5,0,41,36,5
2936,E02000077,2009,76,201000,200000,0,36,33,7,1,75,69,7
2937,E02000077,2010,82,217000,216000,0,55,20,7,1,81,77,5
2938,E02000077,2011,72,217000,220000,1,49,19,3,0,72,69,3
2939,E02000077,2012,77,224000,235000,1,49,18,9,0,77,68,9
2940,E02000077,2013,89,224000,233000,0,55,22,12,0,89,77,12
2941,E02000077,2014,29,246000,250000,0,21,3,5,0,29,24,5
2942,E02000078,2009,83,189000,190000,2,33,27,21,0,83,65,18
2943,E02000078,2010,91,206000,200000,1,37,42,11,0,91,78,13
2944,E02000078,2011,104,207000,203000,4,45,42,13,0,104,91,13
2945,E02000078,2012,105,218000,207000,6,54,31,14,0,105,91,14
2946,E02000078,2013,125,227000,225000,7,56,38,24,1,124,99,26
2947,E02000078,2014,49,234000,200000,0,19,18,12,0,49,37,12
2948,E02000079,2009,103,215000,202000,6,34,30,33,1,102,70,33
2949,E02000079,2010,109,223000,223000,4,40,35,30,1,108,80,29
2950,E02000079,2011,118,231000,221000,7,47,32,32,0,118,85,33
2951,E02000079,2012,97,232000,220000,9,27,28,33,0,97,63,34
2952,E02000079,2013,138,242000,240000,11,52,34,41,1,137,97,41
2953,E02000079,2014,46,252000,250000,3,17,10,16,0,46,30,16
2954,E02000080,2009,83,212000,212000,3,46,27,7,0,83,76,7
2955,E02000080,2010,111,231000,230000,4,69,29,9,0,111,101,10
2956,E02000080,2011,109,227000,229000,5,67,21,16,2,107,93,16
2957,E02000080,2012,121,230000,236000,7,82,16,16,0,121,105,16
2958,E02000080,2013,147,241000,245000,2,90,35,20,1,146,126,21
2959,E02000080,2014,51,243000,250000,2,24,14,11,2,49,40,11
2960,E02000081,2009,70,189000,181000,3,30,23,14,0,70,55,15
2961,E02000081,2010,95,224000,228000,7,45,25,18,0,95,76,19
2962,E02000081,2011,93,229000,232000,4,54,22,13,0,93,77,16
2963,E02000081,2012,89,215000,210000,2,40,22,25,0,89,63,26
2964,E02000081,2013,100,243000,240000,9,49,23,19,1,99,81,19
2965,E02000081,2014,50,247000,246000,4,24,10,12,0,50,37,13
2966,E02000082,2009,90,212000,210000,3,38,45,4,0,90,88,2
2967,E02000082,2010,98,224000,222000,1,42,50,5,0,98,93,5
2968,E02000082,2011,96,238000,230000,4,42,48,2,0,96,93,3
2969,E02000082,2012,113,246000,237000,7,47,57,2,0,113,111,2
2970,E02000082,2013,140,255000,250000,8,54,73,5,2,138,135,5
2971,E02000082,2014,42,274000,254000,4,16,18,4,0,42,38,4
2972,E02000083,2009,97,195000,185000,10,27,40,20,0,97,76,21
2973,E02000083,2010,126,190000,184000,10,35,58,23,0,126,105,21
2974,E02000083,2011,128,186000,175000,8,41,58,21,0,128,108,20
2975,E02000083,2012,185,190000,180000,5,45,71,64,60,125,120,65
2976,E02000083,2013,199,205000,190000,8,36,81,74,71,128,124,75
2977,E02000083,2014,67,224000,220000,6,9,30,22,16,51,45,22
2978,E02000084,2009,113,238000,212000,14,41,37,21,0,113,94,19
2979,E02000084,2010,106,271000,250000,14,58,22,12,0,106,94,12
2980,E02000084,2011,132,274000,249000,22,68,27,15,0,132,116,16
2981,E02000084,2012,129,267000,250000,19,57,33,20,1,128,109,20
2982,E02000084,2013,173,292000,270000,34,73,43,23,0,173,147,26
2983,E02000084,2014,59,331000,320000,19,24,13,3,0,59,56,3
2984,E02000085,2009,94,194000,188000,1,23,60,10,0,94,85,9
2985,E02000085,2010,99,219000,206000,1,33,57,8,0,99,91,8
2986,E02000085,2011,92,224000,210000,1,28,51,12,1,91,79,13
2987,E02000085,2012,96,245000,221000,3,36,51,6,0,96,89,7
2988,E02000085,2013,140,244000,224000,6,44,77,13,0,140,127,13
2989,E02000085,2014,50,252000,242000,1,10,30,9,0,50,41,9
2990,E02000086,2009,83,258000,235000,10,36,33,4,0,83,78,5
2991,E02000086,2010,81,257000,240000,6,33,33,9,0,81,73,8
2992,E02000086,2011,95,260000,239000,7,44,33,11,0,95,85,10
2993,E02000086,2012,98,266000,249000,11,37,40,10,0,98,87,11
2994,E02000086,2013,97,291000,250000,11,33,40,13,0,97,84,13
2995,E02000086,2014,44,268000,256000,1,11,24,8,0,44,35,9
2996,E02000087,2009,70,303000,257000,22,21,12,15,0,70,55,15
2997,E02000087,2010,141,331000,300000,38,45,30,28,17,124,114,27
2998,E02000087,2011,96,355000,324000,34,28,15,19,6,90,78,18
2999,E02000087,2012,122,318000,261000,29,32,32,29,14,108,93,29
3000,E02000087,2013,184,318000,270000,38,42,26,78,62,122,104,80
3001,E02000087,2014,51,341000,275000,12,13,15,11,0,51,40,11
3002,E02000088,2009,87,229000,212000,4,30,51,2,0,87,86,1
3003,E02000088,2010,88,255000,245000,3,40,42,3,0,88,86,2
3004,E02000088,2011,102,275000,250000,7,53,39,3,0,102,100,2
3005,E02000088,2012,96,278000,255000,5,37,53,1,0,96,95,1
3006,E02000088,2013,112,286000,276000,3,48,57,4,0,112,108,4
3007,E02000088,2014,38,300000,279000,3,13,20,2,0,38,36,2
3008,E02000089,2009,78,255000,249000,11,39,24,4,0,78,75,3
3009,E02000089,2010,101,276000,269000,5,63,28,5,0,101,96,5
3010,E02000089,2011,83,282000,273000,7,47,27,2,1,82,81,2
3011,E02000089,2012,91,291000,285000,7,53,25,6,0,91,85,6
3012,E02000089,2013,97,309000,305000,9,57,26,5,4,93,92,5
3013,E02000089,2014,34,346000,336000,1,22,9,2,0,34,32,2
3014,E02000090,2009,141,220000,187000,14,22,29,76,8,133,65,76
3015,E02000090,2010,137,237000,210000,11,36,29,61,3,134,73,64
3016,E02000090,2011,142,223000,192000,9,25,37,71,1,141,69,73
3017,E02000090,2012,187,241000,210000,18,28,28,113,46,141,72,115
3018,E02000090,2013,222,233000,195000,18,29,38,137,43,179,83,139
3019,E02000090,2014,61,237000,195000,3,11,11,36,3,58,25,36
3020,E02000091,2009,118,232000,208000,7,51,11,49,6,112,68,50
3021,E02000091,2010,143,257000,220000,11,53,21,58,8,135,85,58
3022,E02000091,2011,130,261000,234000,10,51,21,48,5,125,80,50
3023,E02000091,2012,153,258000,235000,10,57,20,66,2,151,87,66
3024,E02000091,2013,150,274000,250000,14,53,31,52,6,144,96,54
3025,E02000091,2014,60,301000,245000,6,13,10,31,3,57,29,31
3026,E02000092,2009,58,203000,187000,4,26,14,14,0,58,43,15
3027,E02000092,2010,44,213000,200000,4,16,10,14,0,44,30,14
3028,E02000092,2011,57,225000,190000,7,18,17,15,0,57,42,15
3029,E02000092,2012,52,235000,204000,4,23,15,10,0,52,41,11
3030,E02000092,2013,81,220000,196000,2,30,24,25,0,81,53,28
3031,E02000092,2014,18,230000,200000,1,3,6,8,0,18,10,8
3032,E02000093,2009,31,271000,285000,3,11,10,7,0,31,24,7
3033,E02000093,2010,73,290000,312000,3,21,26,23,1,72,49,24
3034,E02000093,2011,66,316000,320000,1,27,24,14,0,66,52,14
3035,E02000093,2012,38,306000,319000,0,17,15,6,1,37,31,7
3036,E02000093,2013,66,326000,340000,2,24,22,18,0,66,47,19
3037,E02000093,2014,15,352000,366000,1,6,4,4,0,15,11,4
3038,E02000094,2009,40,259000,260000,1,14,16,9,0,40,29,11
3039,E02000094,2010,41,258000,288000,0,15,10,16,0,41,24,17
3040,E02000094,2011,47,281000,308000,0,15,15,17,0,47,28,19
3041,E02000094,2012,41,299000,320000,3,18,9,11,1,40,27,14
3042,E02000094,2013,53,331000,345000,4,29,10,10,0,53,40,13
3043,E02000094,2014,19,345000,338000,0,7,3,9,0,19,10,9
3044,E02000095,2009,49,295000,295000,1,24,7,17,2,47,32,17
3045,E02000095,2010,55,283000,295000,1,26,7,21,0,55,34,21
3046,E02000095,2011,51,296000,311000,1,17,16,17,0,51,35,16
3047,E02000095,2012,47,349000,379000,1,26,10,10,0,47,37,10
3048,E02000095,2013,68,333000,366000,4,35,5,24,4,64,43,25
3049,E02000095,2014,37,327000,250000,0,12,5,20,10,27,16,21
3050,E02000096,2009,51,372000,385000,13,23,2,13,0,51,37,14
3051,E02000096,2010,69,425000,436000,17,35,2,15,0,69,54,15
3052,E02000096,2011,53,417000,435000,16,21,2,14,1,52,39,14
3053,E02000096,2012,61,393000,425000,15,26,1,19,0,61,42,19
3054,E02000096,2013,49,411000,470000,6,27,2,14,2,47,35,14
3055,E02000096,2014,25,485000,525000,6,14,0,5,0,25,20,5
3056,E02000097,2009,67,299000,280000,3,39,15,10,0,67,56,11
3057,E02000097,2010,65,292000,290000,1,21,29,14,0,65,51,14
3058,E02000097,2011,47,305000,300000,3,23,9,12,0,47,35,12
3059,E02000097,2012,55,312000,310000,3,28,7,17,0,55,38,17
3060,E02000097,2013,56,312000,306000,1,20,17,18,2,54,37,19
3061,E02000097,2014,21,356000,330000,1,9,8,3,0,21,18,3
3062,E02000098,2009,40,317000,312000,3,25,4,8,0,40,32,8
3063,E02000098,2010,57,360000,360000,11,26,4,16,0,57,42,15
3064,E02000098,2011,52,358000,366000,13,20,6,13,0,52,39,13
3065,E02000098,2012,52,360000,357000,8,22,5,17,0,52,35,17
3066,E02000098,2013,72,411000,422000,17,34,5,16,0,72,55,17
3067,E02000098,2014,22,434000,472000,6,9,1,6,0,22,16,6
3068,E02000099,2009,42,252000,280000,0,15,11,16,0,42,27,15
3069,E02000099,2010,66,275000,275000,1,20,18,27,2,64,40,26
3070,E02000099,2011,49,294000,308000,0,17,13,19,0,49,30,19
3071,E02000099,2012,59,301000,310000,3,18,16,22,0,59,36,23
3072,E02000099,2013,71,297000,265000,2,25,10,34,1,70,37,34
3073,E02000099,2014,22,343000,388000,0,10,4,8,0,22,14,8
3074,E02000100,2009,33,404000,365000,7,19,5,2,0,33,31,2
3075,E02000100,2010,44,370000,361000,9,18,5,12,1,43,32,12
3076,E02000100,2011,71,389000,385000,10,33,10,18,13,58,52,19
3077,E02000100,2012,45,398000,370000,5,29,7,4,0,45,41,4
3078,E02000100,2013,49,403000,415000,10,21,8,10,0,49,39,10
3079,E02000100,2014,22,526000,530000,7,14,0,1,0,22,21,1
3080,E02000101,2009,36,281000,244000,5,9,3,19,0,36,16,20
3081,E02000101,2010,67,306000,225000,11,10,8,38,2,65,28,39
3082,E02000101,2011,72,338000,246000,17,14,5,36,2,70,37,35
3083,E02000101,2012,52,328000,232000,11,10,4,27,0,52,25,27
3084,E02000101,2013,42,368000,250000,8,7,5,22,0,42,21,21
3085,E02000101,2014,37,368000,248000,9,4,1,23,0,37,13,24
3086,E02000102,2009,29,251000,250000,0,5,16,8,4,25,20,9
3087,E02000102,2010,48,263000,280000,0,5,30,13,0,48,35,13
3088,E02000102,2011,41,240000,250000,0,7,20,14,1,40,27,14
3089,E02000102,2012,34,253000,261000,0,1,20,13,0,34,21,13
3090,E02000102,2013,36,264000,250000,1,3,21,11,0,36,23,13
3091,E02000102,2014,17,286000,230000,0,2,7,8,1,16,9,8
3092,E02000103,2009,39,281000,275000,2,13,10,14,0,39,23,16
3093,E02000103,2010,44,283000,250000,0,14,7,23,0,44,20,24
3094,E02000103,2011,67,299000,292000,5,24,9,29,0,67,36,31
3095,E02000103,2012,47,308000,288000,4,13,10,20,0,47,26,21
3096,E02000103,2013,60,345000,304000,2,19,7,32,4,56,27,33
3097,E02000103,2014,61,333000,298000,1,12,4,44,33,28,17,44
3098,E02000104,2009,30,313000,300000,4,18,3,5,0,30,25,5
3099,E02000104,2010,56,316000,328000,3,26,9,18,1,55,38,18
3100,E02000104,2011,66,307000,323000,5,31,7,23,1,65,43,23
3101,E02000104,2012,51,299000,280000,2,23,3,23,0,51,28,23
3102,E02000104,2013,48,323000,306000,4,21,3,20,0,48,28,20
3103,E02000104,2014,16,292000,250000,0,7,0,9,0,16,7,9
3104,E02000105,2009,51,260000,234000,2,13,15,21,3,48,32,19
3105,E02000105,2010,67,271000,267000,4,24,8,31,4,63,39,28
3106,E02000105,2011,53,279000,250000,9,17,12,15,1,52,39,14
3107,E02000105,2012,45,254000,210000,1,11,8,25,1,44,20,25
3108,E02000105,2013,51,268000,232000,5,15,4,27,1,50,24,27
3109,E02000105,2014,16,302000,298000,3,4,2,7,0,16,9,7
3110,E02000106,2009,29,254000,250000,0,6,12,11,0,29,17,12
3111,E02000106,2010,60,257000,224000,0,15,15,30,0,60,30,30
3112,E02000106,2011,43,305000,289000,1,10,18,14,1,42,27,16
3113,E02000106,2012,52,313000,307000,1,12,21,18,0,52,33,19
3114,E02000106,2013,59,321000,250000,1,15,17,26,0,59,29,30
3115,E02000106,2014,28,371000,333000,0,8,7,13,0,28,14,14
3116,E02000107,2009,47,486000,297000,9,3,10,25,0,47,22,25
3117,E02000107,2010,98,445000,302000,5,19,15,59,0,98,39,59
3118,E02000107,2011,86,462000,313000,5,11,15,55,0,86,29,57
3119,E02000107,2012,80,421000,322000,1,10,11,58,1,79,21,59
3120,E02000107,2013,106,491000,355000,6,16,13,71,3,103,33,73
3121,E02000107,2014,38,504000,380000,2,2,5,29,1,37,8,30
3122,E02000108,2009,28,246000,238000,0,10,7,11,0,28,17,11
3123,E02000108,2010,53,248000,250000,1,13,17,22,0,53,31,22
3124,E02000108,2011,42,263000,262000,2,11,18,11,0,42,31,11
3125,E02000108,2012,57,235000,240000,0,4,10,43,27,30,15,42
3126,E02000108,2013,42,283000,238000,7,6,5,24,9,33,18,24
3127,E02000108,2014,4,254000,225000,0,0,1,3,0,4,1,3
3128,E02000109,2009,51,246000,227000,1,7,8,35,19,32,17,34
3129,E02000109,2010,107,245000,235000,0,14,9,84,60,47,23,84
3130,E02000109,2011,74,262000,250000,2,19,9,44,27,47,30,44
3131,E02000109,2012,71,247000,245000,0,25,4,42,22,49,29,42
3132,E02000109,2013,71,271000,270000,2,15,9,45,16,55,26,45
3133,E02000109,2014,23,274000,240000,1,4,1,17,2,21,6,17
3134,E02000110,2009,44,338000,294000,0,8,11,25,0,44,19,25
3135,E02000110,2010,65,455000,425000,0,21,18,26,1,64,39,26
3136,E02000110,2011,57,426000,460000,1,13,22,21,0,57,35,22
3137,E02000110,2012,65,506000,500000,0,23,19,23,4,61,42,23
3138,E02000110,2013,70,552000,540000,3,19,19,29,4,66,40,30
3139,E02000110,2014,25,615000,580000,1,4,5,15,0,25,10,15
3140,E02000111,2009,29,214000,190000,0,7,7,15,0,29,14,15
3141,E02000111,2010,50,265000,239000,3,13,11,23,0,50,26,24
3142,E02000111,2011,47,249000,230000,2,9,13,23,0,47,23,24
3143,E02000111,2012,39,299000,260000,5,11,7,16,0,39,22,17
3144,E02000111,2013,60,273000,244000,2,20,9,29,1,59,31,29
3145,E02000111,2014,18,247000,238000,0,3,1,14,1,17,4,14
3146,E02000112,2009,28,229000,234000,0,7,10,11,0,28,19,9
3147,E02000112,2010,58,231000,235000,0,10,12,36,25,33,22,36
3148,E02000112,2011,45,268000,265000,1,13,17,14,2,43,32,13
3149,E02000112,2012,36,278000,292000,1,7,15,13,1,35,23,13
3150,E02000112,2013,73,270000,265000,0,9,19,45,27,46,26,47
3151,E02000112,2014,30,269000,266000,0,1,5,24,13,17,6,24
3152,E02000113,2009,21,188000,175000,0,3,7,11,0,21,10,11
3153,E02000113,2010,37,207000,205000,0,5,11,21,1,36,18,19
3154,E02000113,2011,38,206000,211000,0,6,16,16,2,36,22,16
3155,E02000113,2012,12,249000,245000,0,2,9,1,0,12,11,1
3156,E02000113,2013,29,223000,217000,1,0,10,18,2,27,11,18
3157,E02000113,2014,19,235000,227000,0,3,6,10,0,19,9,10
3158,E02000114,2009,43,343000,272000,3,3,12,25,0,43,18,25
3159,E02000114,2010,80,335000,279000,0,10,15,55,1,79,24,56
3160,E02000114,2011,78,350000,276000,4,6,15,53,1,77,22,56
3161,E02000114,2012,72,402000,308000,3,6,12,51,1,71,18,54
3162,E02000114,2013,109,403000,355000,5,4,18,82,32,77,25,84
3163,E02000114,2014,37,419000,400000,0,3,6,28,1,36,8,29
3164,E02000115,2009,75,410000,315000,5,3,2,65,2,73,10,65
3165,E02000115,2010,106,413000,337000,4,3,2,97,10,96,9,97
3166,E02000115,2011,88,458000,358000,4,6,1,77,0,88,9,79
3167,E02000115,2012,99,475000,383000,8,2,1,88,2,97,9,90
3168,E02000115,2013,120,608000,445000,10,11,2,97,3,117,19,101
3169,E02000115,2014,48,504000,425000,2,2,0,44,2,46,3,45
3170,E02000116,2009,28,250000,220000,1,0,5,22,0,28,7,21
3171,E02000116,2010,40,251000,232000,0,2,10,28,0,40,10,30
3172,E02000116,2011,39,249000,227000,1,2,10,26,2,37,13,26
3173,E02000116,2012,44,296000,278000,1,2,15,26,1,43,15,29
3174,E02000116,2013,48,310000,275000,0,4,12,32,0,48,14,34
3175,E02000116,2014,12,379000,355000,0,0,4,8,0,12,4,8
3176,E02000117,2009,39,198000,175000,0,3,9,27,1,38,12,27
3177,E02000117,2010,56,213000,198000,0,3,11,42,1,55,12,44
3178,E02000117,2011,49,247000,223000,0,7,10,32,4,45,16,33
3179,E02000117,2012,47,257000,238000,0,3,16,28,0,47,19,28
3180,E02000117,2013,72,291000,250000,0,6,16,50,0,72,19,53
3181,E02000117,2014,22,338000,322000,0,1,11,10,1,21,12,10
3182,E02000118,2009,28,217000,227000,0,6,13,9,1,27,20,8
3183,E02000118,2010,83,231000,249000,0,5,20,58,31,52,27,56
3184,E02000118,2011,57,246000,250000,0,8,18,31,9,48,26,31
3185,E02000118,2012,52,233000,222000,0,9,12,31,12,40,21,31
3186,E02000118,2013,73,235000,225000,0,11,18,44,17,56,26,47
3187,E02000118,2014,20,282000,300000,0,4,10,6,0,20,14,6
3188,E02000119,2009,34,219000,199000,1,0,3,30,17,17,5,29
3189,E02000119,2010,45,184000,169000,0,0,6,39,16,29,6,39
3190,E02000119,2011,25,202000,180000,0,0,5,20,4,21,5,20
3191,E02000119,2012,15,226000,226000,0,0,5,10,0,15,5,10
3192,E02000119,2013,20,237000,236000,0,0,4,16,0,20,4,16
3193,E02000119,2014,15,236000,230000,0,0,4,11,0,15,4,11
3194,E02000120,2009,137,345000,297000,1,3,18,115,64,73,19,118
3195,E02000120,2010,139,395000,320000,2,4,24,109,2,137,27,112
3196,E02000120,2011,123,431000,360000,2,1,26,94,2,121,25,98
3197,E02000120,2012,104,525000,416000,2,0,29,73,1,103,29,75
3198,E02000120,2013,138,524000,422000,1,1,27,109,1,137,27,111
3199,E02000120,2014,52,539000,399000,0,0,5,47,0,52,5,47
3200,E02000121,2009,33,206000,205000,0,6,8,19,0,33,13,20
3201,E02000121,2010,39,219000,227000,0,5,13,21,0,39,17,22
3202,E02000121,2011,75,221000,220000,1,3,16,55,32,43,19,56
3203,E02000121,2012,61,226000,210000,0,9,11,41,19,42,19,42
3204,E02000121,2013,55,247000,230000,0,4,21,30,1,54,25,30
3205,E02000121,2014,25,270000,235000,0,4,6,15,0,25,10,15
3206,E02000122,2009,64,580000,392000,7,13,10,34,0,64,30,34
3207,E02000122,2010,86,743000,654000,11,17,23,35,1,85,48,38
3208,E02000122,2011,78,619000,408000,1,21,13,43,0,78,33,45
3209,E02000122,2012,99,839000,710000,12,21,23,43,1,98,55,44
3210,E02000122,2013,113,892000,707000,5,27,24,57,6,107,53,60
3211,E02000122,2014,40,1022000,670000,6,7,8,19,2,38,20,20
3212,E02000123,2009,66,250000,218000,0,6,20,40,1,65,23,43
3213,E02000123,2010,98,271000,248000,0,11,24,63,2,96,29,69
3214,E02000123,2011,104,270000,236000,1,8,22,73,4,100,27,77
3215,E02000123,2012,87,327000,310000,0,5,24,58,0,87,26,61
3216,E02000123,2013,106,360000,310000,1,3,29,73,3,103,31,75
3217,E02000123,2014,41,392000,350000,0,3,12,26,3,38,13,28
3218,E02000124,2009,106,490000,358000,0,6,34,66,1,105,39,67
3219,E02000124,2010,152,590000,419000,1,10,51,90,4,148,58,94
3220,E02000124,2011,167,608000,460000,0,7,55,105,9,158,60,107
3221,E02000124,2012,158,533000,375000,0,2,27,129,46,112,30,128
3222,E02000124,2013,160,754000,488000,0,5,46,109,10,150,51,109
3223,E02000124,2014,56,865000,622000,0,1,24,31,0,56,23,33
3224,E02000125,2009,76,356000,320000,0,5,30,41,0,76,34,42
3225,E02000125,2010,134,398000,350000,2,11,43,78,5,129,53,81
3226,E02000125,2011,110,452000,382000,1,4,56,49,0,110,54,56
3227,E02000125,2012,110,511000,424000,1,5,52,52,1,109,52,58
3228,E02000125,2013,129,584000,485000,0,6,58,65,1,128,59,70
3229,E02000125,2014,36,661000,610000,0,2,18,16,0,36,20,16
3230,E02000126,2009,24,262000,248000,0,0,3,21,6,18,2,22
3231,E02000126,2010,53,283000,252000,0,1,2,50,21,32,3,50
3232,E02000126,2011,28,334000,295000,0,0,1,27,0,28,1,27
3233,E02000126,2012,31,308000,305000,0,0,2,29,4,27,2,29
3234,E02000126,2013,84,367000,350000,0,1,4,79,29,55,4,80
3235,E02000126,2014,35,402000,375000,0,1,2,32,12,23,2,33
3236,E02000127,2009,68,207000,175000,3,14,37,14,0,68,55,13
3237,E02000127,2010,89,244000,199000,8,20,47,14,0,89,75,14
3238,E02000127,2011,91,220000,180000,8,10,51,22,0,91,70,21
3239,E02000127,2012,97,249000,195000,8,18,55,16,0,97,80,17
3240,E02000127,2013,117,268000,206000,13,17,65,22,0,117,95,22
3241,E02000127,2014,45,248000,223000,3,4,24,14,0,45,31,14
3242,E02000128,2009,89,294000,250000,7,37,36,9,0,89,80,9
3243,E02000128,2010,119,317000,268000,8,42,45,24,0,119,97,22
3244,E02000128,2011,104,377000,290000,11,26,55,12,2,102,92,12
3245,E02000128,2012,114,305000,285000,7,29,57,21,2,112,92,22
3246,E02000128,2013,124,338000,315000,8,44,54,18,0,124,106,18
3247,E02000128,2014,41,312000,300000,3,8,17,13,0,41,28,13
3248,E02000130,2009,89,263000,230000,1,21,36,31,1,88,59,30
3249,E02000130,2010,103,320000,248000,5,22,39,37,0,103,65,38
3250,E02000130,2011,111,300000,265000,2,32,44,33,0,111,77,34
3251,E02000130,2012,126,310000,280000,2,24,60,40,3,123,85,41
3252,E02000130,2013,133,363000,316000,2,41,46,44,0,133,88,45
3253,E02000130,2014,65,394000,330000,3,11,17,34,1,64,30,35
3254,E02000131,2009,95,208000,188000,4,4,12,75,3,92,21,74
3255,E02000131,2010,136,223000,205000,2,4,12,118,0,136,18,118
3256,E02000131,2011,186,226000,200000,5,12,10,159,43,143,25,161
3257,E02000131,2012,211,225000,185000,4,6,19,182,62,149,27,184
3258,E02000131,2013,247,262000,236000,1,9,30,207,44,203,37,210
3259,E02000131,2014,109,269000,243000,1,5,3,100,28,81,7,102
3260,E02000132,2009,171,243000,210000,8,13,22,128,25,146,42,129
3261,E02000132,2010,194,267000,240000,8,20,37,129,16,178,64,130
3262,E02000132,2011,152,250000,235000,1,12,23,116,1,151,35,117
3263,E02000132,2012,231,282000,246000,9,19,40,163,13,218,65,166
3264,E02000132,2013,213,296000,250000,15,13,33,152,9,204,60,153
3265,E02000132,2014,75,298000,260000,3,3,8,61,0,75,14,61
3266,E02000133,2009,158,582000,500000,82,22,25,29,16,142,125,33
3267,E02000133,2010,199,540000,465000,79,20,44,56,17,182,138,61
3268,E02000133,2011,188,549000,464000,74,26,39,49,20,168,133,55
3269,E02000133,2012,240,578000,500000,112,24,45,59,61,179,170,70
3270,E02000133,2013,279,550000,405000,97,33,58,91,53,226,185,94
3271,E02000133,2014,70,603000,485000,28,6,15,21,2,68,48,22
3272,E02000134,2009,196,239000,216000,9,26,48,113,25,171,81,115
3273,E02000134,2010,181,271000,230000,15,17,54,95,5,176,86,95
3274,E02000134,2011,192,271000,231000,11,20,55,106,8,184,83,109
3275,E02000134,2012,229,298000,248000,14,37,66,112,7,222,117,112
3276,E02000134,2013,253,290000,245000,11,31,65,146,2,251,108,145
3277,E02000134,2014,96,304000,250000,10,7,19,60,1,95,36,60
3278,E02000135,2009,54,194000,174000,0,6,12,36,3,51,17,37
3279,E02000135,2010,58,191000,167000,3,4,12,39,1,57,17,41
3280,E02000135,2011,66,197000,168000,0,5,19,42,3,63,23,43
3281,E02000135,2012,79,208000,190000,1,5,21,52,6,73,27,52
3282,E02000135,2013,89,202000,185000,2,4,10,73,1,88,16,73
3283,E02000135,2014,42,230000,229000,1,0,6,35,0,42,6,36
3284,E02000136,2009,55,327000,222000,15,14,17,9,4,51,45,10
3285,E02000136,2010,66,370000,273000,18,25,12,11,3,63,53,13
3286,E02000136,2011,59,457000,335000,19,15,7,18,7,52,42,17
3287,E02000136,2012,64,383000,254000,23,12,15,14,0,64,51,13
3288,E02000136,2013,79,492000,430000,30,11,22,16,0,79,63,16
3289,E02000136,2014,27,438000,350000,8,7,10,2,0,27,25,2
3290,E02000137,2009,111,300000,242000,15,22,15,59,3,108,50,61
3291,E02000137,2010,147,310000,250000,23,24,13,87,8,139,59,88
3292,E02000137,2011,197,308000,250000,28,25,25,119,15,182,77,120
3293,E02000137,2012,142,326000,264000,19,23,21,79,1,141,63,79
3294,E02000137,2013,157,353000,286000,28,22,25,82,1,156,73,84
3295,E02000137,2014,65,385000,275000,16,8,5,36,1,64,28,37
3296,E02000138,2009,199,296000,243000,27,14,10,148,13,186,47,152
3297,E02000138,2010,177,330000,260000,16,21,25,115,6,171,61,116
3298,E02000138,2011,180,395000,281000,41,11,20,108,6,174,71,109
3299,E02000138,2012,200,361000,275000,24,10,28,138,8,192,60,140
3300,E02000138,2013,208,377000,303000,17,15,23,153,25,183,53,155
3301,E02000138,2014,71,498000,360000,14,5,8,44,2,69,26,45
3302,E02000139,2009,117,263000,230000,5,34,30,48,25,92,71,46
3303,E02000139,2010,128,325000,279000,5,44,49,30,0,128,96,32
3304,E02000139,2011,118,296000,248000,3,34,31,50,1,117,68,50
3305,E02000139,2012,129,330000,285000,6,37,43,43,5,124,85,44
3306,E02000139,2013,171,369000,300000,9,51,53,58,19,152,111,60
3307,E02000139,2014,52,406000,339000,2,24,11,15,0,52,37,15
3308,E02000140,2009,59,170000,173000,2,20,23,14,2,57,44,15
3309,E02000140,2010,53,197000,185000,1,25,19,8,5,48,45,8
3310,E02000140,2011,55,187000,190000,2,31,16,6,0,55,49,6
3311,E02000140,2012,76,208000,200000,5,45,17,9,0,76,67,9
3312,E02000140,2013,77,206000,206000,4,39,22,12,0,77,64,13
3313,E02000140,2014,39,208000,225000,0,16,12,11,0,39,28,11
3314,E02000141,2009,99,217000,211000,0,13,43,43,2,97,53,46
3315,E02000141,2010,81,231000,245000,1,14,32,34,1,80,44,37
3316,E02000141,2011,112,241000,239000,1,17,46,48,0,112,62,50
3317,E02000141,2012,106,245000,239000,0,9,44,53,0,106,52,54
3318,E02000141,2013,137,260000,250000,3,16,48,70,1,136,63,74
3319,E02000141,2014,64,294000,284000,1,5,24,34,0,64,28,36
3320,E02000142,2009,110,360000,288000,19,27,34,30,0,110,81,29
3321,E02000142,2010,127,349000,285000,21,29,39,38,1,126,88,39
3322,E02000142,2011,125,357000,300000,26,21,41,37,5,120,88,37
3323,E02000142,2012,124,335000,278000,20,16,46,42,9,115,82,42
3324,E02000142,2013,152,371000,303000,26,20,42,64,12,140,88,64
3325,E02000142,2014,62,420000,368000,13,10,16,23,4,58,39,23
3326,E02000144,2009,121,274000,250000,11,27,27,56,11,110,65,56
3327,E02000144,2010,140,299000,265000,23,23,42,52,5,135,89,51
3328,E02000144,2011,132,319000,275000,21,32,41,38,1,131,94,38
3329,E02000144,2012,144,333000,296000,27,23,46,48,4,140,93,51
3330,E02000144,2013,156,315000,275000,20,28,38,70,1,155,85,71
3331,E02000144,2014,56,347000,322000,10,9,9,28,0,56,28,28
3332,E02000145,2009,65,165000,165000,1,24,31,9,0,65,59,6
3333,E02000145,2010,63,173000,165000,3,21,31,8,0,63,54,9
3334,E02000145,2011,54,183000,172000,2,23,21,8,0,54,46,8
3335,E02000145,2012,70,175000,170000,1,27,31,11,0,70,60,10
3336,E02000145,2013,124,201000,191000,3,31,74,16,22,102,109,15
3337,E02000145,2014,58,226000,210000,2,16,32,8,15,43,50,8
3338,E02000146,2009,107,234000,230000,5,27,52,23,0,107,83,24
3339,E02000146,2010,167,279000,260000,12,56,69,30,0,167,137,30
3340,E02000146,2011,162,267000,250000,4,54,72,32,24,138,129,33
3341,E02000146,2012,239,266000,245000,11,48,58,122,100,139,115,124
3342,E02000146,2013,169,291000,279000,6,43,81,39,1,168,128,41
3343,E02000146,2014,46,330000,307000,5,7,21,13,0,46,33,13
3344,E02000147,2009,102,411000,390000,39,22,7,34,5,97,67,35
3345,E02000147,2010,110,480000,485000,45,24,3,38,1,109,71,39
3346,E02000147,2011,121,448000,445000,47,22,5,47,8,113,73,48
3347,E02000147,2012,100,456000,440000,41,18,2,39,0,100,60,40
3348,E02000147,2013,138,487000,480000,54,31,5,48,1,137,90,48
3349,E02000147,2014,43,543000,550000,15,12,2,14,0,43,29,14
3350,E02000148,2009,95,401000,350000,23,56,10,6,1,94,89,6
3351,E02000148,2010,93,454000,405000,28,48,12,5,0,93,87,6
3352,E02000148,2011,95,476000,440000,33,50,8,4,0,95,90,5
3353,E02000148,2012,95,426000,378000,24,51,9,11,0,95,84,11
3354,E02000148,2013,94,487000,420000,21,58,7,8,0,94,86,8
3355,E02000148,2014,31,498000,484000,6,21,3,1,0,31,30,1
3356,E02000149,2009,91,205000,190000,6,31,41,13,0,91,81,10
3357,E02000149,2010,77,233000,220000,12,41,18,6,0,77,71,6
3358,E02000149,2011,71,231000,225000,12,31,20,8,0,71,63,8
3359,E02000149,2012,95,221000,215000,13,41,33,8,0,95,87,8
3360,E02000149,2013,114,235000,220000,15,46,35,18,3,111,95,19
3361,E02000149,2014,38,253000,244000,5,18,8,7,0,38,31,7
3362,E02000150,2009,119,341000,290000,9,43,59,8,0,119,111,8
3363,E02000150,2010,88,362000,334000,5,22,49,12,0,88,76,12
3364,E02000150,2011,86,374000,333000,5,21,51,9,1,85,78,8
3365,E02000150,2012,104,392000,340000,8,21,64,11,1,103,93,11
3366,E02000150,2013,118,411000,372000,6,24,76,12,0,118,106,12
3367,E02000150,2014,31,391000,375000,1,5,22,3,0,31,28,3
3368,E02000151,2009,91,354000,330000,22,51,10,8,0,91,81,10
3369,E02000151,2010,108,400000,380000,22,71,7,8,0,108,100,8
3370,E02000151,2011,105,445000,423000,29,67,4,5,0,105,97,8
3371,E02000151,2012,107,462000,430000,26,71,3,7,0,107,100,7
3372,E02000151,2013,146,444000,437000,34,94,5,13,0,146,131,15
3373,E02000151,2014,49,497000,485000,13,31,3,2,0,49,45,4
3374,E02000152,2009,58,264000,234000,6,25,20,7,0,58,50,8
3375,E02000152,2010,72,258000,250000,5,33,22,12,7,65,63,9
3376,E02000152,2011,81,288000,265000,5,37,30,9,11,70,73,8
3377,E02000152,2012,127,321000,305000,9,27,80,11,74,53,115,12
3378,E02000152,2013,198,305000,284000,8,42,78,70,119,79,128,70
3379,E02000152,2014,30,332000,314000,3,13,8,6,0,30,24,6
3380,E02000153,2009,101,324000,315000,9,70,20,2,0,101,99,2
3381,E02000153,2010,92,366000,367000,13,60,16,3,0,92,89,3
3382,E02000153,2011,109,367000,362000,10,77,19,3,3,106,106,3
3383,E02000153,2012,93,392000,385000,7,74,12,0,5,88,93,0
3384,E02000153,2013,110,420000,386000,18,64,25,3,3,107,108,2
3385,E02000153,2014,33,465000,435000,5,25,2,1,0,33,32,1
3386,E02000154,2009,116,254000,198000,24,24,23,45,31,85,72,44
3387,E02000154,2010,153,284000,218000,27,25,31,70,66,87,83,70
3388,E02000154,2011,90,335000,272000,27,23,18,22,0,90,68,22
3389,E02000154,2012,93,330000,275000,32,26,17,18,0,93,74,19
3390,E02000154,2013,133,345000,270000,36,32,39,26,0,133,107,26
3391,E02000154,2014,37,382000,335000,15,8,3,11,0,37,26,11
3392,E02000155,2009,86,208000,205000,1,51,21,13,0,86,74,12
3393,E02000155,2010,89,237000,236000,5,65,14,5,1,88,84,5
3394,E02000155,2011,103,231000,220000,10,63,21,9,1,102,94,9
3395,E02000155,2012,99,253000,250000,11,66,18,4,0,99,95,4
3396,E02000155,2013,99,256000,245000,7,70,14,8,0,99,91,8
3397,E02000155,2014,53,285000,280000,2,42,5,4,0,53,49,4
3398,E02000156,2009,167,318000,315000,22,77,32,36,1,166,131,36
3399,E02000156,2010,192,355000,360000,35,82,34,41,5,187,147,45
3400,E02000156,2011,162,356000,351000,26,71,31,34,3,159,125,37
3401,E02000156,2012,151,375000,375000,16,77,26,32,0,151,116,35
3402,E02000156,2013,166,384000,394000,26,68,34,38,0,166,127,39
3403,E02000156,2014,52,440000,456000,10,21,10,11,0,52,41,11
3404,E02000157,2009,102,296000,270000,28,34,31,9,0,102,93,9
3405,E02000157,2010,105,331000,317000,31,43,24,7,0,105,98,7
3406,E02000157,2011,100,336000,328000,34,39,19,8,0,100,92,8
3407,E02000157,2012,101,342000,320000,32,29,27,13,0,101,88,13
3408,E02000157,2013,132,368000,340000,40,51,26,15,0,132,117,15
3409,E02000157,2014,42,419000,391000,17,12,10,3,0,42,39,3
3410,E02000158,2009,50,292000,268000,13,24,8,5,0,50,46,4
3411,E02000158,2010,83,316000,288000,24,42,10,7,4,79,76,7
3412,E02000158,2011,63,302000,285000,16,37,7,3,4,59,60,3
3413,E02000158,2012,108,285000,250000,17,45,42,4,23,85,105,3
3414,E02000158,2013,112,321000,292000,36,35,30,11,15,97,101,11
3415,E02000158,2014,37,396000,398000,12,22,2,1,0,37,36,1
3416,E02000159,2009,104,582000,368000,49,20,21,14,6,98,88,16
3417,E02000159,2010,99,664000,422000,54,23,16,6,2,97,92,7
3418,E02000159,2011,102,722000,430000,54,28,4,16,6,96,88,14
3419,E02000159,2012,93,539000,382000,38,31,12,12,1,92,81,12
3420,E02000159,2013,119,695000,430000,63,33,11,12,0,119,107,12
3421,E02000159,2014,39,619000,440000,17,10,4,8,0,39,31,8
3422,E02000160,2009,75,337000,328000,16,41,4,14,0,75,60,15
3423,E02000160,2010,107,358000,335000,22,58,3,24,5,102,82,25
3424,E02000160,2011,108,333000,335000,16,64,10,18,2,106,90,18
3425,E02000160,2012,108,405000,358000,20,61,12,15,2,106,93,15
3426,E02000160,2013,96,354000,360000,13,57,8,18,0,96,78,18
3427,E02000160,2014,26,435000,420000,7,15,0,4,0,26,22,4
3428,E02000161,2009,109,272000,264000,23,46,38,2,0,109,107,2
3429,E02000161,2010,146,297000,280000,28,78,32,8,1,145,137,9
3430,E02000161,2011,116,295000,284000,24,51,27,14,0,116,103,13
3431,E02000161,2012,132,301000,294000,28,64,24,16,0,132,116,16
3432,E02000161,2013,147,309000,297000,30,72,35,10,0,147,137,10
3433,E02000161,2014,53,361000,350000,12,27,9,5,0,53,47,6
3434,E02000162,2009,83,283000,250000,19,25,24,15,0,83,68,15
3435,E02000162,2010,92,284000,272000,25,25,21,21,0,92,70,22
3436,E02000162,2011,79,307000,280000,24,25,19,11,0,79,67,12
3437,E02000162,2012,74,326000,292000,23,22,11,18,0,74,56,18
3438,E02000162,2013,94,333000,315000,33,24,17,20,0,94,74,20
3439,E02000162,2014,41,345000,350000,8,13,13,7,0,41,34,7
3440,E02000163,2009,88,364000,275000,35,28,22,3,1,87,85,3
3441,E02000163,2010,105,363000,310000,39,43,18,5,1,104,100,5
3442,E02000163,2011,88,488000,398000,43,23,18,4,0,88,84,4
3443,E02000163,2012,111,395000,320000,40,39,23,9,2,109,100,11
3444,E02000163,2013,102,433000,365000,36,37,27,2,1,101,99,3
3445,E02000163,2014,35,634000,460000,18,10,5,2,1,34,32,3
3446,E02000165,2009,69,238000,225000,13,23,30,3,2,67,66,3
3447,E02000165,2010,87,255000,245000,28,20,26,13,2,85,74,13
3448,E02000165,2011,90,240000,240000,18,27,34,11,1,89,79,11
3449,E02000165,2012,75,242000,233000,13,21,34,7,4,71,68,7
3450,E02000165,2013,114,266000,250000,34,32,34,14,5,109,99,15
3451,E02000165,2014,52,245000,247000,13,10,16,13,0,52,39,13
3452,E02000166,2009,95,780000,523000,11,15,10,59,3,92,36,59
3453,E02000166,2010,112,934000,538000,10,9,11,82,4,108,30,82
3454,E02000166,2011,99,834000,495000,8,4,12,75,3,96,22,77
3455,E02000166,2012,94,836000,425000,5,13,7,69,0,94,25,69
3456,E02000166,2013,88,815000,572000,4,6,9,69,1,87,20,68
3457,E02000166,2014,30,909000,672000,3,4,2,21,0,30,9,21
3458,E02000167,2009,114,1105000,748000,10,13,29,62,0,114,47,67
3459,E02000167,2010,141,1191000,715000,7,9,34,91,0,141,50,91
3460,E02000167,2011,113,1523000,922000,7,10,28,68,0,113,43,70
3461,E02000167,2012,94,1183000,718000,2,8,21,63,5,89,30,64
3462,E02000167,2013,119,1595000,1000000,3,11,34,71,1,118,50,69
3463,E02000167,2014,38,1333000,1048000,1,2,10,25,0,38,13,25
3464,E02000168,2009,90,458000,355000,0,3,23,64,3,87,29,61
3465,E02000168,2010,99,499000,360000,1,2,19,77,0,99,22,77
3466,E02000168,2011,92,551000,398000,1,6,24,61,1,91,29,63
3467,E02000168,2012,70,672000,438000,0,5,18,47,1,69,23,47
3468,E02000168,2013,101,734000,500000,0,6,25,70,0,101,28,73
3469,E02000168,2014,30,692000,595000,0,0,7,23,0,30,8,22
3470,E02000169,2009,79,1390000,800000,10,8,1,60,0,79,18,61
3471,E02000169,2010,127,1274000,855000,8,12,4,103,1,126,26,101
3472,E02000169,2011,104,1429000,928000,8,9,2,85,2,102,19,85
3473,E02000169,2012,106,1675000,1168000,9,6,4,87,0,106,19,87
3474,E02000169,2013,111,1735000,1000000,11,9,1,90,7,104,20,91
3475,E02000169,2014,50,1695000,1100000,7,4,1,38,1,49,11,39
3476,E02000170,2009,96,551000,437000,3,8,10,75,2,94,24,72
3477,E02000170,2010,124,601000,495000,2,10,15,97,31,93,25,99
3478,E02000170,2011,114,656000,520000,2,12,19,81,7,107,32,82
3479,E02000170,2012,135,718000,570000,2,11,20,102,9,126,33,102
3480,E02000170,2013,140,759000,650000,6,19,21,94,5,135,42,98
3481,E02000170,2014,42,805000,710000,0,7,4,31,0,42,11,31
3482,E02000171,2009,97,556000,430000,1,6,21,69,0,97,30,67
3483,E02000171,2010,121,535000,445000,1,4,16,100,4,117,22,99
3484,E02000171,2011,106,613000,492000,3,5,20,78,1,105,27,79
3485,E02000171,2012,96,817000,614000,2,4,15,75,0,96,20,76
3486,E02000171,2013,115,845000,660000,1,5,32,77,0,115,33,82
3487,E02000171,2014,38,881000,808000,0,2,5,31,0,38,7,31
3488,E02000172,2009,84,334000,250000,0,1,16,67,17,67,21,63
3489,E02000172,2010,72,431000,344000,0,4,18,50,10,62,19,53
3490,E02000172,2011,65,413000,325000,0,4,13,48,4,61,16,49
3491,E02000172,2012,63,481000,375000,1,1,13,48,1,62,15,48
3492,E02000172,2013,70,577000,561000,0,0,18,52,12,58,18,52
3493,E02000172,2014,31,528000,430000,0,0,6,25,0,31,7,24
3494,E02000173,2009,70,804000,578000,1,3,1,65,0,70,4,66
3495,E02000173,2010,117,1072000,660000,7,5,5,100,0,117,15,102
3496,E02000173,2011,107,921000,714000,0,7,4,96,0,107,9,98
3497,E02000173,2012,94,1271000,897000,3,8,6,77,2,92,13,81
3498,E02000173,2013,129,1164000,885000,5,2,7,115,6,123,14,115
3499,E02000173,2014,54,1035000,758000,0,2,2,50,1,53,3,51
3500,E02000174,2009,65,447000,345000,0,7,11,47,1,64,17,48
3501,E02000174,2010,80,472000,350000,2,1,13,64,0,80,17,63
3502,E02000174,2011,84,562000,430000,0,7,18,59,2,82,25,59
3503,E02000174,2012,74,499000,382000,0,3,9,62,0,74,12,62
3504,E02000174,2013,91,581000,470000,0,2,11,78,3,88,12,79
3505,E02000174,2014,24,672000,548000,0,1,3,20,0,24,4,20
3506,E02000175,2009,100,440000,388000,0,5,18,77,0,100,23,77
3507,E02000175,2010,145,565000,470000,1,5,19,120,2,143,24,121
3508,E02000175,2011,128,522000,432000,1,2,16,109,5,123,17,111
3509,E02000175,2012,122,570000,500000,1,2,13,106,0,122,13,109
3510,E02000175,2013,141,677000,550000,0,4,18,119,11,130,21,120
3511,E02000175,2014,39,601000,550000,0,0,4,35,0,39,4,35
3512,E02000176,2009,132,727000,585000,1,1,7,123,1,131,10,122
3513,E02000176,2010,135,750000,522000,0,2,9,124,1,134,11,124
3514,E02000176,2011,122,794000,666000,0,1,4,117,0,122,5,117
3515,E02000176,2012,120,824000,662000,0,0,5,115,7,113,6,114
3516,E02000176,2013,114,1044000,846000,2,0,9,103,0,114,10,104
3517,E02000176,2014,49,1078000,845000,0,2,3,44,0,49,4,45
3518,E02000177,2009,75,386000,325000,0,1,7,67,1,74,8,67
3519,E02000177,2010,89,618000,385000,1,6,24,58,0,89,31,58
3520,E02000177,2011,110,451000,370000,0,2,13,95,0,110,15,95
3521,E02000177,2012,110,490000,428000,0,1,12,97,10,100,13,97
3522,E02000177,2013,83,526000,432000,0,0,14,69,1,82,14,69
3523,E02000177,2014,27,566000,547000,0,0,3,24,0,27,3,24
3524,E02000178,2009,74,335000,304000,1,1,4,68,1,73,7,67
3525,E02000178,2010,117,353000,340000,0,1,7,109,1,116,8,109
3526,E02000178,2011,101,392000,350000,0,2,9,90,1,100,10,91
3527,E02000178,2012,166,430000,400000,2,1,12,151,12,154,15,151
3528,E02000178,2013,146,487000,437000,0,0,17,129,15,131,16,130
3529,E02000178,2014,47,462000,420000,0,0,3,44,0,47,4,43
3530,E02000179,2009,61,569000,460000,0,3,9,49,1,60,12,49
3531,E02000179,2010,113,789000,590000,0,3,13,97,35,78,15,98
3532,E02000179,2011,87,917000,615000,0,3,16,68,1,86,19,68
3533,E02000179,2012,84,871000,740000,1,4,19,60,1,83,21,63
3534,E02000179,2013,105,897000,775000,0,1,24,80,8,97,23,82
3535,E02000179,2014,34,879000,787000,0,0,4,30,0,34,4,30
3536,E02000180,2009,70,464000,385000,1,7,15,47,1,69,25,45
3537,E02000180,2010,74,533000,400000,0,4,13,57,3,71,17,57
3538,E02000180,2011,116,484000,418000,1,5,26,84,3,113,32,84
3539,E02000180,2012,87,504000,435000,0,4,17,66,2,85,21,66
3540,E02000180,2013,75,615000,445000,2,3,13,57,1,74,18,57
3541,E02000180,2014,21,704000,530000,0,2,4,15,0,21,6,15
3542,E02000181,2009,102,522000,440000,3,1,0,98,2,100,4,98
3543,E02000181,2010,157,697000,571000,3,6,10,138,2,155,18,139
3544,E02000181,2011,140,647000,495000,0,2,5,133,0,140,6,134
3545,E02000181,2012,130,673000,585000,1,1,3,125,0,130,5,125
3546,E02000181,2013,146,777000,618000,2,1,9,134,0,146,10,136
3547,E02000181,2014,49,871000,735000,1,3,3,42,1,48,5,44
3548,E02000182,2009,74,880000,525000,2,0,6,66,0,74,8,66
3549,E02000182,2010,115,1167000,675000,4,4,9,98,1,114,17,98
3550,E02000182,2011,79,1028000,625000,4,1,7,67,0,79,12,67
3551,E02000182,2012,69,1318000,575000,3,1,1,64,0,69,5,64
3552,E02000182,2013,87,1022000,625000,0,0,9,78,4,83,9,78
3553,E02000182,2014,31,1119000,500000,0,2,2,27,0,31,4,27
3554,E02000183,2009,93,780000,430000,1,2,13,77,1,92,15,78
3555,E02000183,2010,142,1065000,738000,1,7,23,111,25,117,29,113
3556,E02000183,2011,142,1149000,665000,1,5,30,106,20,122,34,108
3557,E02000183,2012,99,1300000,695000,1,3,17,78,1,98,20,79
3558,E02000183,2013,111,1356000,750000,1,2,21,87,0,111,25,86
3559,E02000183,2014,40,1357000,835000,0,1,4,35,1,39,5,35
3560,E02000184,2009,52,334000,296000,0,0,12,40,1,51,11,41
3561,E02000184,2010,72,367000,332000,0,0,14,58,2,70,10,62
3562,E02000184,2011,70,359000,330000,0,0,11,59,1,69,11,59
3563,E02000184,2012,72,390000,340000,0,0,8,64,28,44,4,68
3564,E02000184,2013,85,546000,465000,0,1,9,75,16,69,8,77
3565,E02000184,2014,50,626000,532000,0,1,2,47,16,34,3,47
3566,E02000185,2009,52,282000,270000,0,0,4,48,6,46,4,48
3567,E02000185,2010,83,446000,336000,0,2,6,75,1,82,6,77
3568,E02000185,2011,81,527000,375000,0,3,6,72,1,80,8,73
3569,E02000185,2012,69,473000,385000,0,2,7,60,2,67,6,63
3570,E02000185,2013,100,475000,404000,2,0,2,96,0,100,3,97
3571,E02000185,2014,43,543000,455000,1,0,1,41,0,43,2,41
3572,E02000186,2009,88,624000,442000,0,2,9,77,29,59,11,77
3573,E02000186,2010,81,864000,470000,2,1,11,67,8,73,12,69
3574,E02000186,2011,76,978000,505000,4,1,11,60,1,75,10,66
3575,E02000186,2012,49,1593000,645000,0,0,13,36,0,49,7,42
3576,E02000186,2013,149,1035000,646000,0,3,13,133,46,103,5,144
3577,E02000186,2014,30,1824000,696000,0,0,7,23,1,29,6,24
3578,E02000187,2009,71,568000,545000,0,0,2,69,41,30,2,69
3579,E02000187,2010,39,417000,345000,0,0,1,38,4,35,1,38
3580,E02000187,2011,57,408000,400000,0,0,1,56,28,29,1,56
3581,E02000187,2012,29,491000,364000,0,0,3,26,0,29,2,27
3582,E02000187,2013,112,728000,702000,0,0,3,109,76,36,3,109
3583,E02000187,2014,24,660000,410000,0,0,2,22,2,22,2,22
3584,E02000188,2009,34,306000,265000,0,1,0,33,0,34,0,34
3585,E02000188,2010,51,353000,338000,0,0,0,51,0,51,0,51
3586,E02000188,2011,35,339000,330000,0,0,3,32,0,35,1,34
3587,E02000188,2012,30,325000,330000,0,0,1,29,0,30,1,29
3588,E02000188,2013,31,471000,435000,0,0,0,31,4,27,0,31
3589,E02000188,2014,11,455000,391000,0,0,0,11,0,11,0,11
3590,E02000189,2009,25,357000,358000,0,0,3,22,4,21,3,22
3591,E02000189,2010,26,383000,348000,0,0,0,26,7,19,0,26
3592,E02000189,2011,26,406000,380000,0,0,3,23,1,25,3,23
3593,E02000189,2012,27,532000,420000,0,0,2,25,1,26,2,25
3594,E02000189,2013,34,508000,455000,0,0,2,32,2,32,3,31
3595,E02000189,2014,9,605000,472000,0,0,2,7,0,9,2,7
3596,E02000190,2009,62,378000,320000,0,0,2,60,1,61,2,60
3597,E02000190,2010,56,392000,355000,0,1,0,55,0,56,1,55
3598,E02000190,2011,54,383000,342000,0,0,0,54,1,53,0,54
3599,E02000190,2012,61,412000,370000,0,0,2,59,15,46,2,59
3600,E02000190,2013,142,372000,305000,0,0,3,139,75,67,3,139
3601,E02000190,2014,21,592000,537000,0,0,0,21,0,21,0,21
3602,E02000191,2009,57,578000,400000,0,0,5,52,0,57,5,52
3603,E02000191,2010,61,458000,375000,0,0,3,58,2,59,1,60
3604,E02000191,2011,80,747000,538000,1,1,5,73,6,74,4,76
3605,E02000191,2012,58,790000,642000,0,0,2,56,7,51,1,57
3606,E02000191,2013,101,753000,634000,0,0,2,99,28,73,1,100
3607,E02000191,2014,26,596000,522000,0,0,0,26,0,26,0,26
3608,E02000192,2009,69,475000,440000,0,0,4,65,15,54,6,63
3609,E02000192,2010,65,554000,480000,0,1,3,61,5,60,4,61
3610,E02000192,2011,76,621000,452000,0,0,7,69,14,62,8,68
3611,E02000192,2012,54,647000,462000,0,1,1,52,2,52,3,51
3612,E02000192,2013,81,861000,590000,0,0,6,75,14,67,6,75
3613,E02000192,2014,30,786000,700000,0,0,2,28,10,20,1,29
3614,E02000193,2009,105,417000,315000,0,0,2,103,0,105,1,104
3615,E02000193,2010,126,546000,385000,0,1,2,123,6,120,4,122
3616,E02000193,2011,163,553000,470000,0,0,2,161,45,118,2,161
3617,E02000193,2012,101,763000,499000,0,0,2,99,6,95,2,99
3618,E02000193,2013,131,771000,548000,0,0,6,125,17,114,6,125
3619,E02000193,2014,36,831000,555000,0,0,1,35,0,36,1,35
3620,E02000194,2009,80,215000,197000,2,6,13,59,2,78,21,59
3621,E02000194,2010,111,248000,216000,8,11,14,78,0,111,33,78
3622,E02000194,2011,112,249000,218000,1,13,27,71,3,109,41,71
3623,E02000194,2012,136,264000,235000,5,18,30,83,9,127,52,84
3624,E02000194,2013,183,313000,263000,10,11,46,116,29,154,66,117
3625,E02000194,2014,69,348000,275000,5,10,7,47,1,68,21,48
3626,E02000195,2009,56,305000,285000,10,21,15,10,0,56,46,10
3627,E02000195,2010,72,325000,328000,17,28,9,18,0,72,55,17
3628,E02000195,2011,72,298000,291000,10,23,21,18,0,72,54,18
3629,E02000195,2012,88,322000,306000,17,26,24,21,0,88,67,21
3630,E02000195,2013,156,329000,312000,25,38,36,57,10,146,98,58
3631,E02000195,2014,50,382000,385000,6,13,17,14,0,50,36,14
3632,E02000196,2009,39,248000,240000,1,13,11,14,2,37,26,13
3633,E02000196,2010,43,268000,273000,3,11,19,10,0,43,33,10
3634,E02000196,2011,35,248000,250000,1,10,13,11,0,35,24,11
3635,E02000196,2012,48,294000,298000,3,14,25,6,0,48,41,7
3636,E02000196,2013,67,322000,309000,1,24,28,14,1,66,53,14
3637,E02000196,2014,23,379000,370000,0,7,11,5,0,23,15,8
3638,E02000197,2009,40,237000,204000,5,5,23,7,1,39,35,5
3639,E02000197,2010,60,236000,238000,2,10,39,9,0,60,51,9
3640,E02000197,2011,75,233000,235000,0,11,49,15,0,75,61,14
3641,E02000197,2012,75,271000,250000,2,14,44,15,6,69,60,15
3642,E02000197,2013,83,322000,299000,11,14,42,16,0,83,67,16
3643,E02000197,2014,36,315000,300000,2,5,23,6,0,36,29,7
3644,E02000198,2009,53,185000,175000,1,7,23,22,0,53,35,18
3645,E02000198,2010,51,183000,170000,0,10,18,23,0,51,28,23
3646,E02000198,2011,59,182000,188000,1,13,22,23,5,54,37,22
3647,E02000198,2012,65,194000,190000,1,9,32,23,0,65,41,24
3648,E02000198,2013,88,224000,210000,1,7,34,46,11,77,42,46
3649,E02000198,2014,33,221000,206000,0,5,9,19,0,33,14,19
3650,E02000199,2009,66,203000,200000,1,9,46,10,0,66,55,11
3651,E02000199,2010,61,205000,210000,0,9,36,16,0,61,43,18
3652,E02000199,2011,80,203000,204000,0,11,53,16,1,79,62,18
3653,E02000199,2012,65,216000,215000,2,9,36,18,0,65,46,19
3654,E02000199,2013,94,239000,232000,2,7,61,24,0,94,69,25
3655,E02000199,2014,46,254000,250000,1,4,25,16,0,46,30,16
3656,E02000200,2009,74,179000,166000,1,10,23,40,0,74,34,40
3657,E02000200,2010,75,217000,188000,1,16,13,45,2,73,30,45
3658,E02000200,2011,97,215000,180000,1,16,23,57,3,94,38,59
3659,E02000200,2012,147,203000,185000,3,11,28,105,57,90,40,107
3660,E02000200,2013,128,228000,190000,3,18,23,84,4,124,43,85
3661,E02000200,2014,58,228000,206000,0,1,12,45,2,56,13,45
3662,E02000201,2009,67,160000,160000,4,2,23,38,4,63,28,39
3663,E02000201,2010,59,177000,165000,1,5,16,37,5,54,25,34
3664,E02000201,2011,65,184000,170000,2,3,25,35,4,61,31,34
3665,E02000201,2012,74,173000,158000,0,5,27,42,2,72,30,44
3666,E02000201,2013,88,201000,206000,3,11,35,39,0,88,44,44
3667,E02000201,2014,49,249000,218000,1,4,20,24,0,49,27,22
3668,E02000202,2009,53,196000,200000,0,6,37,10,0,53,43,10
3669,E02000202,2010,77,208000,216000,0,5,60,12,0,77,63,14
3670,E02000202,2011,61,213000,210000,0,5,48,8,0,61,51,10
3671,E02000202,2012,63,214000,220000,0,5,46,12,0,63,51,12
3672,E02000202,2013,75,233000,235000,1,1,62,11,0,75,63,12
3673,E02000202,2014,43,232000,250000,0,2,33,8,0,43,34,9
3674,E02000203,2009,38,190000,197000,0,4,29,5,0,38,33,5
3675,E02000203,2010,52,174000,170000,1,5,24,22,1,51,30,22
3676,E02000203,2011,32,179000,166000,0,2,23,7,1,31,25,7
3677,E02000203,2012,51,186000,185000,0,7,27,17,0,51,34,17
3678,E02000203,2013,55,200000,188000,0,5,32,18,0,55,37,18
3679,E02000203,2014,14,259000,250000,1,1,8,4,1,13,10,4
3680,E02000204,2009,51,197000,215000,0,9,33,9,1,50,41,10
3681,E02000204,2010,62,183000,172000,0,4,27,31,18,44,31,31
3682,E02000204,2011,66,212000,222000,1,5,41,19,11,55,48,18
3683,E02000204,2012,37,213000,230000,1,2,24,10,0,37,27,10
3684,E02000204,2013,67,231000,240000,3,10,42,12,0,67,55,12
3685,E02000204,2014,22,244000,250000,0,1,14,7,0,22,15,7
3686,E02000206,2009,82,157000,158000,1,11,34,36,1,81,47,35
3687,E02000206,2010,55,166000,170000,0,6,20,29,0,55,27,28
3688,E02000206,2011,61,164000,164000,0,6,27,28,0,61,32,29
3689,E02000206,2012,58,180000,182000,0,7,32,19,2,56,38,20
3690,E02000206,2013,164,194000,190000,4,16,39,105,55,109,58,106
3691,E02000206,2014,86,213000,213000,1,7,25,53,27,59,32,54
3692,E02000207,2009,62,188000,180000,3,12,29,18,5,57,43,19
3693,E02000207,2010,48,198000,202000,3,8,23,14,1,47,31,17
3694,E02000207,2011,60,206000,204000,4,12,30,14,0,60,46,14
3695,E02000207,2012,58,192000,188000,2,10,27,19,0,58,39,19
3696,E02000207,2013,89,216000,220000,1,14,57,17,0,89,72,17
3697,E02000207,2014,33,238000,226000,0,5,15,13,4,29,20,13
3698,E02000208,2009,200,144000,135000,0,5,21,174,165,35,25,175
3699,E02000208,2010,70,184000,188000,2,8,28,32,15,55,39,31
3700,E02000208,2011,86,158000,162000,0,5,19,62,27,59,26,60
3701,E02000208,2012,51,171000,170000,0,1,29,21,2,49,30,21
3702,E02000208,2013,73,186000,180000,0,11,25,37,3,70,35,38
3703,E02000208,2014,39,184000,172000,0,1,11,27,0,39,12,27
3704,E02000209,2009,53,179000,175000,0,3,44,6,0,53,46,7
3705,E02000209,2010,60,192000,199000,1,7,44,8,0,60,52,8
3706,E02000209,2011,54,186000,192000,1,1,47,5,0,54,48,6
3707,E02000209,2012,47,184000,182000,1,1,40,5,0,47,42,5
3708,E02000209,2013,54,201000,207000,0,3,45,6,0,54,48,6
3709,E02000209,2014,22,213000,232000,0,3,14,5,0,22,17,5
3710,E02000210,2009,94,200000,205000,0,11,66,17,1,93,77,17
3711,E02000210,2010,89,207000,217000,0,11,62,16,0,89,73,16
3712,E02000210,2011,99,208000,213000,1,12,74,12,0,99,86,13
3713,E02000210,2012,89,215000,221000,0,12,61,16,1,88,73,16
3714,E02000210,2013,101,221000,230000,0,14,67,20,0,101,82,19
3715,E02000210,2014,60,248000,250000,0,6,40,14,0,60,46,14
3716,E02000211,2009,103,241000,238000,17,41,17,28,1,102,70,33
3717,E02000211,2010,99,278000,270000,24,34,22,19,1,98,78,21
3718,E02000211,2011,99,257000,250000,18,29,27,25,0,99,68,31
3719,E02000211,2012,102,298000,284000,25,34,27,16,1,101,82,20
3720,E02000211,2013,151,291000,280000,34,52,35,30,0,151,112,39
3721,E02000211,2014,52,336000,307000,12,18,6,16,0,52,35,17
3722,E02000212,2009,69,170000,167000,0,9,28,32,17,52,36,33
3723,E02000212,2010,85,155000,152000,0,6,23,56,38,47,29,56
3724,E02000212,2011,47,185000,187000,0,11,26,10,1,46,37,10
3725,E02000212,2012,48,181000,185000,0,15,25,8,0,48,39,9
3726,E02000212,2013,60,194000,204000,1,13,37,9,0,60,51,9
3727,E02000212,2014,21,208000,220000,0,5,11,5,0,21,16,5
3728,E02000213,2009,57,188000,166000,5,5,13,34,1,56,21,36
3729,E02000213,2010,62,186000,152000,1,7,11,43,3,59,19,43
3730,E02000213,2011,83,187000,180000,6,5,16,56,19,64,26,57
3731,E02000213,2012,90,179000,170000,1,1,14,74,30,60,15,75
3732,E02000213,2013,161,200000,188000,3,3,16,139,87,74,22,139
3733,E02000213,2014,37,234000,218000,2,3,5,27,1,36,10,27
3734,E02000214,2009,64,248000,250000,3,11,34,16,0,64,47,17
3735,E02000214,2010,56,281000,276000,2,18,19,17,1,55,38,18
3736,E02000214,2011,57,284000,270000,2,16,29,10,0,57,47,10
3737,E02000214,2012,60,295000,275000,5,13,37,5,0,60,56,4
3738,E02000214,2013,76,316000,306000,4,18,46,8,0,76,68,8
3739,E02000214,2014,31,340000,330000,2,6,15,8,0,31,23,8
3740,E02000215,2009,132,194000,190000,2,16,41,73,17,115,58,74
3741,E02000215,2010,119,215000,200000,4,19,32,64,7,112,55,64
3742,E02000215,2011,115,217000,205000,4,14,39,58,2,113,57,58
3743,E02000215,2012,116,213000,198000,2,19,36,59,1,115,58,58
3744,E02000215,2013,159,222000,214000,4,15,56,84,4,155,74,85
3745,E02000215,2014,74,227000,209000,1,8,15,50,3,71,23,51
3746,E02000216,2009,67,306000,210000,17,3,12,35,0,67,29,38
3747,E02000216,2010,91,288000,225000,13,6,16,56,0,91,36,55
3748,E02000216,2011,82,270000,232000,10,5,23,44,0,82,37,45
3749,E02000216,2012,93,295000,236000,13,3,23,54,3,90,37,56
3750,E02000216,2013,106,287000,236000,13,2,32,59,4,102,46,60
3751,E02000216,2014,22,324000,310000,4,1,8,9,0,22,12,10
3752,E02000217,2009,87,192000,195000,0,9,42,36,19,68,53,34
3753,E02000217,2010,232,203000,203000,2,20,43,167,144,88,65,167
3754,E02000217,2011,138,188000,181000,1,14,49,74,57,81,62,76
3755,E02000217,2012,106,195000,195000,1,23,50,32,6,100,74,32
3756,E02000217,2013,248,204000,210000,0,17,42,189,118,130,59,189
3757,E02000217,2014,129,227000,230000,2,6,27,94,59,70,35,94
3758,E02000218,2009,34,272000,275000,2,21,7,4,0,34,30,4
3759,E02000218,2010,37,273000,300000,5,18,6,8,0,37,29,8
3760,E02000218,2011,44,290000,314000,6,23,8,7,1,43,37,7
3761,E02000218,2012,36,300000,298000,7,18,4,7,0,36,29,7
3762,E02000218,2013,55,322000,332000,3,38,8,6,0,55,49,6
3763,E02000218,2014,28,334000,348000,2,15,1,10,6,22,18,10
3764,E02000219,2009,76,301000,300000,15,39,8,14,0,76,62,14
3765,E02000219,2010,92,369000,310000,18,39,16,19,4,88,73,19
3766,E02000219,2011,82,361000,309000,23,36,6,17,3,79,64,18
3767,E02000219,2012,99,326000,325000,16,50,14,19,8,91,78,21
3768,E02000219,2013,105,346000,335000,22,40,23,20,0,105,84,21
3769,E02000219,2014,42,396000,375000,7,20,6,9,0,42,33,9
3770,E02000220,2009,211,194000,175000,7,7,20,177,102,109,33,178
3771,E02000220,2010,155,190000,185000,2,4,17,132,47,108,22,133
3772,E02000220,2011,143,203000,190000,3,15,21,104,17,126,38,105
3773,E02000220,2012,148,183000,182000,1,7,18,122,30,118,25,123
3774,E02000220,2013,231,205000,190000,4,10,18,199,73,158,29,202
3775,E02000220,2014,99,225000,200000,0,3,9,87,15,84,12,87
3776,E02000221,2009,64,209000,195000,4,17,19,24,3,61,39,25
3777,E02000221,2010,80,221000,194000,5,15,18,42,7,73,38,42
3778,E02000221,2011,80,220000,215000,6,17,21,36,3,77,44,36
3779,E02000221,2012,82,237000,214000,12,18,19,33,6,76,48,34
3780,E02000221,2013,115,255000,238000,9,24,36,46,11,104,69,46
3781,E02000221,2014,51,235000,230000,0,10,11,30,3,48,21,30
3782,E02000222,2009,104,224000,200000,11,13,38,42,4,100,63,41
3783,E02000222,2010,121,263000,214000,19,17,43,42,1,120,81,40
3784,E02000222,2011,131,272000,220000,23,27,43,38,14,117,93,38
3785,E02000222,2012,123,260000,208000,18,20,36,49,4,119,74,49
3786,E02000222,2013,188,273000,234000,30,19,61,78,17,171,109,79
3787,E02000222,2014,64,290000,250000,9,7,20,28,0,64,36,28
3788,E02000223,2009,25,153000,160000,0,5,15,5,0,25,21,4
3789,E02000223,2010,28,149000,152000,0,4,19,5,0,28,22,6
3790,E02000223,2011,23,158000,162000,0,3,17,3,0,23,19,4
3791,E02000223,2012,20,169000,164000,0,5,14,1,0,20,18,2
3792,E02000223,2013,20,169000,174000,0,2,14,4,0,20,16,4
3793,E02000223,2014,9,206000,215000,0,3,5,1,0,9,8,1
3794,E02000224,2009,103,223000,200000,6,30,30,37,2,101,67,36
3795,E02000224,2010,115,230000,203000,1,34,30,50,1,114,64,51
3796,E02000224,2011,98,231000,210000,3,26,31,38,0,98,59,39
3797,E02000224,2012,109,249000,221000,6,30,37,36,1,108,73,36
3798,E02000224,2013,126,251000,222000,10,26,29,61,12,114,64,62
3799,E02000224,2014,69,237000,225000,1,16,9,43,5,64,25,44
3800,E02000225,2009,37,182000,182000,0,20,14,3,0,37,34,3
3801,E02000225,2010,36,195000,197000,0,25,9,2,0,36,32,4
3802,E02000225,2011,36,181000,180000,0,22,8,6,0,36,25,11
3803,E02000225,2012,51,190000,185000,0,33,13,5,0,51,42,9
3804,E02000225,2013,63,203000,205000,0,45,13,5,0,63,47,16
3805,E02000225,2014,24,215000,215000,0,18,5,1,0,24,20,4
3806,E02000226,2009,63,310000,295000,12,39,11,1,0,63,61,2
3807,E02000226,2010,59,343000,335000,15,32,11,1,0,59,57,2
3808,E02000226,2011,72,345000,348000,22,35,13,2,0,72,67,5
3809,E02000226,2012,89,330000,326000,22,45,19,3,0,89,79,10
3810,E02000226,2013,88,362000,352000,24,50,13,1,0,88,84,4
3811,E02000226,2014,36,354000,339000,1,22,12,1,0,36,29,7
3812,E02000227,2009,133,197000,196000,5,33,50,45,0,133,89,44
3813,E02000227,2010,160,222000,216000,9,50,66,35,0,160,124,36
3814,E02000227,2011,137,199000,190000,3,30,46,58,0,137,78,59
3815,E02000227,2012,117,219000,210000,5,32,46,34,1,116,83,34
3816,E02000227,2013,187,217000,215000,5,43,66,73,0,187,115,72
3817,E02000227,2014,75,228000,232000,3,18,24,30,0,75,45,30
3818,E02000228,2009,75,357000,359000,36,16,1,22,1,74,53,22
3819,E02000228,2010,100,400000,397000,53,28,1,18,2,98,82,18
3820,E02000228,2011,80,413000,380000,41,20,3,16,1,79,66,14
3821,E02000228,2012,108,412000,400000,58,32,0,18,9,99,89,19
3822,E02000228,2013,135,426000,415000,71,36,1,27,2,133,109,26
3823,E02000228,2014,42,440000,432000,21,10,0,11,1,41,31,11
3824,E02000229,2009,29,173000,175000,0,14,10,5,0,29,25,4
3825,E02000229,2010,32,192000,203000,0,12,14,6,0,32,26,6
3826,E02000229,2011,27,190000,185000,1,15,9,2,0,27,25,2
3827,E02000229,2012,26,179000,181000,0,12,9,5,0,26,21,5
3828,E02000229,2013,52,194000,196000,0,25,15,12,0,52,40,12
3829,E02000229,2014,14,227000,226000,0,9,4,1,0,14,13,1
3830,E02000230,2009,128,292000,246000,40,19,14,55,12,116,74,54
3831,E02000230,2010,120,290000,250000,28,26,17,49,5,115,70,50
3832,E02000230,2011,149,300000,250000,44,20,17,68,10,139,81,68
3833,E02000230,2012,130,327000,308000,46,21,13,50,3,127,79,51
3834,E02000230,2013,173,330000,306000,53,24,16,80,18,155,93,80
3835,E02000230,2014,66,348000,298000,15,11,7,33,7,59,32,34
3836,E02000231,2009,72,588000,465000,48,13,2,9,3,69,62,10
3837,E02000231,2010,87,543000,485000,57,12,3,15,12,75,70,17
3838,E02000231,2011,86,707000,510000,56,22,5,3,0,86,82,4
3839,E02000231,2012,68,590000,532000,53,9,2,4,1,67,63,5
3840,E02000231,2013,114,516000,483000,63,23,1,27,15,99,87,27
3841,E02000231,2014,40,571000,496000,21,7,2,10,7,33,30,10
3842,E02000232,2009,74,277000,250000,14,39,17,4,0,74,71,3
3843,E02000232,2010,85,312000,296000,19,51,8,7,10,75,78,7
3844,E02000232,2011,70,321000,295000,24,32,13,1,0,70,69,1
3845,E02000232,2012,66,315000,312000,18,33,10,5,3,63,61,5
3846,E02000232,2013,74,363000,318000,27,29,13,5,5,69,69,5
3847,E02000232,2014,25,372000,350000,13,9,2,1,0,25,24,1
3848,E02000233,2009,103,251000,230000,20,30,29,24,10,93,78,25
3849,E02000233,2010,83,285000,261000,14,32,24,13,6,77,69,14
3850,E02000233,2011,78,284000,250000,18,26,24,10,0,78,68,10
3851,E02000233,2012,93,286000,250000,16,32,24,21,0,93,72,21
3852,E02000233,2013,107,298000,270000,20,39,23,25,0,107,82,25
3853,E02000233,2014,25,310000,310000,2,10,5,8,0,25,17,8
3854,E02000234,2009,79,301000,266000,26,25,20,8,0,79,70,9
3855,E02000234,2010,97,335000,250000,30,27,27,13,1,96,81,16
3856,E02000234,2011,92,288000,250000,22,22,36,12,0,92,80,12
3857,E02000234,2012,99,314000,300000,30,26,30,13,1,98,85,14
3858,E02000234,2013,116,327000,297000,41,24,20,31,9,107,84,32
3859,E02000234,2014,43,362000,340000,14,13,8,8,1,42,35,8
3860,E02000235,2009,75,322000,275000,28,27,10,10,1,74,64,11
3861,E02000235,2010,84,375000,307000,38,28,5,13,0,84,71,13
3862,E02000235,2011,81,363000,313000,36,32,5,8,0,81,71,10
3863,E02000235,2012,83,336000,300000,37,28,7,11,1,82,73,10
3864,E02000235,2013,97,352000,317000,41,21,13,22,0,97,72,25
3865,E02000235,2014,44,353000,334000,19,11,5,9,0,44,34,10
3866,E02000236,2009,69,269000,250000,10,38,16,5,4,65,64,5
3867,E02000236,2010,88,334000,300000,22,34,28,4,0,88,84,4
3868,E02000236,2011,78,329000,270000,20,29,28,1,2,76,77,1
3869,E02000236,2012,103,335000,315000,25,44,29,5,2,101,99,4
3870,E02000236,2013,95,356000,340000,24,43,24,4,1,94,91,4
3871,E02000236,2014,40,361000,337000,6,19,12,3,1,39,37,3
3872,E02000237,2009,64,284000,260000,24,27,10,3,0,64,61,3
3873,E02000237,2010,100,302000,291000,31,50,10,9,0,100,92,8
3874,E02000237,2011,105,288000,272000,28,45,20,12,1,104,92,13
3875,E02000237,2012,82,315000,308000,28,38,9,7,0,82,76,6
3876,E02000237,2013,89,317000,325000,26,41,14,8,2,87,80,9
3877,E02000237,2014,42,336000,321000,10,17,9,6,0,42,36,6
3878,E02000238,2009,61,226000,240000,0,22,26,13,0,61,49,12
3879,E02000238,2010,86,248000,252000,1,29,39,17,0,86,69,17
3880,E02000238,2011,75,235000,250000,1,19,38,17,0,75,57,18
3881,E02000238,2012,65,243000,250000,0,23,25,17,0,65,47,18
3882,E02000238,2013,66,261000,276000,1,17,32,16,0,66,50,16
3883,E02000238,2014,23,251000,240000,1,3,6,13,1,22,10,13
3884,E02000239,2009,53,229000,240000,0,6,28,19,15,38,36,17
3885,E02000239,2010,65,243000,265000,1,15,27,22,18,47,43,22
3886,E02000239,2011,54,282000,278000,0,12,38,4,0,54,49,5
3887,E02000239,2012,54,296000,300000,0,14,35,5,0,54,49,5
3888,E02000239,2013,78,325000,322000,2,19,53,4,0,78,73,5
3889,E02000239,2014,22,335000,344000,0,4,16,2,0,22,20,2
3890,E02000240,2009,71,207000,214000,0,25,20,26,1,70,47,24
3891,E02000240,2010,84,224000,239000,0,36,25,23,2,82,58,26
3892,E02000240,2011,87,207000,205000,1,23,24,39,8,79,45,42
3893,E02000240,2012,82,237000,249000,2,37,19,24,0,82,58,24
3894,E02000240,2013,85,239000,242000,1,30,22,32,0,85,50,35
3895,E02000240,2014,27,237000,225000,0,6,5,16,0,27,11,16
3896,E02000241,2009,51,214000,225000,0,18,19,14,1,50,37,14
3897,E02000241,2010,75,234000,240000,0,20,37,18,9,66,57,18
3898,E02000241,2011,49,246000,250000,0,12,26,11,0,49,37,12
3899,E02000241,2012,60,239000,254000,0,18,25,17,0,60,43,17
3900,E02000241,2013,62,252000,275000,0,17,31,14,0,62,46,16
3901,E02000241,2014,31,301000,315000,1,12,13,5,0,31,26,5
3902,E02000242,2009,38,256000,250000,1,17,17,3,0,38,35,3
3903,E02000242,2010,46,267000,260000,1,19,18,8,0,46,37,9
3904,E02000242,2011,46,272000,270000,2,15,23,6,1,45,41,5
3905,E02000242,2012,31,284000,289000,0,12,17,2,0,31,29,2
3906,E02000242,2013,49,300000,310000,0,13,31,5,0,49,44,5
3907,E02000242,2014,15,354000,340000,0,1,11,3,0,15,12,3
3908,E02000243,2009,37,222000,235000,1,15,6,15,0,37,23,14
3909,E02000243,2010,62,242000,250000,1,24,14,23,0,62,39,23
3910,E02000243,2011,54,254000,250000,1,26,8,19,0,54,34,20
3911,E02000243,2012,56,241000,228000,1,17,12,26,0,56,27,29
3912,E02000243,2013,75,264000,270000,0,31,18,26,0,75,47,28
3913,E02000243,2014,20,251000,244000,0,6,0,14,1,19,6,14
3914,E02000244,2009,55,234000,243000,0,16,25,14,0,55,41,14
3915,E02000244,2010,57,254000,250000,0,9,28,20,0,57,39,18
3916,E02000244,2011,69,260000,250000,1,14,34,20,0,69,49,20
3917,E02000244,2012,76,253000,274000,0,7,37,32,0,76,44,32
3918,E02000244,2013,70,290000,300000,0,13,39,18,0,70,51,19
3919,E02000244,2014,21,316000,317000,0,2,9,10,0,21,11,10
3920,E02000245,2009,46,184000,175000,2,6,11,27,9,37,19,27
3921,E02000245,2010,66,184000,170000,0,9,16,41,0,66,26,40
3922,E02000245,2011,45,182000,175000,1,8,8,28,0,45,19,26
3923,E02000245,2012,81,185000,188000,0,3,15,63,26,55,18,63
3924,E02000245,2013,72,206000,201000,1,10,14,47,8,64,25,47
3925,E02000245,2014,19,186000,185000,0,2,2,15,0,19,4,15
3926,E02000246,2009,44,209000,220000,1,20,9,14,0,44,30,14
3927,E02000246,2010,66,220000,232000,0,27,18,21,0,66,43,23
3928,E02000246,2011,54,214000,240000,0,24,10,20,0,54,34,20
3929,E02000246,2012,57,209000,230000,0,22,13,22,1,56,35,22
3930,E02000246,2013,62,224000,235000,0,22,10,30,0,62,32,30
3931,E02000246,2014,21,279000,280000,0,10,5,6,0,21,15,6
3932,E02000247,2009,88,183000,170000,2,11,12,63,41,47,24,64
3933,E02000247,2010,85,196000,185000,2,13,13,57,0,85,29,56
3934,E02000247,2011,79,199000,190000,2,11,21,45,0,79,31,48
3935,E02000247,2012,68,210000,198000,6,9,18,35,0,68,32,36
3936,E02000247,2013,89,223000,205000,3,10,27,49,4,85,39,50
3937,E02000247,2014,38,234000,228000,2,4,9,23,0,38,14,24
3938,E02000248,2009,50,276000,248000,2,8,11,29,2,48,16,34
3939,E02000248,2010,59,351000,285000,4,15,7,33,0,59,26,33
3940,E02000248,2011,61,335000,256000,5,12,10,34,0,61,25,36
3941,E02000248,2012,77,378000,310000,5,15,12,45,0,77,31,46
3942,E02000248,2013,95,410000,320000,4,20,11,60,0,95,33,62
3943,E02000248,2014,46,415000,320000,2,9,8,27,0,46,17,29
3944,E02000249,2009,44,246000,244000,1,23,8,12,1,43,31,13
3945,E02000249,2010,67,258000,250000,5,25,14,23,0,67,43,24
3946,E02000249,2011,51,249000,245000,6,17,9,19,0,51,30,21
3947,E02000249,2012,54,271000,264000,3,30,7,14,1,53,40,14
3948,E02000249,2013,79,288000,283000,6,27,12,34,11,68,44,35
3949,E02000249,2014,25,277000,268000,2,8,3,12,1,24,13,12
3950,E02000250,2009,64,413000,406000,0,16,30,18,0,64,45,19
3951,E02000250,2010,74,473000,500000,1,21,28,24,0,74,50,24
3952,E02000250,2011,93,476000,470000,3,19,38,33,0,93,60,33
3953,E02000250,2012,87,527000,550000,1,16,48,22,0,87,64,23
3954,E02000250,2013,98,572000,574000,4,19,42,33,0,98,64,34
3955,E02000250,2014,30,575000,502000,0,6,11,13,0,30,17,13
3956,E02000251,2009,41,233000,235000,0,3,32,6,0,41,34,7
3957,E02000251,2010,39,239000,250000,0,5,29,5,0,39,33,6
3958,E02000251,2011,45,255000,250000,0,6,34,5,0,45,40,5
3959,E02000251,2012,42,257000,260000,0,1,35,6,0,42,35,7
3960,E02000251,2013,60,264000,258000,0,2,50,8,0,60,52,8
3961,E02000251,2014,21,294000,288000,1,3,12,5,0,21,16,5
3962,E02000252,2009,51,254000,247000,1,10,18,22,3,48,29,22
3963,E02000252,2010,59,249000,230000,0,8,12,39,1,58,19,40
3964,E02000252,2011,93,271000,245000,2,10,23,58,10,83,32,61
3965,E02000252,2012,64,305000,250000,0,8,18,38,3,61,26,38
3966,E02000252,2013,125,288000,246000,2,11,25,87,8,117,37,88
3967,E02000252,2014,33,302000,255000,1,1,8,23,0,33,9,24
3968,E02000253,2009,62,244000,239000,0,12,33,17,0,62,44,18
3969,E02000253,2010,70,270000,267000,0,17,36,17,0,70,52,18
3970,E02000253,2011,72,264000,258000,2,13,36,21,0,72,50,22
3971,E02000253,2012,52,290000,275000,1,7,27,17,0,52,35,17
3972,E02000253,2013,91,315000,301000,2,23,50,16,1,90,73,18
3973,E02000253,2014,21,401000,385000,1,3,9,8,0,21,13,8
3974,E02000254,2009,26,224000,222000,1,7,14,4,0,26,23,3
3975,E02000254,2010,29,217000,220000,0,10,13,6,0,29,24,5
3976,E02000254,2011,35,245000,240000,0,10,21,4,0,35,31,4
3977,E02000254,2012,26,246000,247000,0,4,20,2,0,26,24,2
3978,E02000254,2013,30,249000,254000,0,7,21,2,0,30,28,2
3979,E02000254,2014,14,249000,250000,0,1,12,1,0,14,12,2
3980,E02000255,2009,98,378000,360000,3,18,36,41,2,96,56,42
3981,E02000255,2010,93,368000,315000,1,15,30,47,1,92,47,46
3982,E02000255,2011,77,435000,390000,3,19,22,33,0,77,43,34
3983,E02000255,2012,111,438000,355000,4,27,25,55,7,104,53,58
3984,E02000255,2013,94,484000,458000,4,21,31,38,0,94,55,39
3985,E02000255,2014,44,587000,578000,2,11,15,16,0,44,28,16
3986,E02000256,2009,67,523000,394000,8,17,7,35,4,63,30,37
3987,E02000256,2010,126,448000,318000,8,20,7,91,4,122,32,94
3988,E02000256,2011,108,527000,340000,13,21,7,67,2,106,39,69
3989,E02000256,2012,103,567000,317000,14,18,2,69,0,103,33,70
3990,E02000256,2013,143,583000,375000,13,25,7,98,4,139,45,98
3991,E02000256,2014,43,497000,396000,1,5,2,35,0,43,9,34
3992,E02000257,2009,110,439000,300000,12,15,10,73,0,110,35,75
3993,E02000257,2010,142,468000,324000,17,11,14,100,0,142,39,103
3994,E02000257,2011,134,458000,350000,10,12,19,93,1,133,40,94
3995,E02000257,2012,207,446000,340000,17,2,19,169,64,143,38,169
3996,E02000257,2013,284,557000,454000,21,13,30,220,75,209,61,223
3997,E02000257,2014,61,712000,500000,7,6,8,40,2,59,20,41
3998,E02000258,2009,36,432000,398000,4,16,11,5,0,36,31,5
3999,E02000258,2010,74,380000,332000,2,28,11,33,1,73,39,35
4000,E02000258,2011,47,396000,350000,1,20,3,23,4,43,23,24
4001,E02000258,2012,55,429000,420000,0,23,9,23,0,55,32,23
4002,E02000258,2013,82,519000,462000,3,28,13,38,6,76,42,40
4003,E02000258,2014,21,617000,555000,1,8,6,6,1,20,15,6
4004,E02000259,2009,42,318000,300000,1,7,22,12,0,42,29,13
4005,E02000259,2010,75,344000,313000,3,18,26,28,0,75,44,31
4006,E02000259,2011,62,358000,330000,5,17,17,23,12,50,38,24
4007,E02000259,2012,73,374000,333000,1,17,24,31,14,59,40,33
4008,E02000259,2013,68,423000,390000,5,24,24,15,0,68,52,16
4009,E02000259,2014,20,422000,390000,0,5,7,8,0,20,12,8
4010,E02000260,2009,24,206000,202000,0,7,7,10,0,24,14,10
4011,E02000260,2010,25,239000,248000,0,8,11,6,0,25,19,6
4012,E02000260,2011,26,265000,247000,2,11,7,6,0,26,18,8
4013,E02000260,2012,21,251000,240000,0,8,8,5,0,21,16,5
4014,E02000260,2013,23,214000,188000,1,4,7,11,0,23,12,11
4015,E02000260,2014,5,199000,215000,0,1,3,1,0,5,4,1
4016,E02000261,2009,88,313000,285000,2,17,14,55,9,79,33,55
4017,E02000261,2010,164,339000,282000,6,22,24,112,17,147,44,120
4018,E02000261,2011,113,354000,315000,2,21,18,72,2,111,36,77
4019,E02000261,2012,226,356000,326000,5,19,26,176,127,99,34,192
4020,E02000261,2013,185,449000,375000,6,22,29,128,35,150,39,146
4021,E02000261,2014,46,523000,432000,3,4,10,29,1,45,15,31
4022,E02000262,2009,63,305000,250000,2,4,16,41,0,63,20,43
4023,E02000262,2010,111,373000,310000,6,18,29,58,0,111,54,57
4024,E02000262,2011,119,404000,325000,3,13,34,69,20,99,46,73
4025,E02000262,2012,108,437000,342000,1,19,29,59,3,105,47,61
4026,E02000262,2013,142,470000,346000,1,22,36,83,1,141,59,83
4027,E02000262,2014,40,602000,492000,1,9,8,22,0,40,17,23
4028,E02000263,2009,37,216000,220000,0,2,29,6,0,37,30,7
4029,E02000263,2010,54,220000,235000,0,1,44,9,0,54,43,11
4030,E02000263,2011,36,220000,231000,0,3,28,5,0,36,31,5
4031,E02000263,2012,34,218000,230000,0,0,27,7,0,34,27,7
4032,E02000263,2013,28,245000,250000,0,2,23,3,0,28,24,4
4033,E02000263,2014,10,224000,250000,0,2,6,2,0,10,7,3
4034,E02000264,2009,71,429000,310000,3,17,4,47,12,59,25,46
4035,E02000264,2010,95,460000,310000,6,29,6,54,23,72,38,57
4036,E02000264,2011,132,432000,358000,6,29,6,91,31,101,35,97
4037,E02000264,2012,134,448000,325000,8,26,4,96,58,76,36,98
4038,E02000264,2013,112,613000,471000,15,32,5,60,0,112,47,65
4039,E02000264,2014,40,606000,455000,2,12,3,23,0,40,17,23
4040,E02000265,2009,89,281000,250000,0,17,31,41,1,88,42,47
4041,E02000265,2010,124,320000,294000,2,20,44,58,5,119,61,63
4042,E02000265,2011,117,345000,316000,1,15,48,53,0,117,59,58
4043,E02000265,2012,130,366000,330000,1,15,55,59,3,127,64,66
4044,E02000265,2013,187,402000,335000,2,23,56,106,16,171,78,109
4045,E02000265,2014,43,379000,353000,1,3,9,30,3,40,12,31
4046,E02000266,2009,29,221000,210000,0,14,5,10,0,29,18,11
4047,E02000266,2010,47,200000,205000,1,13,9,24,0,47,22,25
4048,E02000266,2011,36,221000,170000,1,10,11,14,0,36,22,14
4049,E02000266,2012,32,229000,238000,0,9,10,13,0,32,18,14
4050,E02000266,2013,51,253000,240000,1,8,15,27,1,50,23,28
4051,E02000266,2014,18,255000,250000,0,3,8,7,1,17,11,7
4052,E02000267,2009,77,267000,275000,1,13,43,20,0,77,56,21
4053,E02000267,2010,90,297000,292000,0,10,45,35,3,87,54,36
4054,E02000267,2011,108,325000,340000,1,14,63,30,7,101,69,39
4055,E02000267,2012,99,338000,335000,1,11,64,23,7,92,74,25
4056,E02000267,2013,151,363000,342000,7,12,70,62,41,110,87,64
4057,E02000267,2014,36,399000,440000,2,3,18,13,1,35,23,13
4058,E02000268,2009,91,492000,415000,9,30,26,26,0,91,64,27
4059,E02000268,2010,90,472000,374000,5,21,30,34,1,89,54,36
4060,E02000268,2011,114,463000,390000,6,29,34,45,0,114,65,49
4061,E02000268,2012,107,539000,468000,4,22,48,33,0,107,74,33
4062,E02000268,2013,124,607000,494000,7,22,44,51,7,117,73,51
4063,E02000268,2014,45,648000,610000,1,6,17,21,0,45,23,22
4064,E02000269,2009,112,410000,384000,1,19,64,28,0,112,81,31
4065,E02000269,2010,144,468000,434000,3,24,78,39,4,140,104,40
4066,E02000269,2011,120,472000,428000,4,19,54,43,5,115,76,44
4067,E02000269,2012,120,495000,476000,4,19,56,41,3,117,78,42
4068,E02000269,2013,102,501000,438000,4,11,41,46,3,99,55,47
4069,E02000269,2014,41,659000,650000,1,7,19,14,1,40,27,14
4070,E02000270,2009,49,302000,250000,0,4,10,35,2,47,14,35
4071,E02000270,2010,79,276000,230000,0,9,13,57,7,72,20,59
4072,E02000270,2011,71,323000,260000,1,8,11,51,1,70,18,53
4073,E02000270,2012,71,424000,325000,3,8,18,42,10,61,29,42
4074,E02000270,2013,139,375000,350000,0,2,24,113,66,73,21,118
4075,E02000270,2014,31,409000,327000,0,1,6,24,6,25,7,24
4076,E02000271,2009,103,631000,535000,5,12,53,33,2,101,69,34
4077,E02000271,2010,131,648000,600000,6,13,65,47,4,127,78,53
4078,E02000271,2011,122,840000,718000,5,22,58,37,0,122,84,38
4079,E02000271,2012,138,790000,750000,6,15,77,40,5,133,94,44
4080,E02000271,2013,132,971000,829000,2,17,68,45,11,121,83,49
4081,E02000271,2014,37,1108000,1000000,1,5,20,11,2,35,26,11
4082,E02000272,2009,69,376000,395000,0,14,48,7,0,69,57,12
4083,E02000272,2010,81,405000,438000,0,21,40,20,0,81,58,23
4084,E02000272,2011,92,433000,457000,2,14,63,13,0,92,78,14
4085,E02000272,2012,76,463000,467000,2,18,42,14,0,76,63,13
4086,E02000272,2013,88,522000,565000,4,18,49,17,0,88,71,17
4087,E02000272,2014,32,624000,648000,0,5,23,4,0,32,27,5
4088,E02000274,2009,42,198000,200000,1,6,22,13,2,40,29,13
4089,E02000274,2010,64,221000,218000,0,5,50,9,2,62,56,8
4090,E02000274,2011,45,215000,218000,0,5,33,7,0,45,39,6
4091,E02000274,2012,36,215000,220000,0,10,17,9,5,31,26,10
4092,E02000274,2013,156,202000,200000,1,6,54,95,78,78,59,97
4093,E02000274,2014,21,230000,240000,1,3,13,4,2,19,15,6
4094,E02000275,2009,22,270000,241000,2,6,8,6,0,22,15,7
4095,E02000275,2010,28,294000,210000,3,6,9,10,0,28,18,10
4096,E02000275,2011,32,262000,196000,6,7,8,11,0,32,21,11
4097,E02000275,2012,38,319000,248000,5,14,10,9,1,37,28,10
4098,E02000275,2013,35,304000,250000,5,7,9,14,7,28,21,14
4099,E02000275,2014,9,263000,234000,0,2,3,4,1,8,6,3
4100,E02000276,2009,72,362000,378000,2,12,36,22,0,72,48,24
4101,E02000276,2010,97,351000,305000,0,10,38,49,0,97,42,55
4102,E02000276,2011,96,408000,402000,0,6,53,37,0,96,54,42
4103,E02000276,2012,92,400000,361000,1,8,47,36,1,91,50,42
4104,E02000276,2013,92,494000,550000,3,11,42,36,1,91,49,43
4105,E02000276,2014,40,503000,481000,0,2,18,20,1,39,19,21
4106,E02000277,2009,56,202000,200000,2,17,27,10,0,56,46,10
4107,E02000277,2010,69,208000,222000,2,26,22,19,1,68,48,21
4108,E02000277,2011,64,215000,228000,1,30,21,12,0,64,52,12
4109,E02000277,2012,53,218000,220000,2,23,21,7,0,53,45,8
4110,E02000277,2013,64,224000,228000,1,28,20,15,0,64,49,15
4111,E02000277,2014,37,213000,232000,1,11,12,13,0,37,22,15
4112,E02000278,2009,56,194000,206000,1,15,23,17,0,56,38,18
4113,E02000278,2010,57,205000,221000,0,15,28,14,0,57,43,14
4114,E02000278,2011,51,203000,203000,2,18,22,9,1,50,42,9
4115,E02000278,2012,84,197000,209000,0,9,42,33,24,60,51,33
4116,E02000278,2013,62,215000,232000,1,16,27,18,1,61,43,19
4117,E02000278,2014,24,221000,246000,1,3,12,8,0,24,16,8
4118,E02000279,2009,94,200000,201000,5,12,48,29,1,93,63,31
4119,E02000279,2010,94,196000,202000,7,9,40,38,0,94,57,37
4120,E02000279,2011,85,182000,190000,2,10,35,38,0,85,47,38
4121,E02000279,2012,85,202000,208000,4,9,39,33,0,85,53,32
4122,E02000279,2013,129,191000,178000,5,4,52,68,0,129,59,70
4123,E02000279,2014,53,197000,180000,3,2,14,34,0,53,19,34
4124,E02000280,2009,101,275000,250000,11,24,52,14,0,101,87,14
4125,E02000280,2010,112,303000,284000,14,27,59,12,0,112,98,14
4126,E02000280,2011,114,289000,279000,17,24,55,18,1,113,93,21
4127,E02000280,2012,122,284000,284000,13,29,48,32,0,122,90,32
4128,E02000280,2013,107,315000,305000,10,31,43,23,0,107,84,23
4129,E02000280,2014,40,317000,336000,3,6,20,11,0,40,29,11
4130,E02000281,2009,77,183000,175000,0,5,30,42,0,77,35,42
4131,E02000281,2010,89,209000,214000,0,16,36,37,0,89,52,37
4132,E02000281,2011,88,223000,195000,3,6,39,40,0,88,46,42
4133,E02000281,2012,71,218000,225000,1,5,36,29,0,71,42,29
4134,E02000281,2013,93,243000,245000,1,9,49,34,1,92,59,34
4135,E02000281,2014,38,257000,260000,0,4,20,14,0,38,24,14
4136,E02000282,2009,49,173000,182000,0,11,19,19,0,49,30,19
4137,E02000282,2010,53,181000,165000,0,11,19,23,0,53,28,25
4138,E02000282,2011,69,187000,180000,1,11,21,36,0,69,33,36
4139,E02000282,2012,72,197000,190000,1,10,30,31,7,65,39,33
4140,E02000282,2013,64,201000,185000,2,8,24,30,1,63,34,30
4141,E02000282,2014,26,209000,198000,0,3,10,13,0,26,13,13
4142,E02000283,2009,60,210000,205000,2,11,39,8,0,60,53,7
4143,E02000283,2010,54,216000,220000,0,15,34,5,0,54,48,6
4144,E02000283,2011,58,214000,222000,1,8,39,10,3,55,47,11
4145,E02000283,2012,51,227000,230000,1,9,35,6,1,50,45,6
4146,E02000283,2013,63,241000,244000,0,14,44,5,0,63,57,6
4147,E02000283,2014,32,353000,250000,0,4,27,1,1,31,31,1
4148,E02000284,2009,84,239000,222000,1,11,40,32,0,84,51,33
4149,E02000284,2010,114,284000,285000,3,21,52,38,0,114,78,36
4150,E02000284,2011,109,258000,244000,6,17,37,49,0,109,59,50
4151,E02000284,2012,114,261000,250000,2,10,58,44,0,114,70,44
4152,E02000284,2013,144,291000,280000,2,18,66,58,9,135,85,59
4153,E02000284,2014,48,331000,317000,0,9,23,16,0,48,32,16
4154,E02000285,2009,64,281000,276000,1,27,30,6,0,64,55,9
4155,E02000285,2010,82,306000,305000,1,37,38,6,0,82,75,7
4156,E02000285,2011,65,319000,320000,0,33,29,3,0,65,61,4
4157,E02000285,2012,51,297000,310000,0,21,24,6,0,51,44,7
4158,E02000285,2013,87,328000,327000,0,35,44,8,1,86,74,13
4159,E02000285,2014,23,373000,375000,0,8,14,1,0,23,21,2
4160,E02000286,2009,151,255000,225000,12,13,17,109,24,127,39,112
4161,E02000286,2010,152,303000,260000,14,19,24,95,9,143,58,94
4162,E02000286,2011,151,290000,248000,19,17,14,101,9,142,47,104
4163,E02000286,2012,148,302000,250000,15,19,23,91,6,142,55,93
4164,E02000286,2013,177,320000,250000,18,15,20,124,30,147,53,124
4165,E02000286,2014,55,356000,317000,8,7,7,33,2,53,21,34
4166,E02000287,2009,63,835000,640000,26,15,5,17,10,53,42,21
4167,E02000287,2010,76,706000,514000,22,25,3,26,5,71,49,27
4168,E02000287,2011,60,707000,478000,18,24,2,16,0,60,42,18
4169,E02000287,2012,67,831000,690000,22,15,6,24,1,66,41,26
4170,E02000287,2013,89,639000,430000,23,15,2,49,23,66,38,51
4171,E02000287,2014,36,787000,742000,15,7,3,11,1,35,25,11
4172,E02000288,2009,55,190000,205000,1,12,25,17,1,54,37,18
4173,E02000288,2010,82,200000,210000,0,10,47,25,1,81,56,26
4174,E02000288,2011,76,200000,206000,2,12,40,22,3,73,54,22
4175,E02000288,2012,54,192000,205000,0,9,25,20,0,54,33,21
4176,E02000288,2013,91,203000,212000,0,12,40,39,0,91,51,40
4177,E02000288,2014,33,248000,250000,2,1,16,14,0,33,19,14
4178,E02000289,2009,53,370000,377000,5,37,6,5,0,53,47,6
4179,E02000289,2010,50,390000,397000,3,32,11,4,0,50,45,5
4180,E02000289,2011,68,441000,446000,9,46,9,4,0,68,64,4
4181,E02000289,2012,59,424000,430000,8,37,12,2,0,59,57,2
4182,E02000289,2013,73,439000,430000,8,43,7,15,4,69,58,15
4183,E02000289,2014,24,518000,497000,4,15,2,3,0,24,21,3
4184,E02000290,2009,35,167000,170000,0,6,12,17,0,35,18,17
4185,E02000290,2010,43,181000,180000,0,2,22,19,0,43,23,20
4186,E02000290,2011,37,182000,208000,0,5,18,14,0,37,22,15
4187,E02000290,2012,44,168000,156000,1,4,15,24,0,44,19,25
4188,E02000290,2013,38,195000,193000,0,3,18,17,0,38,21,17
4189,E02000290,2014,24,198000,216000,0,4,9,11,0,24,13,11
4190,E02000291,2009,94,220000,204000,2,11,27,54,0,94,39,55
4191,E02000291,2010,120,239000,222000,2,6,36,76,1,119,42,78
4192,E02000291,2011,107,235000,218000,4,12,22,69,1,106,36,71
4193,E02000291,2012,114,242000,219000,2,14,27,71,2,112,43,71
4194,E02000291,2013,254,247000,228000,5,16,32,201,82,172,54,200
4195,E02000291,2014,155,259000,245000,0,6,7,142,107,48,13,142
4196,E02000292,2009,92,220000,230000,2,11,68,11,0,92,81,11
4197,E02000292,2010,117,248000,250000,0,19,84,14,0,117,103,14
4198,E02000292,2011,96,239000,240000,0,8,74,14,0,96,83,13
4199,E02000292,2012,107,240000,245000,0,12,73,22,0,107,85,22
4200,E02000292,2013,119,260000,264000,0,5,93,21,4,115,97,22
4201,E02000292,2014,41,269000,265000,0,1,30,10,0,41,30,11
4202,E02000293,2009,84,437000,390000,16,28,6,34,11,73,50,34
4203,E02000293,2010,78,454000,432000,14,26,9,29,6,72,49,29
4204,E02000293,2011,59,498000,464000,13,21,5,20,1,58,39,20
4205,E02000293,2012,87,458000,450000,17,36,5,29,4,83,58,29
4206,E02000293,2013,104,488000,470000,18,47,2,37,4,100,67,37
4207,E02000293,2014,45,490000,440000,10,14,6,15,0,45,29,16
4208,E02000294,2009,59,204000,210000,1,11,42,5,0,59,55,4
4209,E02000294,2010,37,214000,225000,0,6,25,6,0,37,31,6
4210,E02000294,2011,40,204000,212000,0,1,29,10,0,40,30,10
4211,E02000294,2012,47,218000,220000,0,6,35,6,0,47,41,6
4212,E02000294,2013,63,227000,240000,0,6,49,8,0,63,55,8
4213,E02000294,2014,19,261000,265000,0,1,17,1,0,19,18,1
4214,E02000295,2009,76,292000,250000,3,22,14,37,1,75,39,37
4215,E02000295,2010,134,305000,270000,3,28,20,83,10,124,52,82
4216,E02000295,2011,87,325000,250000,3,21,14,49,0,87,38,49
4217,E02000295,2012,96,348000,308000,3,28,18,47,0,96,49,47
4218,E02000295,2013,132,356000,278000,11,39,12,70,0,132,62,70
4219,E02000295,2014,37,417000,425000,5,13,3,16,0,37,21,16
4220,E02000296,2009,120,259000,237000,3,20,23,74,27,93,46,74
4221,E02000296,2010,116,277000,250000,2,22,27,65,0,116,49,67
4222,E02000296,2011,127,273000,260000,3,10,33,81,8,119,46,81
4223,E02000296,2012,116,303000,265000,5,13,32,66,7,109,50,66
4224,E02000296,2013,152,296000,274000,3,12,24,113,29,123,39,113
4225,E02000296,2014,33,328000,275000,0,4,6,23,0,33,10,23
4226,E02000297,2009,88,296000,296000,2,21,44,21,4,84,65,23
4227,E02000297,2010,107,340000,340000,7,33,45,22,1,106,86,21
4228,E02000297,2011,95,337000,355000,7,28,38,22,0,95,73,22
4229,E02000297,2012,100,337000,358000,6,30,45,19,0,100,81,19
4230,E02000297,2013,121,375000,370000,6,36,49,30,0,121,91,30
4231,E02000297,2014,40,361000,406000,1,13,16,10,0,40,29,11
4232,E02000298,2009,92,462000,440000,11,37,20,24,0,92,68,24
4233,E02000298,2010,85,577000,460000,14,31,17,23,3,82,60,25
4234,E02000298,2011,79,531000,500000,8,35,14,22,0,79,56,23
4235,E02000298,2012,80,454000,480000,5,34,15,26,0,80,51,29
4236,E02000298,2013,122,508000,530000,11,45,28,38,3,119,81,41
4237,E02000298,2014,39,588000,580000,7,11,11,10,0,39,27,12
4238,E02000299,2009,48,191000,190000,0,5,38,5,0,48,44,4
4239,E02000299,2010,79,198000,200000,0,3,62,14,0,79,64,15
4240,E02000299,2011,59,209000,210000,1,5,50,3,0,59,56,3
4241,E02000299,2012,50,195000,204000,0,3,35,12,0,50,38,12
4242,E02000299,2013,70,205000,215000,1,2,51,16,1,69,54,16
4243,E02000299,2014,28,228000,249000,0,2,21,5,0,28,22,6
4244,E02000300,2009,66,202000,204000,1,10,40,15,0,66,52,14
4245,E02000300,2010,56,194000,191000,1,5,30,20,0,56,36,20
4246,E02000300,2011,62,204000,209000,0,7,40,15,0,62,47,15
4247,E02000300,2012,69,195000,212000,1,5,39,24,0,69,45,24
4248,E02000300,2013,66,209000,230000,3,6,37,20,0,66,45,21
4249,E02000300,2014,25,217000,235000,0,2,14,9,0,25,16,9
4250,E02000301,2009,48,161000,175000,0,6,20,22,2,46,27,21
4251,E02000301,2010,64,186000,190000,0,6,37,21,0,64,44,20
4252,E02000301,2011,46,171000,173000,0,3,27,16,0,46,30,16
4253,E02000301,2012,64,181000,188000,0,5,35,24,0,64,40,24
4254,E02000301,2013,65,182000,188000,0,5,32,28,0,65,37,28
4255,E02000301,2014,53,206000,226000,1,2,30,20,2,51,32,21
4256,E02000302,2009,77,274000,272000,1,18,41,17,5,72,60,17
4257,E02000302,2010,66,314000,310000,1,13,38,14,6,60,52,14
4258,E02000302,2011,55,324000,340000,1,13,32,9,2,53,45,10
4259,E02000302,2012,101,325000,335000,2,14,50,35,26,75,66,35
4260,E02000302,2013,101,344000,350000,6,19,52,24,6,95,75,26
4261,E02000302,2014,30,362000,385000,0,5,17,8,0,30,22,8
4262,E02000303,2009,56,191000,198000,0,18,19,19,2,54,37,19
4263,E02000303,2010,52,172000,159000,0,10,14,28,0,52,23,29
4264,E02000303,2011,45,221000,235000,0,18,20,7,0,45,38,7
4265,E02000303,2012,50,217000,234000,0,20,20,10,2,48,40,10
4266,E02000303,2013,51,215000,240000,0,23,11,17,0,51,34,17
4267,E02000303,2014,12,233000,244000,1,3,4,4,0,12,8,4
4268,E02000304,2009,56,367000,310000,3,20,8,25,9,47,28,28
4269,E02000304,2010,64,439000,465000,10,23,8,23,2,62,40,24
4270,E02000304,2011,57,504000,493000,6,28,8,15,2,55,41,16
4271,E02000304,2012,58,511000,485000,8,28,11,11,1,57,46,12
4272,E02000304,2013,86,543000,572000,11,37,11,27,0,86,58,28
4273,E02000304,2014,21,537000,555000,0,11,2,8,2,19,12,9
4274,E02000305,2009,78,305000,275000,2,14,28,34,0,78,37,41
4275,E02000305,2010,101,303000,267000,2,9,28,62,3,98,32,69
4276,E02000305,2011,131,317000,260000,5,13,41,72,7,124,50,81
4277,E02000305,2012,112,350000,280000,2,12,32,66,9,103,43,69
4278,E02000305,2013,112,376000,327000,0,20,37,55,2,110,50,62
4279,E02000305,2014,35,368000,325000,0,4,8,23,0,35,9,26
4280,E02000306,2009,17,166000,169000,0,0,11,6,0,17,11,6
4281,E02000306,2010,42,153000,150000,0,1,16,25,0,42,17,25
4282,E02000306,2011,26,174000,177000,0,2,10,14,0,26,13,13
4283,E02000306,2012,31,172000,166000,0,3,13,15,0,31,15,16
4284,E02000306,2013,38,187000,178000,0,6,9,23,0,38,15,23
4285,E02000306,2014,25,189000,178000,0,3,5,17,0,25,8,17
4286,E02000307,2009,62,214000,210000,0,9,51,2,0,62,61,1
4287,E02000307,2010,70,245000,232000,0,11,58,1,1,69,69,1
4288,E02000307,2011,72,214000,210000,0,2,63,7,0,72,65,7
4289,E02000307,2012,68,245000,248000,0,9,52,7,0,68,61,7
4290,E02000307,2013,85,269000,254000,0,6,73,6,0,85,78,7
4291,E02000307,2014,32,298000,300000,0,3,27,2,0,32,30,2
4292,E02000308,2009,61,275000,285000,2,15,24,20,0,61,42,19
4293,E02000308,2010,63,293000,302000,0,11,34,18,0,63,46,17
4294,E02000308,2011,79,307000,315000,1,19,34,25,0,79,54,25
4295,E02000308,2012,61,335000,330000,1,9,36,15,0,61,46,15
4296,E02000308,2013,58,327000,326000,1,6,27,24,0,58,33,25
4297,E02000308,2014,21,434000,475000,1,3,13,4,0,21,16,5
4298,E02000309,2009,64,174000,175000,0,6,48,10,0,64,53,11
4299,E02000309,2010,62,184000,182000,1,5,35,21,0,62,44,18
4300,E02000309,2011,89,182000,190000,0,6,57,26,0,89,64,25
4301,E02000309,2012,58,194000,200000,1,4,45,8,0,58,50,8
4302,E02000309,2013,58,200000,214000,0,2,43,13,0,58,44,14
4303,E02000309,2014,26,229000,230000,1,0,22,3,0,26,23,3
4304,E02000311,2009,101,215000,206000,0,7,30,64,49,52,39,62
4305,E02000311,2010,94,231000,225000,0,8,36,50,27,67,43,51
4306,E02000311,2011,69,258000,250000,1,10,39,19,0,69,50,19
4307,E02000311,2012,75,269000,250000,0,5,50,20,0,75,54,21
4308,E02000311,2013,82,268000,269000,0,8,40,34,0,82,48,34
4309,E02000311,2014,30,299000,278000,1,3,16,10,0,30,19,11
4310,E02000312,2009,78,269000,250000,4,10,31,33,0,78,42,36
4311,E02000312,2010,95,279000,250000,0,11,33,51,0,95,40,55
4312,E02000312,2011,94,299000,250000,2,14,29,49,8,86,43,51
4313,E02000312,2012,95,307000,300000,0,14,33,48,4,91,44,51
4314,E02000312,2013,132,328000,282000,1,16,43,72,2,130,56,76
4315,E02000312,2014,47,382000,375000,2,8,12,25,0,47,20,27
4316,E02000313,2009,14,137000,139000,0,1,10,3,0,14,11,3
4317,E02000313,2010,12,170000,176000,1,0,10,1,0,12,11,1
4318,E02000313,2011,10,144000,154000,1,0,7,2,0,10,8,2
4319,E02000313,2012,19,157000,165000,0,1,16,2,0,19,17,2
4320,E02000313,2013,18,135000,146000,0,0,10,8,0,18,10,8
4321,E02000313,2014,14,152000,166000,0,0,9,5,0,14,9,5
4322,E02000314,2009,41,158000,157000,2,6,25,8,0,41,33,8
4323,E02000314,2010,41,176000,171000,2,6,22,11,0,41,31,10
4324,E02000314,2011,49,162000,157000,2,2,29,16,0,49,32,17
4325,E02000314,2012,56,171000,162000,3,7,30,16,0,56,40,16
4326,E02000314,2013,96,159000,158000,1,5,51,39,0,96,56,40
4327,E02000314,2014,40,184000,172000,3,1,19,17,0,40,23,17
4328,E02000315,2009,30,159000,163000,0,4,20,6,0,30,24,6
4329,E02000315,2010,29,166000,175000,0,2,23,4,0,29,25,4
4330,E02000315,2011,46,155000,164000,0,5,33,8,0,46,38,8
4331,E02000315,2012,45,161000,162000,0,3,36,6,0,45,39,6
4332,E02000315,2013,49,175000,179000,1,3,32,13,3,46,36,13
4333,E02000315,2014,19,218000,215000,0,1,15,3,1,18,16,3
4334,E02000316,2009,116,268000,250000,0,2,6,108,87,29,8,108
4335,E02000316,2010,113,250000,250000,1,0,14,98,43,70,11,102
4336,E02000316,2011,125,228000,224000,1,1,11,112,48,77,6,119
4337,E02000316,2012,227,234000,208000,0,0,11,216,127,100,8,219
4338,E02000316,2013,183,273000,290000,0,1,8,174,43,140,8,175
4339,E02000316,2014,59,253000,250000,0,0,6,53,3,56,4,55
4340,E02000317,2009,24,234000,208000,0,2,15,7,0,24,17,7
4341,E02000317,2010,20,207000,164000,0,1,10,9,0,20,11,9
4342,E02000317,2011,25,221000,190000,0,2,12,11,0,25,13,12
4343,E02000317,2012,39,190000,152000,0,1,13,25,0,39,14,25
4344,E02000317,2013,58,252000,190000,1,0,24,33,0,58,25,33
4345,E02000317,2014,18,207000,168000,0,0,6,12,0,18,6,12
4346,E02000318,2009,58,175000,175000,0,3,47,8,0,58,52,6
4347,E02000318,2010,59,182000,185000,1,5,48,5,0,59,54,5
4348,E02000318,2011,52,171000,174000,0,9,34,9,1,51,43,9
4349,E02000318,2012,71,171000,171000,1,7,48,15,0,71,56,15
4350,E02000318,2013,69,202000,202000,0,9,56,4,0,69,65,4
4351,E02000318,2014,18,221000,223000,0,2,15,1,0,18,17,1
4352,E02000319,2009,47,157000,153000,0,0,38,9,0,47,38,9
4353,E02000319,2010,59,189000,186000,0,5,43,11,0,59,47,12
4354,E02000319,2011,85,180000,175000,0,3,63,19,0,85,67,18
4355,E02000319,2012,77,182000,190000,0,0,49,28,0,77,50,27
4356,E02000319,2013,102,192000,192000,0,2,62,38,1,101,64,38
4357,E02000319,2014,31,220000,215000,0,2,21,8,0,31,23,8
4358,E02000320,2009,45,175000,174000,0,3,40,2,0,45,41,4
4359,E02000320,2010,40,183000,181000,0,1,35,4,0,40,36,4
4360,E02000320,2011,42,186000,180000,0,3,37,2,0,42,40,2
4361,E02000320,2012,42,187000,184000,0,1,36,5,0,42,37,5
4362,E02000320,2013,54,206000,210000,1,2,45,6,0,54,48,6
4363,E02000320,2014,18,239000,250000,0,2,13,3,0,18,15,3
4364,E02000321,2009,38,157000,158000,0,0,25,13,0,38,26,12
4365,E02000321,2010,33,175000,185000,1,4,19,9,0,33,24,9
4366,E02000321,2011,23,175000,175000,0,0,13,10,0,23,13,10
4367,E02000321,2012,23,188000,198000,0,0,20,3,0,23,20,3
4368,E02000321,2013,41,192000,192000,0,3,27,11,0,41,30,11
4369,E02000321,2014,14,211000,206000,0,1,7,6,0,14,8,6
4370,E02000323,2009,43,191000,190000,0,0,33,10,0,43,33,10
4371,E02000323,2010,45,183000,182000,1,1,29,14,0,45,31,14
4372,E02000323,2011,45,187000,180000,1,1,33,10,0,45,35,10
4373,E02000323,2012,56,184000,188000,0,3,34,19,0,56,36,20
4374,E02000323,2013,117,234000,233000,0,2,31,84,48,69,32,85
4375,E02000323,2014,67,264000,268000,0,0,12,55,37,30,13,54
4376,E02000324,2009,36,235000,224000,0,16,14,6,0,36,30,6
4377,E02000324,2010,45,297000,250000,0,13,18,14,0,45,33,12
4378,E02000324,2011,45,252000,247000,2,21,7,15,0,45,29,16
4379,E02000324,2012,50,286000,249000,2,16,16,16,0,50,34,16
4380,E02000324,2013,58,300000,250000,3,13,18,24,0,58,34,24
4381,E02000324,2014,18,325000,298000,0,5,6,7,0,18,10,8
4382,E02000326,2009,102,274000,285000,0,11,62,29,20,82,66,36
4383,E02000326,2010,95,308000,320000,0,8,61,26,0,95,67,28
4384,E02000326,2011,95,281000,285000,0,7,50,38,0,95,51,44
4385,E02000326,2012,100,321000,337000,2,6,68,24,0,100,75,25
4386,E02000326,2013,123,361000,385000,0,10,79,34,0,123,84,39
4387,E02000326,2014,31,361000,415000,1,2,14,14,0,31,17,14
4388,E02000327,2009,23,231000,180000,1,0,5,17,10,13,6,17
4389,E02000327,2010,21,176000,160000,0,1,6,14,6,15,7,14
4390,E02000327,2011,27,169000,164000,0,3,2,22,4,23,5,22
4391,E02000327,2012,26,179000,182000,0,1,7,18,0,26,9,17
4392,E02000327,2013,46,247000,190000,0,0,11,35,15,31,11,35
4393,E02000327,2014,16,204000,179000,1,0,6,9,2,14,5,11
4394,E02000328,2009,95,403000,325000,6,6,15,68,23,72,26,69
4395,E02000328,2010,149,388000,310000,2,9,21,117,64,85,28,121
4396,E02000328,2011,115,413000,335000,2,9,15,89,28,87,26,89
4397,E02000328,2012,114,494000,375000,10,16,19,69,4,110,44,70
4398,E02000328,2013,138,477000,347000,5,15,16,102,2,136,37,101
4399,E02000328,2014,43,447000,360000,1,3,6,33,0,43,9,34
4400,E02000329,2009,51,185000,180000,0,18,29,4,0,51,47,4
4401,E02000329,2010,64,198000,196000,0,21,39,4,0,64,60,4
4402,E02000329,2011,49,191000,190000,1,16,28,4,0,49,44,5
4403,E02000329,2012,51,190000,180000,0,15,26,10,0,51,41,10
4404,E02000329,2013,65,224000,215000,0,15,49,1,0,65,64,1
4405,E02000329,2014,30,253000,250000,0,11,16,3,0,30,27,3
4406,E02000331,2009,65,253000,215000,1,19,28,17,0,65,48,17
4407,E02000331,2010,72,279000,225000,1,12,29,30,0,72,42,30
4408,E02000331,2011,77,264000,235000,2,15,30,30,2,75,47,30
4409,E02000331,2012,72,237000,228000,1,12,26,33,0,72,39,33
4410,E02000331,2013,110,257000,236000,1,17,36,56,0,110,54,56
4411,E02000331,2014,42,257000,232000,0,2,10,30,0,42,12,30
4412,E02000332,2009,47,234000,220000,5,10,20,12,3,44,35,12
4413,E02000332,2010,70,248000,235000,3,18,31,18,1,69,53,17
4414,E02000332,2011,56,241000,231000,3,14,31,8,0,56,49,7
4415,E02000332,2012,111,245000,238000,8,24,54,25,0,111,86,25
4416,E02000332,2013,120,271000,261000,7,24,59,30,8,112,88,32
4417,E02000332,2014,45,275000,280000,2,13,13,17,2,43,28,17
4418,E02000333,2009,81,414000,315000,9,12,8,52,0,81,28,53
4419,E02000333,2010,124,503000,352000,14,13,9,88,1,123,34,90
4420,E02000333,2011,107,529000,392000,11,15,13,68,1,106,38,69
4421,E02000333,2012,106,500000,358000,7,18,6,75,2,104,31,75
4422,E02000333,2013,153,528000,355000,14,12,12,115,2,151,36,117
4423,E02000333,2014,51,485000,391000,1,6,5,39,1,50,12,39
4424,E02000334,2009,52,222000,200000,1,20,18,13,0,52,39,13
4425,E02000334,2010,64,253000,245000,1,30,14,19,0,64,45,19
4426,E02000334,2011,63,241000,219000,1,29,22,11,0,63,52,11
4427,E02000334,2012,66,253000,245000,4,27,20,15,0,66,51,15
4428,E02000334,2013,85,283000,250000,1,43,18,23,0,85,62,23
4429,E02000334,2014,27,302000,265000,1,9,10,7,0,27,20,7
4430,E02000335,2009,80,220000,222000,0,22,40,18,16,64,61,19
4431,E02000335,2010,80,251000,247000,0,24,49,7,2,78,72,8
4432,E02000335,2011,76,240000,241000,0,21,49,6,0,76,68,8
4433,E02000335,2012,94,255000,250000,0,30,58,6,0,94,86,8
4434,E02000335,2013,88,267000,268000,0,25,55,8,0,88,77,11
4435,E02000335,2014,37,299000,310000,0,10,24,3,0,37,32,5
4436,E02000337,2009,75,198000,192000,0,21,44,10,0,75,65,10
4437,E02000337,2010,59,217000,212000,0,19,35,5,0,59,53,6
4438,E02000337,2011,62,232000,224000,0,27,30,5,0,62,57,5
4439,E02000337,2012,55,208000,220000,0,19,26,10,0,55,43,12
4440,E02000337,2013,75,230000,231000,0,20,37,18,2,73,56,19
4441,E02000337,2014,20,276000,282000,0,8,8,4,0,20,16,4
4442,E02000339,2009,54,257000,250000,2,13,30,9,0,54,40,14
4443,E02000339,2010,64,308000,272000,5,17,34,8,0,64,53,11
4444,E02000339,2011,74,305000,299000,4,22,29,19,0,74,53,21
4445,E02000339,2012,68,326000,284000,3,14,33,18,1,67,49,19
4446,E02000339,2013,77,375000,381000,7,21,37,12,1,76,63,14
4447,E02000339,2014,20,384000,410000,0,8,6,6,0,20,14,6
4448,E02000340,2009,70,242000,190000,7,13,15,35,0,70,33,37
4449,E02000340,2010,85,280000,225000,11,25,14,35,0,85,49,36
4450,E02000340,2011,88,247000,225000,5,26,18,39,0,88,48,40
4451,E02000340,2012,97,288000,249000,5,30,19,43,5,92,51,46
4452,E02000340,2013,100,287000,244000,6,24,22,48,6,94,51,49
4453,E02000340,2014,48,284000,236000,3,11,7,27,0,48,20,28
4454,E02000341,2009,38,186000,184000,1,12,11,14,0,38,24,14
4455,E02000341,2010,44,219000,203000,2,15,15,12,0,44,32,12
4456,E02000341,2011,31,201000,182000,0,9,14,8,0,31,23,8
4457,E02000341,2012,42,219000,187000,2,10,16,14,0,42,27,15
4458,E02000341,2013,68,230000,200000,4,18,22,24,0,68,43,25
4459,E02000341,2014,27,288000,250000,4,6,10,7,0,27,20,7
4460,E02000342,2009,47,234000,230000,1,19,21,6,0,47,41,6
4461,E02000342,2010,62,237000,232000,0,23,24,15,0,62,48,14
4462,E02000342,2011,56,218000,210000,0,16,29,11,0,56,43,13
4463,E02000342,2012,52,209000,219000,0,13,21,18,0,52,34,18
4464,E02000342,2013,59,255000,250000,1,18,26,14,0,59,45,14
4465,E02000342,2014,18,303000,292000,2,4,7,5,0,18,12,6
4466,E02000343,2009,45,221000,222000,1,25,9,10,0,45,35,10
4467,E02000343,2010,60,242000,239000,1,38,14,7,0,60,52,8
4468,E02000343,2011,56,280000,249000,5,31,10,10,0,56,45,11
4469,E02000343,2012,54,253000,239000,3,23,13,15,0,54,39,15
4470,E02000343,2013,100,264000,250000,3,42,24,31,0,100,67,33
4471,E02000343,2014,28,293000,267000,2,11,3,12,0,28,16,12
4472,E02000344,2009,46,236000,248000,2,20,14,10,0,46,35,11
4473,E02000344,2010,60,255000,252000,2,31,16,11,0,60,49,11
4474,E02000344,2011,61,263000,275000,3,34,17,7,0,61,54,7
4475,E02000344,2012,88,270000,268000,1,55,19,13,0,88,74,14
4476,E02000344,2013,88,282000,276000,3,49,18,18,2,86,69,19
4477,E02000344,2014,39,333000,325000,0,26,8,5,0,39,34,5
4478,E02000345,2009,21,316000,270000,0,3,7,11,0,21,10,11
4479,E02000345,2010,34,387000,330000,2,1,16,15,0,34,19,15
4480,E02000345,2011,27,306000,250000,1,1,11,14,0,27,10,17
4481,E02000345,2012,32,361000,326000,1,2,10,19,0,32,9,23
4482,E02000345,2013,26,397000,319000,0,2,10,14,0,26,11,15
4483,E02000345,2014,9,359000,340000,0,0,3,6,0,9,2,7
4484,E02000346,2009,12,190000,175000,0,0,1,11,1,11,1,11
4485,E02000346,2010,20,195000,206000,0,0,0,20,0,20,0,20
4486,E02000346,2011,17,223000,210000,0,0,0,17,0,17,0,17
4487,E02000346,2012,253,309000,300000,0,0,0,253,217,36,0,253
4488,E02000346,2013,78,326000,280000,0,1,1,76,7,71,2,76
4489,E02000346,2014,8,407000,315000,0,0,1,7,0,8,1,7
4490,E02000347,2009,27,304000,273000,1,2,4,20,0,27,6,21
4491,E02000347,2010,50,353000,250000,3,2,7,38,0,50,12,38
4492,E02000347,2011,42,347000,308000,0,2,7,33,0,42,7,35
4493,E02000347,2012,33,344000,320000,0,2,4,27,0,33,6,27
4494,E02000347,2013,53,360000,310000,0,1,4,48,0,53,4,49
4495,E02000347,2014,21,454000,390000,0,2,4,15,0,21,5,16
4496,E02000348,2009,18,315000,250000,0,0,4,14,0,18,4,14
4497,E02000348,2010,37,302000,250000,1,1,9,26,1,36,10,27
4498,E02000348,2011,33,337000,278000,2,2,7,22,0,33,10,23
4499,E02000348,2012,27,365000,318000,0,2,6,19,0,27,9,18
4500,E02000348,2013,26,291000,257000,0,0,2,24,1,25,2,24
4501,E02000348,2014,8,348000,258000,0,1,2,5,0,8,3,5
4502,E02000350,2009,83,299000,245000,1,1,22,59,11,72,19,64
4503,E02000350,2010,83,337000,300000,1,0,16,66,0,83,15,68
4504,E02000350,2011,102,359000,297000,1,2,23,76,2,100,23,79
4505,E02000350,2012,101,398000,325000,0,1,26,74,6,95,23,78
4506,E02000350,2013,97,407000,346000,0,2,16,79,6,91,18,79
4507,E02000350,2014,28,483000,399000,0,1,5,22,1,27,6,22
4508,E02000351,2009,64,325000,290000,0,2,5,57,1,63,6,58
4509,E02000351,2010,111,345000,310000,0,4,11,96,1,110,12,99
4510,E02000351,2011,97,350000,310000,1,3,11,82,1,96,11,86
4511,E02000351,2012,104,354000,319000,0,1,6,97,2,102,5,99
4512,E02000351,2013,166,395000,368000,0,2,10,154,38,128,11,155
4513,E02000351,2014,34,522000,511000,0,2,2,30,0,34,2,32
4514,E02000352,2009,43,351000,300000,1,3,9,30,3,40,13,30
4515,E02000352,2010,69,355000,295000,0,4,15,50,3,66,18,51
4516,E02000352,2011,52,341000,338000,2,2,12,36,9,43,15,37
4517,E02000352,2012,64,399000,322000,0,2,14,48,1,63,16,48
4518,E02000352,2013,71,394000,361000,0,3,7,61,2,69,8,63
4519,E02000352,2014,24,426000,418000,0,0,2,22,1,23,2,22
4520,E02000353,2009,80,396000,422000,0,5,40,35,3,77,42,38
4521,E02000353,2010,101,430000,404000,0,6,47,48,0,101,51,50
4522,E02000353,2011,88,459000,442000,1,1,48,38,0,88,47,41
4523,E02000353,2012,89,544000,575000,0,0,56,33,0,89,55,34
4524,E02000353,2013,93,594000,600000,0,1,46,46,7,86,46,47
4525,E02000353,2014,32,620000,560000,0,0,16,16,0,32,16,16
4526,E02000354,2009,75,257000,225000,0,1,12,62,2,73,13,62
4527,E02000354,2010,85,299000,249000,0,1,18,66,0,85,16,69
4528,E02000354,2011,75,285000,250000,1,0,14,60,0,75,11,64
4529,E02000354,2012,107,320000,290000,0,3,18,86,9,98,21,86
4530,E02000354,2013,92,343000,313000,0,0,13,79,1,91,12,80
4531,E02000354,2014,32,432000,372000,0,2,5,25,1,31,7,25
4532,E02000355,2009,36,295000,250000,1,1,15,19,0,36,17,19
4533,E02000355,2010,68,375000,376000,0,0,35,33,1,67,34,34
4534,E02000355,2011,83,332000,280000,1,1,30,51,0,83,29,54
4535,E02000355,2012,85,401000,390000,0,0,37,48,0,85,36,49
4536,E02000355,2013,92,481000,445000,1,2,41,48,1,91,42,50
4537,E02000355,2014,29,527000,425000,0,0,13,16,1,28,13,16
4538,E02000356,2009,77,370000,300000,1,2,26,48,7,70,28,49
4539,E02000356,2010,108,451000,405000,1,1,44,62,0,108,45,63
4540,E02000356,2011,97,392000,340000,1,1,23,72,5,92,22,75
4541,E02000356,2012,78,494000,468000,0,0,30,48,3,75,29,49
4542,E02000356,2013,100,519000,470000,0,0,27,73,5,95,26,74
4543,E02000356,2014,26,644000,600000,0,0,12,14,1,25,11,15
4544,E02000357,2009,9,198000,188000,0,0,1,8,0,9,1,8
4545,E02000357,2010,17,182000,165000,0,0,2,15,0,17,2,15
4546,E02000357,2011,27,194000,170000,0,1,7,19,0,27,7,20
4547,E02000357,2012,129,250000,240000,0,1,7,121,103,26,6,123
4548,E02000357,2013,36,228000,215000,0,0,5,31,1,35,5,31
4549,E02000357,2014,17,280000,245000,0,0,1,16,0,17,1,16
4550,E02000358,2009,62,322000,282000,0,0,23,39,0,62,20,42
4551,E02000358,2010,101,331000,310000,1,1,20,79,3,98,18,83
4552,E02000358,2011,97,350000,305000,0,0,25,72,2,95,20,77
4553,E02000358,2012,96,385000,346000,0,3,30,63,3,93,27,69
4554,E02000358,2013,151,398000,353000,0,1,36,114,13,138,28,123
4555,E02000358,2014,36,427000,370000,0,0,5,31,0,36,5,31
4556,E02000359,2009,46,320000,329000,0,2,30,14,0,46,31,15
4557,E02000359,2010,58,336000,342000,0,3,34,21,0,58,37,21
4558,E02000359,2011,87,366000,381000,1,1,52,33,0,87,52,35
4559,E02000359,2012,75,391000,405000,0,1,37,37,8,67,39,36
4560,E02000359,2013,76,512000,545000,0,1,49,26,12,64,49,27
4561,E02000359,2014,33,554000,560000,0,0,20,13,1,32,20,13
4562,E02000360,2009,39,256000,218000,0,0,9,30,0,39,8,31
4563,E02000360,2010,94,257000,234000,0,1,8,85,35,59,7,87
4564,E02000360,2011,73,289000,250000,0,1,8,64,17,56,7,66
4565,E02000360,2012,80,316000,268000,0,1,16,63,7,73,14,66
4566,E02000360,2013,73,380000,340000,0,2,8,63,3,70,10,63
4567,E02000360,2014,26,415000,330000,0,0,5,21,0,26,4,22
4568,E02000361,2009,55,268000,238000,0,2,7,46,6,49,8,47
4569,E02000361,2010,65,287000,250000,0,0,12,53,2,63,12,53
4570,E02000361,2011,70,303000,278000,1,2,15,52,8,62,14,56
4571,E02000361,2012,72,334000,312000,0,1,5,66,16,56,6,66
4572,E02000361,2013,65,392000,358000,0,1,8,56,2,63,9,56
4573,E02000361,2014,23,461000,400000,0,0,5,18,0,23,4,19
4574,E02000362,2009,39,206000,181000,0,1,8,30,15,24,9,30
4575,E02000362,2010,53,253000,232000,0,0,18,35,0,53,18,35
4576,E02000362,2011,60,272000,246000,0,2,25,33,0,60,26,34
4577,E02000362,2012,60,299000,249000,1,2,26,31,2,58,27,33
4578,E02000362,2013,67,330000,275000,0,1,19,47,8,59,19,48
4579,E02000362,2014,31,345000,345000,0,2,7,22,1,30,9,22
4580,E02000363,2009,35,213000,185000,0,0,6,29,2,33,5,30
4581,E02000363,2010,40,264000,201000,0,1,9,30,3,37,9,31
4582,E02000363,2011,43,284000,218000,0,1,12,30,3,40,9,34
4583,E02000363,2012,52,283000,227000,0,0,11,41,3,49,9,43
4584,E02000363,2013,51,285000,242000,0,1,10,40,1,50,9,42
4585,E02000363,2014,62,339000,340000,1,0,4,57,27,35,3,59
4586,E02000364,2009,61,377000,332000,0,1,24,36,2,59,23,38
4587,E02000364,2010,138,375000,320000,2,3,29,104,41,97,34,104
4588,E02000364,2011,167,416000,385000,2,3,34,128,72,95,38,129
4589,E02000364,2012,93,480000,425000,0,6,21,66,4,89,27,66
4590,E02000364,2013,110,544000,434000,2,10,27,71,2,108,37,73
4591,E02000364,2014,32,662000,542000,0,1,9,22,1,31,9,23
4592,E02000365,2009,235,338000,298000,2,8,27,198,153,82,37,198
4593,E02000365,2010,175,408000,318000,2,11,33,129,50,125,45,130
4594,E02000365,2011,292,382000,326000,0,12,36,244,174,118,50,242
4595,E02000365,2012,212,447000,365000,0,7,33,172,78,134,40,172
4596,E02000365,2013,307,461000,394000,0,2,38,267,140,167,38,269
4597,E02000365,2014,55,632000,530000,2,3,11,39,0,55,14,41
4598,E02000366,2009,52,381000,325000,0,4,10,38,0,52,12,40
4599,E02000366,2010,61,413000,300000,2,4,16,39,5,56,22,39
4600,E02000366,2011,76,412000,346000,2,3,19,52,1,75,24,52
4601,E02000366,2012,62,478000,439000,2,1,23,36,0,62,25,37
4602,E02000366,2013,51,507000,457000,0,0,16,35,0,51,13,38
4603,E02000366,2014,16,530000,345000,0,1,3,12,0,16,4,12
4604,E02000367,2009,76,299000,250000,0,5,14,57,16,60,13,63
4605,E02000367,2010,121,374000,320000,3,9,24,85,9,112,32,89
4606,E02000367,2011,94,351000,328000,1,2,15,76,2,92,16,78
4607,E02000367,2012,86,409000,365000,1,3,10,72,12,74,13,73
4608,E02000367,2013,133,445000,375000,2,2,24,105,6,127,27,106
4609,E02000367,2014,40,504000,480000,0,1,5,34,1,39,5,35
4610,E02000368,2009,62,261000,246000,0,1,5,56,5,57,6,56
4611,E02000368,2010,61,331000,300000,1,1,10,49,14,47,13,48
4612,E02000368,2011,62,304000,278000,1,0,9,52,2,60,9,53
4613,E02000368,2012,67,344000,302000,0,3,8,56,14,53,11,56
4614,E02000368,2013,66,359000,328000,0,0,12,54,3,63,11,55
4615,E02000368,2014,22,384000,352000,0,0,2,20,0,22,2,20
4616,E02000369,2009,78,302000,275000,0,1,2,75,21,57,3,75
4617,E02000369,2010,113,331000,310000,0,1,4,108,23,90,2,111
4618,E02000369,2011,103,356000,350000,1,5,7,90,18,85,10,93
4619,E02000369,2012,228,346000,325000,0,1,3,224,143,85,3,225
4620,E02000369,2013,212,429000,402000,0,0,4,208,83,129,3,209
4621,E02000369,2014,48,413000,402000,0,0,0,48,2,46,0,48
4622,E02000370,2009,156,424000,385000,0,0,3,153,98,58,3,153
4623,E02000370,2010,69,401000,300000,0,0,2,67,1,68,2,67
4624,E02000370,2011,60,402000,322000,0,0,6,54,2,58,6,54
4625,E02000370,2012,62,492000,402000,0,1,3,58,7,55,3,59
4626,E02000370,2013,89,528000,412000,0,0,1,88,13,76,1,88
4627,E02000370,2014,101,555000,549000,0,0,0,101,66,35,0,101
4628,E02000371,2009,144,351000,345000,1,1,2,140,63,81,4,140
4629,E02000371,2010,118,395000,315000,1,0,9,108,3,115,8,110
4630,E02000371,2011,106,375000,375000,0,0,2,104,3,103,2,104
4631,E02000371,2012,111,487000,408000,0,1,2,108,11,100,3,108
4632,E02000371,2013,267,483000,410000,0,1,1,265,135,132,2,265
4633,E02000371,2014,45,566000,487000,0,0,1,44,8,37,1,44
4634,E02000372,2009,30,276000,268000,0,5,14,11,0,30,22,8
4635,E02000372,2010,34,297000,291000,0,3,18,13,0,34,22,12
4636,E02000372,2011,29,280000,275000,1,1,18,9,0,29,20,9
4637,E02000372,2012,51,366000,318000,0,4,29,18,0,51,33,18
4638,E02000372,2013,59,366000,349000,0,1,34,24,0,59,34,25
4639,E02000372,2014,19,384000,408000,0,0,12,7,0,19,13,6
4640,E02000373,2009,14,212000,194000,0,0,2,12,0,14,2,12
4641,E02000373,2010,18,253000,208000,0,2,4,12,0,18,6,12
4642,E02000373,2011,14,229000,195000,0,1,0,13,0,14,1,13
4643,E02000373,2012,20,301000,239000,0,1,6,13,0,20,7,13
4644,E02000373,2013,41,278000,225000,0,2,6,33,0,41,8,33
4645,E02000373,2014,16,312000,293000,0,0,1,15,1,15,1,15
4646,E02000374,2009,61,372000,340000,0,10,24,27,0,61,32,29
4647,E02000374,2010,50,446000,421000,1,3,30,16,0,50,33,17
4648,E02000374,2011,67,459000,420000,0,9,34,24,0,67,43,24
4649,E02000374,2012,80,531000,495000,2,9,40,29,0,80,51,29
4650,E02000374,2013,74,567000,500000,0,7,32,35,1,73,35,39
4651,E02000374,2014,22,725000,638000,0,0,15,7,0,22,13,9
4652,E02000375,2009,42,348000,314000,0,1,9,32,1,41,10,32
4653,E02000375,2010,66,443000,368000,2,0,21,43,1,65,23,43
4654,E02000375,2011,70,459000,345000,0,0,25,45,3,67,20,50
4655,E02000375,2012,51,489000,381000,0,0,18,33,1,50,17,34
4656,E02000375,2013,68,520000,428000,1,0,17,50,0,68,17,51
4657,E02000375,2014,28,474000,375000,0,0,6,22,0,28,6,22
4658,E02000376,2009,54,424000,326000,1,4,9,40,0,54,14,40
4659,E02000376,2010,71,404000,330000,0,1,14,56,0,71,13,58
4660,E02000376,2011,86,406000,321000,0,1,12,73,0,86,13,73
4661,E02000376,2012,86,474000,369000,0,1,19,66,1,85,20,66
4662,E02000376,2013,167,573000,412000,1,0,34,132,61,106,35,132
4663,E02000376,2014,39,531000,412000,0,1,4,34,3,36,5,34
4664,E02000377,2009,72,427000,335000,1,2,30,39,4,68,33,39
4665,E02000377,2010,85,499000,375000,0,6,30,49,1,84,38,47
4666,E02000377,2011,98,415000,332000,0,1,32,65,3,95,33,65
4667,E02000377,2012,98,472000,345000,1,3,23,71,4,94,27,71
4668,E02000377,2013,116,519000,383000,1,5,27,83,0,116,31,85
4669,E02000377,2014,37,563000,475000,0,1,6,30,0,37,7,30
4670,E02000378,2009,91,359000,290000,0,1,8,82,3,88,9,82
4671,E02000378,2010,119,458000,375000,0,0,14,105,0,119,15,104
4672,E02000378,2011,120,427000,300000,0,0,14,106,1,119,13,107
4673,E02000378,2012,99,464000,345000,0,0,8,91,0,99,6,93
4674,E02000378,2013,134,553000,453000,0,1,15,118,9,125,17,117
4675,E02000378,2014,63,595000,485000,0,0,10,53,1,62,7,56
4676,E02000379,2009,133,460000,340000,5,12,19,97,53,80,32,101
4677,E02000379,2010,113,484000,355000,1,9,18,85,37,76,28,85
4678,E02000379,2011,114,577000,424000,2,16,28,68,1,113,43,71
4679,E02000379,2012,87,614000,420000,1,7,18,61,3,84,25,62
4680,E02000379,2013,116,706000,480000,3,12,23,78,5,111,37,79
4681,E02000379,2014,42,626000,522000,0,3,11,28,1,41,13,29
4682,E02000380,2009,55,609000,618000,0,2,31,22,1,54,34,21
4683,E02000380,2010,84,790000,738000,0,4,55,25,0,84,59,25
4684,E02000380,2011,90,634000,650000,0,4,51,35,0,90,50,40
4685,E02000380,2012,97,796000,635000,0,1,48,48,1,96,49,48
4686,E02000380,2013,73,869000,750000,0,1,35,37,0,73,36,37
4687,E02000380,2014,22,920000,838000,0,0,11,11,0,22,11,11
4688,E02000381,2009,89,716000,440000,0,1,37,51,0,89,38,51
4689,E02000381,2010,140,859000,508000,1,2,56,81,0,140,58,82
4690,E02000381,2011,116,893000,558000,0,4,45,67,1,115,44,72
4691,E02000381,2012,97,841000,522000,1,0,28,68,0,97,28,69
4692,E02000381,2013,151,919000,606000,0,0,49,102,1,150,47,104
4693,E02000381,2014,37,798000,650000,0,0,7,30,0,37,7,30
4694,E02000382,2009,45,478000,400000,0,4,15,26,1,44,18,27
4695,E02000382,2010,69,576000,382000,1,3,23,42,0,69,26,43
4696,E02000382,2011,71,704000,495000,3,9,20,39,1,70,33,38
4697,E02000382,2012,81,728000,475000,1,7,24,49,4,77,32,49
4698,E02000382,2013,106,698000,415000,1,7,26,72,11,95,32,74
4699,E02000382,2014,31,674000,490000,1,0,5,25,4,27,6,25
4700,E02000383,2009,71,450000,364000,0,0,8,63,0,71,6,65
4701,E02000383,2010,121,457000,390000,0,0,7,114,0,121,6,115
4702,E02000383,2011,130,509000,390000,1,1,12,116,0,130,13,117
4703,E02000383,2012,119,524000,418000,0,0,1,118,11,108,1,118
4704,E02000383,2013,123,567000,440000,1,0,5,117,0,123,6,117
4705,E02000383,2014,48,595000,535000,1,0,2,45,0,48,1,47
4706,E02000384,2009,48,407000,307000,0,2,12,34,0,48,12,36
4707,E02000384,2010,77,482000,380000,0,2,21,54,1,76,23,54
4708,E02000384,2011,116,446000,365000,0,3,19,94,54,62,19,97
4709,E02000384,2012,57,615000,435000,1,0,17,39,0,57,18,39
4710,E02000384,2013,58,715000,518000,0,2,14,42,1,57,16,42
4711,E02000384,2014,18,818000,552000,0,1,4,13,0,18,5,13
4712,E02000385,2009,79,376000,350000,1,2,12,64,0,79,15,64
4713,E02000385,2010,95,430000,385000,0,0,13,82,2,93,13,82
4714,E02000385,2011,126,466000,424000,0,1,18,107,0,126,17,109
4715,E02000385,2012,115,479000,424000,2,0,10,103,0,115,9,106
4716,E02000385,2013,121,571000,473000,1,0,16,104,1,120,15,106
4717,E02000385,2014,37,696000,563000,0,0,7,30,0,37,7,30
4718,E02000386,2009,51,424000,332000,0,1,8,42,0,51,9,42
4719,E02000386,2010,59,449000,374000,0,0,13,46,1,58,12,47
4720,E02000386,2011,71,464000,380000,0,0,14,57,0,71,11,60
4721,E02000386,2012,90,406000,342000,0,0,10,80,17,73,8,82
4722,E02000386,2013,78,505000,439000,0,0,7,71,0,78,6,72
4723,E02000386,2014,26,545000,477000,0,0,2,24,2,24,2,24
4724,E02000387,2009,38,363000,305000,0,1,14,23,0,38,16,22
4725,E02000387,2010,61,471000,447000,0,0,28,33,0,61,28,33
4726,E02000387,2011,63,454000,405000,0,0,25,38,0,63,27,36
4727,E02000387,2012,66,502000,414000,0,0,24,42,0,66,24,42
4728,E02000387,2013,103,535000,480000,0,0,31,72,1,102,31,72
4729,E02000387,2014,17,535000,465000,0,0,4,13,1,16,4,13
4730,E02000388,2009,103,488000,425000,1,3,33,66,0,103,35,68
4731,E02000388,2010,120,588000,500000,0,3,38,79,0,120,41,79
4732,E02000388,2011,120,614000,500000,0,0,36,84,9,111,35,85
4733,E02000388,2012,129,613000,495000,0,3,38,88,4,125,39,90
4734,E02000388,2013,206,655000,558000,0,1,40,165,34,172,40,166
4735,E02000388,2014,52,809000,662000,0,0,15,37,0,52,13,39
4736,E02000389,2009,101,613000,545000,2,7,52,40,0,101,58,43
4737,E02000389,2010,141,673000,500000,0,4,54,83,0,141,58,83
4738,E02000389,2011,124,682000,545000,1,4,51,68,1,123,51,73
4739,E02000389,2012,108,693000,567000,0,1,44,63,0,108,44,64
4740,E02000389,2013,126,763000,658000,0,2,43,81,0,126,45,81
4741,E02000389,2014,42,855000,700000,0,0,14,28,0,42,13,29
4742,E02000390,2009,94,557000,547000,0,1,59,34,0,94,59,35
4743,E02000390,2010,129,630000,580000,0,2,70,57,1,128,71,58
4744,E02000390,2011,146,606000,500000,0,2,71,73,7,139,72,74
4745,E02000390,2012,115,691000,675000,0,0,63,52,0,115,61,54
4746,E02000390,2013,131,727000,660000,0,0,61,70,2,129,60,71
4747,E02000390,2014,45,897000,885000,0,1,21,23,0,45,22,23
4748,E02000391,2009,120,959000,700000,0,1,70,49,2,118,69,51
4749,E02000391,2010,144,914000,651000,0,2,73,69,0,144,72,72
4750,E02000391,2011,135,1181000,872000,2,1,74,58,3,132,74,61
4751,E02000391,2012,136,1185000,855000,1,1,74,60,2,134,72,64
4752,E02000391,2013,153,1330000,885000,0,2,72,79,1,152,71,82
4753,E02000391,2014,47,1476000,1295000,0,1,26,20,0,47,26,21
4754,E02000392,2009,125,680000,500000,0,7,51,67,2,123,58,67
4755,E02000392,2010,153,839000,650000,2,3,72,76,0,153,76,77
4756,E02000392,2011,161,759000,535000,1,1,60,99,0,161,62,99
4757,E02000392,2012,153,880000,583000,1,1,55,96,3,150,53,100
4758,E02000392,2013,168,1103000,818000,2,1,79,86,1,167,76,92
4759,E02000392,2014,47,912000,665000,0,1,11,35,0,47,13,34
4760,E02000393,2009,100,564000,478000,1,1,45,53,1,99,47,53
4761,E02000393,2010,143,644000,535000,0,0,69,74,1,142,68,75
4762,E02000393,2011,153,696000,544000,0,6,65,82,17,136,64,89
4763,E02000393,2012,134,766000,592000,1,0,53,80,0,134,52,82
4764,E02000393,2013,154,818000,650000,1,0,55,98,1,153,55,99
4765,E02000393,2014,52,979000,812000,0,0,22,30,0,52,19,33
4766,E02000394,2009,132,651000,525000,0,2,29,101,35,97,30,102
4767,E02000394,2010,179,580000,450000,0,0,21,158,40,139,20,159
4768,E02000394,2011,232,603000,469000,0,2,29,201,90,142,25,207
4769,E02000394,2012,282,676000,600000,0,0,23,259,128,154,18,264
4770,E02000394,2013,241,905000,740000,0,0,31,210,36,205,29,212
4771,E02000394,2014,78,877000,718000,1,0,9,68,6,72,8,70
4772,E02000395,2009,79,826000,650000,0,8,29,42,0,79,36,43
4773,E02000395,2010,109,846000,578000,0,10,28,71,1,108,38,71
4774,E02000395,2011,134,984000,630000,3,12,41,78,0,134,53,81
4775,E02000395,2012,117,917000,702000,0,10,29,78,0,117,40,77
4776,E02000395,2013,128,1115000,780000,1,15,26,86,0,128,44,84
4777,E02000395,2014,46,1391000,1092000,2,5,12,27,0,46,18,28
4778,E02000396,2009,85,738000,600000,1,1,50,33,0,85,49,36
4779,E02000396,2010,80,879000,695000,0,0,42,38,0,80,42,38
4780,E02000396,2011,100,951000,822000,0,1,59,40,1,99,61,39
4781,E02000396,2012,86,823000,558000,1,4,36,45,5,81,40,46
4782,E02000396,2013,112,1191000,935000,1,0,56,55,1,111,56,56
4783,E02000396,2014,35,1156000,998000,0,0,16,19,0,35,15,20
4784,E02000397,2009,64,216000,200000,0,4,14,46,0,64,16,48
4785,E02000397,2010,71,265000,250000,0,8,21,42,0,71,30,41
4786,E02000397,2011,56,289000,272000,2,9,13,32,0,56,23,33
4787,E02000397,2012,79,269000,245000,1,6,22,50,2,77,28,51
4788,E02000397,2013,85,311000,288000,0,5,29,51,0,85,29,56
4789,E02000397,2014,38,340000,319000,2,2,5,29,0,38,9,29
4790,E02000398,2009,33,181000,175000,0,3,17,13,0,33,21,12
4791,E02000398,2010,39,197000,196000,0,3,22,14,0,39,25,14
4792,E02000398,2011,28,174000,181000,0,0,14,14,0,28,14,14
4793,E02000398,2012,20,169000,164000,0,0,11,9,0,20,11,9
4794,E02000398,2013,33,181000,165000,0,0,14,19,1,32,13,20
4795,E02000398,2014,12,236000,260000,0,0,8,4,0,12,8,4
4796,E02000400,2009,60,316000,275000,1,10,22,27,4,56,32,28
4797,E02000400,2010,62,370000,358000,1,15,17,29,0,62,32,30
4798,E02000400,2011,58,381000,362000,0,15,15,28,1,57,29,29
4799,E02000400,2012,74,364000,356000,1,11,25,37,1,73,37,37
4800,E02000400,2013,76,364000,260000,1,12,12,51,0,76,23,53
4801,E02000400,2014,33,410000,322000,0,6,9,18,1,32,14,19
4802,E02000401,2009,22,193000,185000,0,0,19,3,0,22,18,4
4803,E02000401,2010,17,217000,238000,0,3,11,3,0,17,14,3
4804,E02000401,2011,34,220000,224000,0,5,25,4,0,34,30,4
4805,E02000401,2012,29,230000,230000,0,4,22,3,0,29,26,3
4806,E02000401,2013,25,241000,250000,0,3,17,5,0,25,19,6
4807,E02000401,2014,14,286000,281000,0,0,12,2,0,14,12,2
4808,E02000402,2009,17,192000,195000,0,3,11,3,0,17,14,3
4809,E02000402,2010,37,187000,205000,0,3,24,10,0,37,27,10
4810,E02000402,2011,23,201000,215000,0,3,15,5,0,23,18,5
4811,E02000402,2012,24,205000,205000,0,3,12,9,1,23,15,9
4812,E02000402,2013,28,200000,195000,0,4,11,13,0,28,15,13
4813,E02000402,2014,17,218000,210000,0,0,8,9,0,17,7,10
4814,E02000403,2009,47,273000,248000,0,2,22,23,0,47,25,22
4815,E02000403,2010,47,281000,250000,0,4,17,26,0,47,20,27
4816,E02000403,2011,76,314000,292000,0,7,45,24,0,76,47,29
4817,E02000403,2012,62,287000,250000,0,6,23,33,1,61,28,34
4818,E02000403,2013,71,300000,262000,0,6,20,45,0,71,24,47
4819,E02000403,2014,31,336000,295000,0,2,10,19,0,31,11,20
4820,E02000404,2009,36,221000,226000,0,0,25,11,0,36,25,11
4821,E02000404,2010,43,233000,232000,0,2,24,17,0,43,25,18
4822,E02000404,2011,49,243000,250000,0,2,31,16,0,49,33,16
4823,E02000404,2012,50,262000,264000,0,0,29,21,2,48,29,21
4824,E02000404,2013,58,276000,276000,0,1,29,28,5,53,29,29
4825,E02000404,2014,23,300000,303000,0,1,12,10,0,23,13,10
4826,E02000405,2009,63,442000,345000,2,5,23,33,0,63,27,36
4827,E02000405,2010,76,471000,378000,2,9,26,39,0,76,36,40
4828,E02000405,2011,104,533000,500000,6,11,41,46,0,104,54,50
4829,E02000405,2012,86,530000,401000,5,10,26,45,0,86,38,48
4830,E02000405,2013,91,664000,560000,2,9,41,39,0,91,48,43
4831,E02000405,2014,26,724000,601000,1,2,12,11,0,26,13,13
4832,E02000406,2009,44,233000,238000,0,1,29,14,5,39,29,15
4833,E02000406,2010,50,260000,277000,0,2,36,12,1,49,37,13
4834,E02000406,2011,58,254000,250000,0,1,41,16,0,58,41,17
4835,E02000406,2012,44,273000,257000,0,0,34,10,0,44,32,12
4836,E02000406,2013,67,283000,280000,0,0,45,22,0,67,44,23
4837,E02000406,2014,30,330000,314000,0,1,20,9,0,30,21,9
4838,E02000407,2009,34,182000,170000,0,0,17,17,0,34,13,21
4839,E02000407,2010,47,215000,200000,0,3,22,22,0,47,25,22
4840,E02000407,2011,52,191000,165000,1,0,27,24,0,52,26,26
4841,E02000407,2012,45,200000,190000,0,0,20,25,0,45,20,25
4842,E02000407,2013,50,234000,221000,0,0,21,29,0,50,22,28
4843,E02000407,2014,23,256000,239000,0,0,11,12,0,23,11,12
4844,E02000408,2009,35,183000,180000,1,1,24,9,0,35,26,9
4845,E02000408,2010,35,203000,210000,0,2,23,10,0,35,23,12
4846,E02000408,2011,25,207000,212000,0,1,21,3,0,25,22,3
4847,E02000408,2012,21,180000,175000,0,1,11,9,0,21,11,10
4848,E02000408,2013,32,225000,246000,0,0,20,12,0,32,20,12
4849,E02000408,2014,13,253000,250000,0,1,11,1,0,13,12,1
4850,E02000409,2009,27,269000,250000,1,0,21,5,0,27,22,5
4851,E02000409,2010,34,270000,272000,0,0,25,9,1,33,26,8
4852,E02000409,2011,23,294000,297000,0,1,16,6,0,23,17,6
4853,E02000409,2012,30,276000,276000,0,1,18,11,0,30,19,11
4854,E02000409,2013,44,278000,274000,0,0,25,19,0,44,22,22
4855,E02000409,2014,8,314000,294000,0,0,3,5,0,8,3,5
4856,E02000410,2009,66,511000,385000,1,11,18,36,0,66,29,37
4857,E02000410,2010,93,601000,430000,2,8,29,54,0,93,38,55
4858,E02000410,2011,83,551000,400000,0,8,26,49,0,83,31,52
4859,E02000410,2012,88,576000,356000,0,8,25,55,1,87,31,57
4860,E02000410,2013,97,721000,485000,3,14,19,61,6,91,33,64
4861,E02000410,2014,49,580000,420000,0,1,10,38,0,49,10,39
4862,E02000411,2009,33,184000,182000,0,2,19,12,0,33,21,12
4863,E02000411,2010,52,186000,197000,1,1,26,24,0,52,28,24
4864,E02000411,2011,52,190000,192000,0,1,28,23,0,52,30,22
4865,E02000411,2012,100,212000,224000,0,0,17,83,71,29,17,83
4866,E02000411,2013,95,222000,228000,1,0,20,74,48,47,21,74
4867,E02000411,2014,25,249000,240000,0,2,11,12,0,25,12,13
4868,E02000412,2009,45,229000,220000,0,4,17,24,18,27,21,24
4869,E02000412,2010,41,252000,248000,0,3,12,26,1,40,15,26
4870,E02000412,2011,59,263000,235000,0,3,17,39,12,47,20,39
4871,E02000412,2012,27,288000,250000,0,0,12,15,0,27,12,15
4872,E02000412,2013,57,327000,305000,1,3,24,29,0,57,28,29
4873,E02000412,2014,18,353000,329000,0,2,5,11,0,18,6,12
4874,E02000413,2009,89,411000,289000,3,13,20,53,35,54,34,55
4875,E02000413,2010,112,571000,380000,9,18,29,56,22,90,54,58
4876,E02000413,2011,80,660000,450000,3,14,26,37,0,80,41,39
4877,E02000413,2012,79,777000,603000,7,19,19,34,0,79,45,34
4878,E02000413,2013,113,591000,435000,4,7,37,65,26,87,47,66
4879,E02000413,2014,24,763000,520000,0,5,8,11,0,24,12,12
4880,E02000414,2009,51,225000,230000,0,1,40,10,0,51,41,10
4881,E02000414,2010,77,220000,230000,1,3,50,23,0,77,52,25
4882,E02000414,2011,52,237000,242000,0,1,39,12,0,52,38,14
4883,E02000414,2012,41,252000,250000,0,0,30,11,0,41,27,14
4884,E02000414,2013,53,283000,270000,0,0,39,14,0,53,36,17
4885,E02000414,2014,28,298000,275000,0,0,12,16,0,28,11,17
4886,E02000415,2009,41,236000,245000,0,1,20,20,0,41,22,19
4887,E02000415,2010,40,285000,258000,0,0,25,15,0,40,25,15
4888,E02000415,2011,53,285000,280000,0,0,34,19,2,51,32,21
4889,E02000415,2012,58,296000,279000,0,1,32,25,0,58,31,27
4890,E02000415,2013,67,323000,295000,1,0,33,33,1,66,33,34
4891,E02000415,2014,33,335000,313000,0,0,12,21,0,33,11,22
4892,E02000416,2009,60,282000,258000,0,3,12,45,1,59,14,46
4893,E02000416,2010,99,339000,294000,0,4,19,76,1,98,21,78
4894,E02000416,2011,94,318000,250000,0,2,18,74,1,93,18,76
4895,E02000416,2012,100,341000,319000,0,1,21,78,0,100,20,80
4896,E02000416,2013,141,347000,295000,1,1,26,113,0,141,26,115
4897,E02000416,2014,36,378000,312000,0,0,4,32,0,36,4,32
4898,E02000417,2009,68,623000,492000,1,9,26,32,1,67,34,34
4899,E02000417,2010,96,529000,364000,0,16,23,57,1,95,35,61
4900,E02000417,2011,66,598000,395000,2,9,16,39,0,66,26,40
4901,E02000417,2012,85,630000,435000,1,7,24,53,0,85,29,56
4902,E02000417,2013,106,763000,534000,3,17,26,60,0,106,44,62
4903,E02000417,2014,33,918000,680000,2,4,9,18,0,33,14,19
4904,E02000418,2009,72,496000,482000,0,11,32,29,0,72,41,31
4905,E02000418,2010,68,516000,443000,1,5,29,33,0,68,34,34
4906,E02000418,2011,73,601000,600000,2,8,38,25,9,64,45,28
4907,E02000418,2012,101,582000,480000,0,8,40,53,25,76,45,56
4908,E02000418,2013,90,748000,790000,0,7,51,32,0,90,57,33
4909,E02000418,2014,23,893000,1065000,0,3,11,9,0,23,14,9
4910,E02000419,2009,49,292000,258000,0,6,21,22,0,49,22,27
4911,E02000419,2010,89,315000,272000,0,7,33,49,1,88,40,49
4912,E02000419,2011,72,335000,299000,1,5,31,35,0,72,34,38
4913,E02000419,2012,102,381000,324000,0,6,51,45,1,101,54,48
4914,E02000419,2013,71,400000,355000,0,2,33,36,0,71,30,41
4915,E02000419,2014,33,491000,450000,0,4,15,14,0,33,18,15
4916,E02000420,2009,39,223000,210000,1,1,21,16,1,38,23,16
4917,E02000420,2010,44,216000,235000,0,2,28,14,0,44,30,14
4918,E02000420,2011,52,238000,231000,0,3,34,15,5,47,37,15
4919,E02000420,2012,46,244000,238000,0,2,27,17,2,44,29,17
4920,E02000420,2013,52,262000,272000,0,3,33,16,1,51,35,17
4921,E02000420,2014,20,323000,341000,0,0,13,7,1,19,13,7
4922,E02000421,2009,28,197000,195000,0,3,9,16,2,26,14,14
4923,E02000421,2010,24,168000,161000,0,0,6,18,0,24,6,18
4924,E02000421,2011,34,180000,170000,0,0,9,25,1,33,8,26
4925,E02000421,2012,34,210000,196000,0,0,10,24,0,34,11,23
4926,E02000421,2013,38,216000,212000,0,0,10,28,1,37,10,28
4927,E02000421,2014,12,314000,352000,0,0,8,4,1,11,7,5
4928,E02000422,2009,27,197000,183000,0,2,17,8,1,26,18,9
4929,E02000422,2010,59,232000,228000,0,1,40,18,0,59,39,20
4930,E02000422,2011,53,239000,245000,0,0,33,20,0,53,34,19
4931,E02000422,2012,52,261000,248000,0,0,31,21,0,52,29,23
4932,E02000422,2013,57,278000,300000,0,0,33,24,0,57,30,27
4933,E02000422,2014,24,304000,298000,0,1,10,13,0,24,11,13
4934,E02000423,2009,48,262000,250000,0,0,29,19,0,48,29,19
4935,E02000423,2010,50,268000,250000,0,4,24,22,0,50,24,26
4936,E02000423,2011,51,291000,305000,0,2,32,17,0,51,34,17
4937,E02000423,2012,57,309000,278000,0,0,33,24,0,57,32,25
4938,E02000423,2013,70,335000,328000,0,2,39,29,1,69,40,30
4939,E02000423,2014,28,400000,402000,1,2,13,12,2,26,16,12
4940,E02000424,2009,80,380000,311000,0,3,23,54,0,80,24,56
4941,E02000424,2010,95,462000,372000,0,1,33,61,1,94,33,62
4942,E02000424,2011,98,457000,335000,1,3,31,63,0,98,32,66
4943,E02000424,2012,115,459000,360000,2,1,31,81,0,115,32,83
4944,E02000424,2013,119,519000,445000,0,5,32,82,2,117,34,85
4945,E02000424,2014,28,619000,459000,0,0,9,19,0,28,8,20
4946,E02000425,2009,22,269000,264000,0,1,16,5,0,22,17,5
4947,E02000425,2010,25,336000,350000,0,3,19,3,0,25,22,3
4948,E02000425,2011,34,341000,350000,0,1,27,6,0,34,28,6
4949,E02000425,2012,38,296000,242000,0,3,19,16,2,36,20,18
4950,E02000425,2013,30,366000,375000,0,2,20,8,0,30,22,8
4951,E02000425,2014,9,288000,240000,0,0,3,6,0,9,3,6
4952,E02000426,2009,91,632000,380000,5,6,21,59,0,91,32,59
4953,E02000426,2010,83,898000,495000,8,9,23,43,0,83,39,44
4954,E02000426,2011,80,931000,490000,6,8,17,49,0,80,31,49
4955,E02000426,2012,73,796000,468000,6,7,8,52,0,73,22,51
4956,E02000426,2013,112,1224000,590000,15,7,26,64,0,112,48,64
4957,E02000426,2014,36,1291000,549000,4,3,9,20,0,36,16,20
4958,E02000427,2009,54,291000,247000,0,2,19,33,0,54,22,32
4959,E02000427,2010,74,325000,290000,0,2,25,47,0,74,25,49
4960,E02000427,2011,52,346000,312000,0,1,23,28,0,52,21,31
4961,E02000427,2012,80,404000,340000,0,4,33,43,0,80,36,44
4962,E02000427,2013,80,420000,355000,2,0,35,43,0,80,34,46
4963,E02000427,2014,32,449000,398000,0,0,12,20,0,32,12,20
4964,E02000428,2009,31,186000,195000,1,0,8,22,2,29,9,22
4965,E02000428,2010,46,230000,227000,0,0,16,30,0,46,15,31
4966,E02000428,2011,54,245000,244000,1,0,25,28,0,54,21,33
4967,E02000428,2012,42,264000,246000,0,0,18,24,0,42,18,24
4968,E02000428,2013,41,269000,280000,0,0,9,32,0,41,8,33
4969,E02000428,2014,18,298000,264000,0,0,6,12,0,18,5,13
4970,E02000429,2009,95,433000,375000,0,8,14,73,1,94,22,73
4971,E02000429,2010,133,554000,405000,4,8,22,99,1,132,35,98
4972,E02000429,2011,128,581000,429000,3,7,22,96,1,127,31,97
4973,E02000429,2012,145,520000,439000,2,10,21,112,25,120,33,112
4974,E02000429,2013,115,733000,485000,7,9,15,84,0,115,30,85
4975,E02000429,2014,50,628000,528000,0,1,8,41,9,41,8,42
4976,E02000430,2009,92,379000,303000,1,6,15,70,3,89,23,69
4977,E02000430,2010,118,468000,366000,1,11,20,86,11,107,29,89
4978,E02000430,2011,124,495000,359000,2,11,30,81,1,123,40,84
4979,E02000430,2012,116,476000,375000,0,7,21,88,1,115,23,93
4980,E02000430,2013,131,554000,448000,8,4,18,101,1,130,26,105
4981,E02000430,2014,27,628000,485000,0,2,4,21,0,27,6,21
4982,E02000431,2009,97,572000,422000,1,11,25,60,0,97,34,63
4983,E02000431,2010,126,515000,388000,4,5,21,96,0,126,27,99
4984,E02000431,2011,109,563000,427000,2,7,9,91,0,109,17,92
4985,E02000431,2012,125,542000,388000,0,0,20,105,1,124,16,109
4986,E02000431,2013,128,720000,528000,7,7,22,92,4,124,34,94
4987,E02000431,2014,34,824000,567000,1,3,5,25,0,34,8,26
4988,E02000432,2009,55,367000,310000,0,3,14,38,0,55,16,39
4989,E02000432,2010,90,396000,322000,2,8,14,66,0,90,21,69
4990,E02000432,2011,101,387000,315000,0,7,17,77,0,101,22,79
4991,E02000432,2012,97,386000,350000,0,1,12,84,2,95,12,85
4992,E02000432,2013,104,447000,372000,0,1,18,85,2,102,19,85
4993,E02000432,2014,30,461000,440000,0,0,4,26,1,29,4,26
4994,E02000433,2009,62,490000,305000,21,2,2,37,0,62,26,36
4995,E02000433,2010,100,517000,365000,30,6,8,56,5,95,42,58
4996,E02000433,2011,96,553000,380000,31,7,8,50,1,95,43,53
4997,E02000433,2012,107,545000,375000,30,10,9,58,5,102,49,58
4998,E02000433,2013,147,692000,495000,40,15,15,77,24,123,69,78
4999,E02000433,2014,54,708000,498000,14,5,10,25,8,46,27,27
5000,E02000434,2009,76,343000,321000,12,31,4,29,6,70,47,29
5001,E02000434,2010,115,352000,305000,9,25,5,76,52,63,38,77
5002,E02000434,2011,128,335000,300000,11,29,5,83,48,80,45,83
5003,E02000434,2012,115,388000,340000,14,26,4,71,35,80,46,69
5004,E02000434,2013,175,381000,355000,19,37,11,108,66,109,67,108
5005,E02000434,2014,56,408000,380000,7,8,1,40,12,44,16,40
5006,E02000435,2009,58,352000,327000,10,19,11,18,0,58,38,20
5007,E02000435,2010,68,334000,304000,2,22,24,20,0,68,44,24
5008,E02000435,2011,56,394000,335000,9,22,12,13,0,56,42,14
5009,E02000435,2012,85,395000,331000,9,32,16,28,17,68,55,30
5010,E02000435,2013,91,435000,370000,12,32,14,33,0,91,56,35
5011,E02000435,2014,30,427000,334000,2,12,3,13,0,30,15,15
5012,E02000436,2009,54,462000,439000,22,23,1,8,0,54,46,8
5013,E02000436,2010,51,570000,513000,23,19,4,5,0,51,46,5
5014,E02000436,2011,50,505000,468000,19,19,3,9,0,50,41,9
5015,E02000436,2012,53,559000,495000,26,19,3,5,0,53,48,5
5016,E02000436,2013,69,547000,475000,31,27,2,9,0,69,60,9
5017,E02000436,2014,24,592000,590000,9,11,1,3,0,24,21,3
5018,E02000437,2009,83,300000,290000,11,32,15,25,11,72,58,25
5019,E02000437,2010,84,320000,304000,12,52,13,7,0,84,78,6
5020,E02000437,2011,86,300000,278000,17,41,7,21,0,86,65,21
5021,E02000437,2012,79,346000,325000,12,36,14,17,4,75,61,18
5022,E02000437,2013,95,331000,308000,11,49,11,24,1,94,70,25
5023,E02000437,2014,26,350000,352000,1,13,6,6,0,26,19,7
5024,E02000438,2009,84,291000,220000,8,27,10,39,8,76,46,38
5025,E02000438,2010,101,362000,275000,14,29,14,44,8,93,56,45
5026,E02000438,2011,72,379000,250000,10,32,9,21,2,70,50,22
5027,E02000438,2012,96,327000,261000,9,23,10,54,9,87,42,54
5028,E02000438,2013,91,364000,276000,13,23,7,48,1,90,44,47
5029,E02000438,2014,32,366000,288000,3,9,5,15,0,32,17,15
5030,E02000439,2009,45,246000,250000,0,31,5,9,0,45,35,10
5031,E02000439,2010,38,265000,283000,1,25,3,9,0,38,29,9
5032,E02000439,2011,69,256000,278000,1,44,5,19,3,66,52,17
5033,E02000439,2012,51,286000,305000,0,29,4,18,11,40,33,18
5034,E02000439,2013,54,301000,326000,1,35,7,11,0,54,43,11
5035,E02000439,2014,31,297000,250000,0,15,12,4,0,31,27,4
5036,E02000440,2009,79,308000,290000,4,46,14,15,7,72,64,15
5037,E02000440,2010,92,411000,371000,15,55,13,9,3,89,84,8
5038,E02000440,2011,84,408000,373000,14,51,12,7,0,84,77,7
5039,E02000440,2012,67,397000,370000,7,44,9,7,0,67,60,7
5040,E02000440,2013,86,404000,380000,8,52,19,7,0,86,78,8
5041,E02000440,2014,33,403000,420000,1,18,9,5,0,33,28,5
5042,E02000441,2009,71,328000,290000,14,20,7,30,0,71,41,30
5043,E02000441,2010,90,346000,271000,19,17,16,38,0,90,52,38
5044,E02000441,2011,77,463000,340000,28,13,8,28,0,77,49,28
5045,E02000441,2012,84,436000,308000,21,19,12,32,8,76,52,32
5046,E02000441,2013,93,394000,300000,24,12,11,46,1,92,47,46
5047,E02000441,2014,24,489000,432000,8,4,2,10,0,24,13,11
5048,E02000442,2009,39,255000,250000,0,17,19,3,2,37,36,3
5049,E02000442,2010,76,268000,274000,0,21,45,10,1,75,64,12
5050,E02000442,2011,50,280000,279000,0,18,29,3,0,50,47,3
5051,E02000442,2012,46,285000,292000,0,16,25,5,0,46,41,5
5052,E02000442,2013,43,309000,309000,1,16,23,3,0,43,40,3
5053,E02000442,2014,28,355000,356000,0,12,16,0,0,28,28,0
5054,E02000443,2009,52,221000,237000,0,17,23,12,0,52,40,12
5055,E02000443,2010,79,240000,248000,1,21,38,19,0,79,59,20
5056,E02000443,2011,83,251000,250000,1,25,36,21,7,76,62,21
5057,E02000443,2012,78,247000,250000,1,21,33,23,1,77,55,23
5058,E02000443,2013,80,261000,250000,1,15,25,39,11,69,41,39
5059,E02000443,2014,42,301000,316000,2,12,16,12,1,41,30,12
5060,E02000444,2009,43,282000,288000,1,25,9,8,0,43,36,7
5061,E02000444,2010,71,277000,304000,1,32,10,28,1,70,43,28
5062,E02000444,2011,54,283000,298000,2,24,9,19,0,54,35,19
5063,E02000444,2012,43,344000,335000,6,26,3,8,0,43,35,8
5064,E02000444,2013,67,353000,360000,2,47,6,12,0,67,54,13
5065,E02000444,2014,17,423000,414000,1,13,2,1,0,17,16,1
5066,E02000445,2009,62,244000,238000,3,14,24,21,0,62,41,21
5067,E02000445,2010,119,216000,205000,0,22,34,63,25,94,56,63
5068,E02000445,2011,86,241000,244000,1,19,32,34,3,83,52,34
5069,E02000445,2012,75,252000,247000,2,19,28,26,1,74,49,26
5070,E02000445,2013,108,258000,248000,5,25,28,50,17,91,56,52
5071,E02000445,2014,41,268000,270000,3,6,11,21,5,36,19,22
5072,E02000447,2009,60,283000,292000,1,34,10,15,0,60,45,15
5073,E02000447,2010,51,356000,350000,8,24,12,7,1,50,44,7
5074,E02000447,2011,72,344000,365000,9,38,8,17,4,68,55,17
5075,E02000447,2012,66,347000,365000,2,36,12,16,4,62,50,16
5076,E02000447,2013,89,350000,369000,7,50,13,19,10,79,70,19
5077,E02000447,2014,21,373000,390000,0,13,1,7,0,21,14,7
5078,E02000448,2009,70,406000,358000,25,9,6,30,1,69,39,31
5079,E02000448,2010,97,507000,489000,35,22,10,30,0,97,63,34
5080,E02000448,2011,76,630000,608000,31,20,6,19,5,71,55,21
5081,E02000448,2012,75,491000,470000,22,20,7,26,0,75,47,28
5082,E02000448,2013,89,509000,440000,24,12,14,39,0,89,49,40
5083,E02000448,2014,48,511000,408000,14,5,3,26,1,47,20,28
5084,E02000449,2009,44,265000,250000,0,8,34,2,6,38,42,2
5085,E02000449,2010,40,278000,282000,0,7,25,8,6,34,33,7
5086,E02000449,2011,32,278000,281000,1,7,20,4,0,32,28,4
5087,E02000449,2012,40,297000,305000,0,5,32,3,0,40,37,3
5088,E02000449,2013,34,305000,312000,0,4,24,6,0,34,28,6
5089,E02000449,2014,12,308000,307000,0,2,6,4,0,12,8,4
5090,E02000451,2009,61,313000,302000,7,26,18,10,0,61,49,12
5091,E02000451,2010,74,376000,383000,14,34,12,14,0,74,58,16
5092,E02000451,2011,59,351000,364000,6,28,15,10,0,59,46,13
5093,E02000451,2012,53,361000,377000,8,23,7,15,0,53,38,15
5094,E02000451,2013,79,412000,420000,14,42,9,14,0,79,63,16
5095,E02000451,2014,20,442000,460000,4,10,5,1,0,20,18,2
5096,E02000452,2009,63,245000,225000,0,20,8,35,0,63,29,34
5097,E02000452,2010,85,255000,235000,0,28,10,47,0,85,36,49
5098,E02000452,2011,64,252000,229000,2,13,9,40,0,64,23,41
5099,E02000452,2012,73,254000,227000,3,21,6,43,4,69,28,45
5100,E02000452,2013,94,258000,242000,3,20,13,58,6,88,35,59
5101,E02000452,2014,34,270000,236000,2,7,2,23,0,34,9,25
5102,E02000453,2009,61,252000,250000,3,19,14,25,0,61,35,26
5103,E02000453,2010,78,266000,249000,1,25,16,36,0,78,41,37
5104,E02000453,2011,90,271000,250000,1,17,19,53,28,62,36,54
5105,E02000453,2012,154,244000,226000,3,16,23,112,80,74,41,113
5106,E02000453,2013,101,279000,249000,1,18,22,60,7,94,41,60
5107,E02000453,2014,32,335000,300000,1,7,8,16,0,32,14,18
5108,E02000454,2009,66,362000,352000,11,28,12,15,0,66,52,14
5109,E02000454,2010,86,413000,402000,19,42,15,10,0,86,76,10
5110,E02000454,2011,80,427000,395000,13,47,11,9,0,80,68,12
5111,E02000454,2012,86,456000,449000,18,49,10,9,0,86,76,10
5112,E02000454,2013,96,484000,468000,18,57,11,10,0,96,86,10
5113,E02000454,2014,25,494000,480000,5,14,2,4,0,25,21,4
5114,E02000455,2009,75,257000,235000,2,17,8,48,3,72,26,49
5115,E02000455,2010,89,262000,245000,3,15,8,63,3,86,24,65
5116,E02000455,2011,79,269000,238000,4,14,7,54,1,78,25,54
5117,E02000455,2012,73,293000,250000,3,15,12,43,1,72,30,43
5118,E02000455,2013,121,297000,250000,6,15,8,92,13,108,29,92
5119,E02000455,2014,34,309000,264000,2,3,1,28,5,29,6,28
5120,E02000456,2009,44,251000,270000,1,14,16,13,0,44,32,12
5121,E02000456,2010,61,306000,322000,1,21,24,15,0,61,44,17
5122,E02000456,2011,63,295000,316000,2,17,23,21,0,63,42,21
5123,E02000456,2012,69,302000,310000,3,18,29,19,5,64,48,21
5124,E02000456,2013,77,333000,350000,3,26,26,22,4,73,52,25
5125,E02000456,2014,20,346000,370000,1,10,3,6,0,20,13,7
5126,E02000457,2009,56,321000,320000,9,36,4,7,0,56,49,7
5127,E02000457,2010,43,364000,350000,11,25,4,3,0,43,40,3
5128,E02000457,2011,60,351000,370000,8,38,4,10,1,59,50,10
5129,E02000457,2012,53,374000,352000,10,37,3,3,0,53,50,3
5130,E02000457,2013,60,394000,423000,4,45,1,10,2,58,50,10
5131,E02000457,2014,19,401000,421000,2,12,2,3,0,19,16,3
5132,E02000459,2009,171,192000,181000,2,13,18,138,113,58,33,138
5133,E02000459,2010,84,236000,222000,4,12,23,45,10,74,38,46
5134,E02000459,2011,89,264000,242000,3,22,25,39,6,83,50,39
5135,E02000459,2012,94,243000,205000,3,13,22,56,5,89,38,56
5136,E02000459,2013,110,252000,228000,3,19,30,58,3,107,48,62
5137,E02000459,2014,31,298000,250000,1,3,5,22,0,31,8,23
5138,E02000460,2009,58,223000,209000,0,8,23,27,17,41,30,28
5139,E02000460,2010,52,238000,242000,0,5,24,23,15,37,30,22
5140,E02000460,2011,57,233000,226000,0,8,17,32,20,37,24,33
5141,E02000460,2012,69,253000,232000,1,9,27,32,33,36,37,32
5142,E02000460,2013,58,264000,249000,1,6,29,22,12,46,36,22
5143,E02000460,2014,15,341000,350000,1,1,11,2,0,15,13,2
5144,E02000461,2009,67,301000,265000,3,9,19,36,2,65,26,41
5145,E02000461,2010,76,353000,320000,5,12,17,42,1,75,34,42
5146,E02000461,2011,68,413000,316000,10,9,15,34,0,68,33,35
5147,E02000461,2012,81,357000,320000,4,9,16,52,0,81,29,52
5148,E02000461,2013,100,370000,325000,8,8,23,61,0,100,37,63
5149,E02000461,2014,44,413000,365000,5,3,10,26,0,44,18,26
5150,E02000462,2009,42,225000,244000,1,16,13,12,0,42,31,11
5151,E02000462,2010,58,265000,276000,3,28,15,12,3,55,46,12
5152,E02000462,2011,65,240000,250000,1,21,20,23,5,60,41,24
5153,E02000462,2012,62,244000,252000,0,14,24,24,12,50,38,24
5154,E02000462,2013,52,275000,308000,1,20,16,15,2,50,37,15
5155,E02000462,2014,20,269000,274000,1,3,6,10,2,18,10,10
5156,E02000463,2009,53,224000,240000,0,19,26,8,0,53,44,9
5157,E02000463,2010,56,271000,274000,1,19,29,7,0,56,50,6
5158,E02000463,2011,59,260000,250000,0,18,31,10,5,54,49,10
5159,E02000463,2012,50,262000,261000,1,20,21,8,1,49,41,9
5160,E02000463,2013,56,267000,274000,0,14,31,11,0,56,45,11
5161,E02000463,2014,21,311000,315000,0,8,10,3,0,21,18,3
5162,E02000464,2009,71,166000,158000,1,11,32,27,28,43,44,27
5163,E02000464,2010,54,200000,168000,2,18,18,16,9,45,38,16
5164,E02000464,2011,53,216000,182000,4,19,26,4,0,53,49,4
5165,E02000464,2012,51,203000,180000,4,16,26,5,0,51,46,5
5166,E02000464,2013,157,213000,202000,6,34,87,30,84,73,127,30
5167,E02000464,2014,47,239000,218000,2,11,34,0,24,23,46,1
5168,E02000465,2009,46,170000,170000,0,18,24,4,0,46,42,4
5169,E02000465,2010,56,177000,172000,1,23,27,5,0,56,51,5
5170,E02000465,2011,76,169000,168000,4,25,37,10,1,75,66,10
5171,E02000465,2012,71,178000,178000,0,18,47,6,0,71,64,7
5172,E02000465,2013,83,185000,185000,0,24,48,11,2,81,72,11
5173,E02000465,2014,23,200000,195000,0,5,16,2,0,23,21,2
5174,E02000466,2009,68,206000,181000,8,19,24,17,1,67,49,19
5175,E02000466,2010,82,225000,211000,12,36,11,23,1,81,59,23
5176,E02000466,2011,65,236000,195000,3,27,18,17,1,64,48,17
5177,E02000466,2012,87,208000,200000,7,39,21,20,0,87,66,21
5178,E02000466,2013,103,233000,220000,10,55,28,10,0,103,93,10
5179,E02000466,2014,34,251000,240000,5,18,8,3,1,33,31,3
5180,E02000467,2009,83,152000,150000,0,16,43,24,24,59,59,24
5181,E02000467,2010,40,152000,160000,0,10,22,8,0,40,32,8
5182,E02000467,2011,62,148000,151000,0,13,40,9,0,62,53,9
5183,E02000467,2012,69,153000,155000,0,17,39,13,0,69,56,13
5184,E02000467,2013,81,161000,169000,0,22,39,20,1,80,60,21
5185,E02000467,2014,30,189000,194000,0,8,18,4,0,30,26,4
5186,E02000468,2009,82,199000,194000,2,38,34,8,2,80,76,6
5187,E02000468,2010,83,225000,218000,9,40,32,2,0,83,81,2
5188,E02000468,2011,78,216000,210000,5,32,39,2,0,78,76,2
5189,E02000468,2012,85,218000,208000,7,38,33,7,2,83,77,8
5190,E02000468,2013,99,222000,222000,10,44,40,5,1,98,94,5
5191,E02000468,2014,27,251000,248000,2,13,10,2,0,27,25,2
5192,E02000469,2009,41,169000,165000,4,15,17,5,0,41,37,4
5193,E02000469,2010,52,182000,176000,4,17,24,7,0,52,45,7
5194,E02000469,2011,57,173000,170000,4,14,29,10,0,57,48,9
5195,E02000469,2012,52,184000,172000,7,11,28,6,4,48,46,6
5196,E02000469,2013,68,191000,186000,5,22,35,6,0,68,61,7
5197,E02000469,2014,22,195000,196000,0,9,10,3,0,22,19,3
5198,E02000470,2009,92,220000,210000,11,44,21,16,1,91,77,15
5199,E02000470,2010,116,224000,224000,6,49,43,18,0,116,97,19
5200,E02000470,2011,106,229000,226000,14,48,28,16,0,106,89,17
5201,E02000470,2012,105,234000,235000,14,51,27,13,0,105,90,15
5202,E02000470,2013,167,272000,245000,11,65,51,40,38,129,127,40
5203,E02000470,2014,69,336000,295000,7,24,29,9,22,47,59,10
5204,E02000471,2009,78,261000,250000,9,52,13,4,0,78,74,4
5205,E02000471,2010,84,297000,270000,8,53,20,3,0,84,81,3
5206,E02000471,2011,79,294000,265000,4,55,18,2,1,78,77,2
5207,E02000471,2012,77,284000,271000,7,53,15,2,3,74,75,2
5208,E02000471,2013,109,314000,285000,14,73,18,4,0,109,105,4
5209,E02000471,2014,44,315000,292000,5,31,6,2,0,44,42,2
5210,E02000472,2009,97,201000,198000,4,31,48,14,3,94,83,14
5211,E02000472,2010,105,213000,215000,8,42,40,15,0,105,90,15
5212,E02000472,2011,101,213000,210000,8,31,48,14,0,101,85,16
5213,E02000472,2012,92,234000,231000,5,31,45,11,2,90,81,11
5214,E02000472,2013,133,231000,232000,9,48,59,17,0,133,115,18
5215,E02000472,2014,37,262000,250000,2,12,21,2,0,37,35,2
5216,E02000473,2009,100,220000,220000,6,33,42,19,6,94,82,18
5217,E02000473,2010,120,261000,250000,15,46,44,15,0,120,105,15
5218,E02000473,2011,107,252000,245000,13,50,29,15,0,107,92,15
5219,E02000473,2012,133,262000,245000,17,52,34,30,14,119,103,30
5220,E02000473,2013,131,264000,250000,11,56,41,23,4,127,108,23
5221,E02000473,2014,52,292000,272000,3,24,19,6,0,52,46,6
5222,E02000474,2009,103,176000,170000,4,26,30,43,30,73,60,43
5223,E02000474,2010,109,205000,205000,9,36,47,17,2,107,92,17
5224,E02000474,2011,119,197000,198000,7,27,45,40,19,100,79,40
5225,E02000474,2012,91,193000,195000,6,24,31,30,4,87,60,31
5226,E02000474,2013,123,217000,225000,7,44,44,28,0,123,95,28
5227,E02000474,2014,50,222000,231000,4,12,21,13,0,50,36,14
5228,E02000475,2009,97,295000,262000,16,27,12,42,12,85,54,43
5229,E02000475,2010,130,363000,312000,46,30,9,45,10,120,83,47
5230,E02000475,2011,131,333000,300000,36,38,13,44,1,130,85,46
5231,E02000475,2012,96,329000,250000,22,30,10,34,0,96,61,35
5232,E02000475,2013,164,319000,280000,39,42,5,78,11,153,87,77
5233,E02000475,2014,62,302000,240000,10,13,5,34,0,62,27,35
5234,E02000476,2009,144,177000,159000,3,20,15,106,54,90,38,106
5235,E02000476,2010,142,198000,180000,4,17,25,96,26,116,46,96
5236,E02000476,2011,85,189000,168000,6,18,7,54,3,82,28,57
5237,E02000476,2012,109,192000,170000,4,23,13,69,9,100,40,69
5238,E02000476,2013,111,202000,176000,5,20,18,68,2,109,43,68
5239,E02000476,2014,53,242000,213000,5,19,3,26,0,53,26,27
5240,E02000477,2009,118,255000,240000,15,41,46,16,8,110,102,16
5241,E02000477,2010,120,280000,250000,17,43,40,20,1,119,102,18
5242,E02000477,2011,119,289000,280000,17,51,39,12,10,109,106,13
5243,E02000477,2012,130,270000,250000,14,49,56,11,11,119,118,12
5244,E02000477,2013,141,286000,275000,21,51,43,26,13,128,116,25
5245,E02000477,2014,49,311000,305000,6,19,13,11,2,47,38,11
5246,E02000478,2009,49,548000,470000,32,13,2,2,2,47,47,2
5247,E02000478,2010,76,651000,542000,54,13,6,3,0,76,73,3
5248,E02000478,2011,55,605000,499000,40,7,2,6,1,54,49,6
5249,E02000478,2012,54,585000,458000,38,8,0,8,2,52,46,8
5250,E02000478,2013,73,665000,600000,57,9,2,5,1,72,68,5
5251,E02000478,2014,28,650000,560000,20,5,1,2,0,28,26,2
5252,E02000479,2009,112,193000,190000,6,31,32,43,2,110,69,43
5253,E02000479,2010,126,197000,195000,4,36,45,41,1,125,86,40
5254,E02000479,2011,122,208000,207000,6,46,39,31,15,107,91,31
5255,E02000479,2012,120,213000,214000,2,45,36,37,30,90,83,37
5256,E02000479,2013,159,217000,217000,8,54,46,51,13,146,107,52
5257,E02000479,2014,47,224000,225000,2,19,11,15,0,47,33,14
5258,E02000480,2009,76,191000,186000,5,19,40,12,0,76,64,12
5259,E02000480,2010,101,197000,200000,3,33,51,14,0,101,86,15
5260,E02000480,2011,92,202000,205000,5,26,48,13,0,92,79,13
5261,E02000480,2012,196,177000,170000,1,31,52,112,80,116,85,111
5262,E02000480,2013,295,193000,180000,9,36,79,171,160,135,124,171
5263,E02000480,2014,88,200000,185000,2,14,25,47,33,55,40,48
5264,E02000481,2009,69,221000,218000,5,25,26,13,0,69,58,11
5265,E02000481,2010,113,237000,236000,6,40,36,31,19,94,79,34
5266,E02000481,2011,96,252000,242000,11,39,29,17,1,95,78,18
5267,E02000481,2012,108,267000,250000,17,41,31,19,4,104,89,19
5268,E02000481,2013,111,278000,270000,14,47,31,19,5,106,92,19
5269,E02000481,2014,48,281000,282000,5,20,11,12,0,48,36,12
5270,E02000482,2009,59,388000,344000,15,36,3,5,1,58,54,5
5271,E02000482,2010,82,429000,364000,19,50,3,10,0,82,72,10
5272,E02000482,2011,90,413000,340000,15,56,7,12,1,89,78,12
5273,E02000482,2012,83,404000,344000,9,61,6,7,1,82,76,7
5274,E02000482,2013,90,443000,370000,15,58,7,10,1,89,79,11
5275,E02000482,2014,34,432000,410000,4,22,2,6,0,34,28,6
5276,E02000483,2009,86,223000,220000,6,37,20,23,0,86,62,24
5277,E02000483,2010,102,235000,222000,4,38,22,38,0,102,61,41
5278,E02000483,2011,97,234000,240000,4,37,15,41,0,97,55,42
5279,E02000483,2012,89,232000,240000,9,34,12,34,1,88,53,36
5280,E02000483,2013,121,227000,230000,4,42,25,50,0,121,70,51
5281,E02000483,2014,39,244000,235000,2,18,1,18,0,39,21,18
5282,E02000484,2009,95,236000,225000,8,33,47,7,11,84,88,7
5283,E02000484,2010,106,268000,250000,17,29,52,8,18,88,100,6
5284,E02000484,2011,95,233000,225000,9,25,48,13,10,85,82,13
5285,E02000484,2012,99,244000,236000,8,23,48,20,12,87,79,20
5286,E02000484,2013,106,293000,249000,19,26,51,10,10,96,96,10
5287,E02000484,2014,53,289000,265000,6,20,21,6,2,51,47,6
5288,E02000485,2009,106,244000,221000,7,54,11,34,7,99,71,35
5289,E02000485,2010,126,263000,246000,11,66,17,32,1,125,93,33
5290,E02000485,2011,118,257000,250000,4,68,9,37,1,117,79,39
5291,E02000485,2012,109,263000,250000,4,61,14,30,1,108,77,32
5292,E02000485,2013,135,272000,261000,6,78,15,36,0,135,98,37
5293,E02000485,2014,42,279000,266000,1,20,8,13,0,42,29,13
5294,E02000486,2009,62,214000,216000,3,30,19,10,0,62,52,10
5295,E02000486,2010,87,222000,222000,3,47,19,18,0,87,69,18
5296,E02000486,2011,81,230000,230000,0,47,25,9,0,81,72,9
5297,E02000486,2012,100,230000,223000,2,47,37,14,0,100,85,15
5298,E02000486,2013,97,238000,240000,3,48,29,17,0,97,78,19
5299,E02000486,2014,35,268000,272000,1,20,11,3,0,35,32,3
5300,E02000487,2009,70,381000,375000,15,46,8,1,4,66,69,1
5301,E02000487,2010,96,453000,442000,28,57,11,0,1,95,96,0
5302,E02000487,2011,80,429000,422000,22,49,7,2,0,80,79,1
5303,E02000487,2012,93,425000,415000,21,53,14,5,0,93,88,5
5304,E02000487,2013,96,438000,435000,25,59,12,0,0,96,96,0
5305,E02000487,2014,29,452000,440000,5,18,3,3,1,28,26,3
5306,E02000488,2009,79,222000,218000,3,40,26,10,0,79,71,8
5307,E02000488,2010,78,252000,249000,3,48,24,3,0,78,76,2
5308,E02000488,2011,84,244000,245000,5,52,21,6,0,84,79,5
5309,E02000488,2012,81,253000,250000,2,52,24,3,0,81,78,3
5310,E02000488,2013,128,267000,260000,6,81,36,5,0,128,123,5
5311,E02000488,2014,32,275000,294000,1,21,9,1,0,32,30,2
5312,E02000489,2009,67,194000,190000,0,22,35,10,0,67,57,10
5313,E02000489,2010,66,209000,206000,2,21,34,9,0,66,56,10
5314,E02000489,2011,61,207000,203000,1,23,28,9,0,61,52,9
5315,E02000489,2012,96,218000,215000,1,34,46,15,3,93,81,15
5316,E02000489,2013,119,234000,230000,10,34,61,14,27,92,104,15
5317,E02000489,2014,55,253000,240000,6,14,29,6,14,41,49,6
5318,E02000490,2009,72,195000,186000,5,23,40,4,0,72,69,3
5319,E02000490,2010,56,202000,201000,1,20,31,4,0,56,52,4
5320,E02000490,2011,80,200000,200000,3,31,42,4,0,80,75,5
5321,E02000490,2012,82,200000,205000,4,34,42,2,2,80,79,3
5322,E02000490,2013,86,217000,216000,12,22,48,4,2,84,82,4
5323,E02000490,2014,29,213000,225000,0,7,18,4,0,29,25,4
5324,E02000491,2009,73,171000,172000,8,18,27,20,1,72,53,20
5325,E02000491,2010,82,185000,190000,16,21,30,15,2,80,66,16
5326,E02000491,2011,79,189000,185000,18,23,27,11,0,79,68,11
5327,E02000491,2012,78,193000,190000,9,25,33,11,1,77,66,12
5328,E02000491,2013,90,196000,194000,14,18,40,18,9,81,72,18
5329,E02000491,2014,52,223000,225000,10,17,18,7,0,52,45,7
5330,E02000492,2009,59,225000,213000,24,15,15,5,4,55,54,5
5331,E02000492,2010,67,217000,218000,15,29,16,7,5,62,60,7
5332,E02000492,2011,58,234000,222000,19,22,13,4,2,56,54,4
5333,E02000492,2012,71,229000,228000,27,30,12,2,0,71,69,2
5334,E02000492,2013,75,241000,230000,24,31,16,4,2,73,70,5
5335,E02000492,2014,42,250000,250000,10,19,10,3,3,39,39,3
5336,E02000493,2009,45,163000,170000,0,11,26,8,1,44,36,9
5337,E02000493,2010,57,173000,175000,0,20,25,12,0,57,45,12
5338,E02000493,2011,53,180000,180000,3,16,26,8,0,53,45,8
5339,E02000493,2012,65,178000,180000,5,20,22,18,0,65,47,18
5340,E02000493,2013,96,184000,185000,6,38,39,13,20,76,83,13
5341,E02000493,2014,29,197000,210000,1,8,12,8,2,27,21,8
5342,E02000494,2009,96,518000,374000,43,6,5,42,23,73,53,43
5343,E02000494,2010,101,603000,460000,54,7,16,24,2,99,76,25
5344,E02000494,2011,90,636000,504000,50,11,9,20,0,90,68,22
5345,E02000494,2012,86,656000,448000,49,6,11,20,0,86,65,21
5346,E02000494,2013,91,573000,465000,43,5,15,28,0,91,60,31
5347,E02000494,2014,43,616000,594000,20,1,10,12,0,43,31,12
5348,E02000495,2009,122,293000,275000,12,31,18,61,19,103,58,64
5349,E02000495,2010,151,298000,275000,19,44,19,69,0,151,79,72
5350,E02000495,2011,132,329000,288000,27,25,16,64,5,127,68,64
5351,E02000495,2012,130,318000,315000,21,32,18,59,7,123,69,61
5352,E02000495,2013,150,352000,334000,27,33,21,69,2,148,78,72
5353,E02000495,2014,51,374000,340000,6,12,6,27,0,51,23,28
5354,E02000496,2009,80,265000,245000,11,33,18,18,1,79,64,16
5355,E02000496,2010,92,256000,242000,15,28,25,24,1,91,69,23
5356,E02000496,2011,83,280000,243000,14,27,24,18,0,83,66,17
5357,E02000496,2012,88,298000,250000,9,31,30,18,4,84,69,19
5358,E02000496,2013,102,321000,265000,14,29,31,28,9,93,75,27
5359,E02000496,2014,31,308000,305000,2,15,6,8,1,30,23,8
5360,E02000497,2009,107,284000,265000,11,46,21,29,16,91,77,30
5361,E02000497,2010,129,312000,302000,15,39,37,38,37,92,89,40
5362,E02000497,2011,164,327000,287000,18,44,38,64,60,104,96,68
5363,E02000497,2012,179,386000,340000,49,29,35,66,61,118,109,70
5364,E02000497,2013,152,380000,371000,36,48,19,49,23,129,101,51
5365,E02000497,2014,33,376000,368000,7,5,10,11,0,33,22,11
5366,E02000498,2009,65,301000,285000,17,24,12,12,0,65,54,11
5367,E02000498,2010,92,337000,322000,26,28,22,16,0,92,76,16
5368,E02000498,2011,92,344000,337000,24,34,22,12,10,82,79,13
5369,E02000498,2012,107,355000,318000,20,36,16,35,34,73,70,37
5370,E02000498,2013,105,363000,318000,32,23,19,31,11,94,72,33
5371,E02000498,2014,36,392000,389000,8,11,5,12,5,31,24,12
5372,E02000499,2009,68,342000,312000,12,40,5,11,0,68,57,11
5373,E02000499,2010,82,359000,352000,13,49,3,17,0,82,63,19
5374,E02000499,2011,99,388000,362000,23,59,1,16,0,99,81,18
5375,E02000499,2012,94,393000,365000,20,48,3,23,5,89,70,24
5376,E02000499,2013,108,405000,388000,19,52,4,33,4,104,74,34
5377,E02000499,2014,45,441000,420000,12,20,3,10,0,45,35,10
5378,E02000500,2009,100,320000,284000,36,9,5,50,37,63,50,50
5379,E02000500,2010,126,421000,412000,58,22,7,39,19,107,86,40
5380,E02000500,2011,121,447000,425000,59,18,5,39,18,103,86,35
5381,E02000500,2012,103,408000,350000,44,17,3,39,9,94,63,40
5382,E02000500,2013,116,453000,468000,49,29,5,33,14,102,83,33
5383,E02000500,2014,76,368000,330000,11,5,3,57,45,31,19,57
5384,E02000501,2009,92,278000,270000,12,40,33,7,1,91,84,8
5385,E02000501,2010,109,290000,275000,13,45,38,13,0,109,94,15
5386,E02000501,2011,120,316000,318000,14,62,30,14,0,120,106,14
5387,E02000501,2012,107,316000,312000,10,46,41,10,0,107,97,10
5388,E02000501,2013,131,329000,320000,4,56,38,33,20,111,95,36
5389,E02000501,2014,35,375000,375000,7,15,11,2,0,35,33,2
5390,E02000502,2009,108,240000,234000,9,35,23,41,0,108,65,43
5391,E02000502,2010,121,273000,250000,16,34,24,47,4,117,67,54
5392,E02000502,2011,148,336000,270000,20,32,43,53,30,118,92,56
5393,E02000502,2012,183,341000,280000,24,40,41,78,57,126,105,78
5394,E02000502,2013,135,339000,295000,20,40,31,44,6,129,91,44
5395,E02000502,2014,51,313000,306000,2,11,20,18,0,51,32,19
5396,E02000503,2009,119,237000,240000,1,17,82,19,11,108,100,19
5397,E02000503,2010,110,278000,272000,2,21,81,6,1,109,104,6
5398,E02000503,2011,106,273000,275000,4,13,80,9,0,106,94,12
5399,E02000503,2012,132,294000,285000,3,4,115,10,0,132,122,10
5400,E02000503,2013,107,312000,318000,4,6,85,12,0,107,95,12
5401,E02000503,2014,43,328000,332000,3,2,31,7,1,42,36,7
5402,E02000504,2009,87,355000,340000,26,42,4,15,11,76,71,16
5403,E02000504,2010,97,384000,370000,35,48,5,9,2,95,86,11
5404,E02000504,2011,113,397000,380000,37,52,11,13,5,108,97,16
5405,E02000504,2012,89,388000,375000,33,33,9,14,1,88,74,15
5406,E02000504,2013,108,432000,402000,35,57,6,10,0,108,96,12
5407,E02000504,2014,33,504000,515000,16,15,0,2,0,33,31,2
5408,E02000506,2009,74,379000,362000,42,12,3,17,10,64,57,17
5409,E02000506,2010,119,429000,370000,63,13,8,35,52,67,85,34
5410,E02000506,2011,104,383000,366000,46,17,9,32,30,74,73,31
5411,E02000506,2012,86,480000,445000,47,17,12,10,11,75,76,10
5412,E02000506,2013,87,482000,475000,59,13,4,11,1,86,76,11
5413,E02000506,2014,29,494000,500000,14,8,3,4,0,29,25,4
5414,E02000507,2009,72,215000,226000,1,19,40,12,1,71,59,13
5415,E02000507,2010,84,250000,250000,0,24,54,6,1,83,78,6
5416,E02000507,2011,81,252000,250000,1,19,52,9,0,81,70,11
5417,E02000507,2012,78,263000,254000,0,24,47,7,0,78,70,8
5418,E02000507,2013,75,269000,275000,1,22,42,10,0,75,65,10
5419,E02000507,2014,27,297000,302000,0,6,19,2,0,27,25,2
5420,E02000508,2009,98,217000,210000,8,31,17,42,26,72,56,42
5421,E02000508,2010,110,233000,218000,9,21,29,51,23,87,58,52
5422,E02000508,2011,163,231000,205000,11,18,19,115,30,133,49,114
5423,E02000508,2012,119,230000,210000,7,20,11,81,38,81,38,81
5424,E02000508,2013,101,305000,250000,19,17,23,42,15,86,57,44
5425,E02000508,2014,43,271000,240000,6,4,6,27,7,36,16,27
5426,E02000509,2009,85,193000,180000,3,16,16,50,34,51,33,52
5427,E02000509,2010,96,216000,190000,2,28,10,56,39,57,40,56
5428,E02000509,2011,106,222000,206000,3,25,24,54,20,86,52,54
5429,E02000509,2012,78,232000,227000,3,24,24,27,7,71,49,29
5430,E02000509,2013,83,234000,228000,8,23,21,31,1,82,50,33
5431,E02000509,2014,28,262000,255000,1,9,6,12,0,28,16,12
5432,E02000510,2009,81,251000,248000,15,39,17,10,1,80,65,16
5433,E02000510,2010,116,269000,250000,17,50,34,15,0,116,100,16
5434,E02000510,2011,82,294000,261000,18,35,18,11,0,82,71,11
5435,E02000510,2012,69,273000,256000,10,26,22,11,0,69,55,14
5436,E02000510,2013,94,301000,285000,25,31,20,18,3,91,77,17
5437,E02000510,2014,33,321000,295000,7,12,8,6,5,28,27,6
5438,E02000511,2009,73,218000,228000,1,53,11,8,0,73,63,10
5439,E02000511,2010,88,236000,250000,1,61,14,12,0,88,76,12
5440,E02000511,2011,97,220000,248000,1,57,12,27,0,97,72,25
5441,E02000511,2012,77,234000,250000,0,53,10,14,0,77,63,14
5442,E02000511,2013,94,251000,266000,3,61,14,16,0,94,78,16
5443,E02000511,2014,41,264000,275000,1,26,7,7,0,41,34,7
5444,E02000512,2009,53,207000,215000,3,19,18,13,0,53,40,13
5445,E02000512,2010,64,243000,237000,13,20,14,17,0,64,44,20
5446,E02000512,2011,66,226000,218000,8,25,21,12,0,66,54,12
5447,E02000512,2012,59,231000,228000,7,20,22,10,0,59,48,11
5448,E02000512,2013,80,237000,240000,10,22,31,17,0,80,58,22
5449,E02000512,2014,39,269000,260000,8,10,12,9,0,39,31,8
5450,E02000513,2009,52,194000,202000,1,22,12,17,0,52,34,18
5451,E02000513,2010,69,185000,192000,2,24,14,29,0,69,40,29
5452,E02000513,2011,80,198000,202000,2,20,28,30,0,80,51,29
5453,E02000513,2012,56,191000,184000,0,15,20,21,0,56,34,22
5454,E02000513,2013,77,206000,200000,1,29,11,36,0,77,40,37
5455,E02000513,2014,29,217000,220000,0,8,8,13,0,29,16,13
5456,E02000514,2009,58,215000,210000,2,30,22,4,0,58,54,4
5457,E02000514,2010,74,216000,220000,1,34,30,9,0,74,61,13
5458,E02000514,2011,78,219000,218000,0,28,42,8,0,78,69,9
5459,E02000514,2012,66,237000,240000,1,28,33,4,0,66,62,4
5460,E02000514,2013,77,241000,240000,1,34,35,7,0,77,70,7
5461,E02000514,2014,19,251000,250000,0,10,6,3,0,19,16,3
5462,E02000515,2009,146,196000,188000,9,32,27,78,41,105,69,77
5463,E02000515,2010,143,212000,205000,14,39,33,57,18,125,85,58
5464,E02000515,2011,144,193000,199000,4,31,25,84,25,119,58,86
5465,E02000515,2012,165,200000,192000,8,21,23,113,67,98,53,112
5466,E02000515,2013,162,212000,202000,10,35,36,81,23,139,80,82
5467,E02000515,2014,61,243000,230000,5,15,16,25,1,60,36,25
5468,E02000516,2009,53,207000,208000,2,23,20,8,0,53,45,8
5469,E02000516,2010,56,237000,238000,4,19,29,4,0,56,49,7
5470,E02000516,2011,58,226000,232000,1,29,21,7,0,58,51,7
5471,E02000516,2012,52,227000,239000,4,16,25,7,0,52,45,7
5472,E02000516,2013,68,244000,243000,10,16,34,8,0,68,61,7
5473,E02000516,2014,28,237000,218000,3,5,14,6,0,28,20,8
5474,E02000517,2009,71,212000,210000,3,31,21,16,12,59,53,18
5475,E02000517,2010,87,208000,210000,2,29,23,33,26,61,54,33
5476,E02000517,2011,131,223000,214000,3,32,39,57,65,66,74,57
5477,E02000517,2012,116,235000,220000,4,28,35,49,52,64,67,49
5478,E02000517,2013,108,237000,242000,1,38,39,30,38,70,78,30
5479,E02000517,2014,28,238000,250000,1,12,6,9,1,27,19,9
5480,E02000518,2009,76,209000,208000,3,31,19,23,7,69,51,25
5481,E02000518,2010,78,216000,221000,4,36,18,20,9,69,54,24
5482,E02000518,2011,76,237000,244000,4,41,16,15,1,75,61,15
5483,E02000518,2012,71,233000,242000,4,36,20,11,0,71,60,11
5484,E02000518,2013,72,232000,247000,2,33,21,16,0,72,53,19
5485,E02000518,2014,20,255000,270000,1,9,5,5,0,20,15,5
5486,E02000519,2009,43,212000,222000,1,21,12,9,0,43,34,9
5487,E02000519,2010,46,237000,250000,1,26,15,4,0,46,42,4
5488,E02000519,2011,47,233000,235000,2,26,12,7,0,47,40,7
5489,E02000519,2012,43,222000,225000,5,16,15,7,0,43,33,10
5490,E02000519,2013,35,230000,247000,2,15,10,8,0,35,26,9
5491,E02000519,2014,18,271000,256000,2,7,5,4,2,16,13,5
5492,E02000520,2009,72,202000,210000,2,44,13,13,0,72,57,15
5493,E02000520,2010,73,220000,232000,0,34,24,15,4,69,58,15
5494,E02000520,2011,93,240000,250000,1,39,38,15,23,70,77,16
5495,E02000520,2012,117,246000,250000,1,30,59,27,48,69,91,26
5496,E02000520,2013,115,231000,236000,2,39,30,44,46,69,71,44
5497,E02000520,2014,35,243000,250000,0,10,15,10,0,35,24,11
5498,E02000521,2009,96,208000,204000,0,22,20,54,41,55,43,53
5499,E02000521,2010,104,214000,220000,2,35,28,39,28,76,65,39
5500,E02000521,2011,90,201000,210000,0,33,18,39,29,61,48,42
5501,E02000521,2012,87,244000,243000,1,34,37,15,26,61,73,14
5502,E02000521,2013,258,251000,241000,3,40,75,140,180,78,116,142
5503,E02000521,2014,88,257000,240000,1,9,30,48,53,35,39,49
5504,E02000522,2009,73,196000,200000,5,23,25,20,0,73,50,23
5505,E02000522,2010,87,231000,225000,10,37,19,21,0,87,66,21
5506,E02000522,2011,85,239000,235000,11,39,13,22,0,85,63,22
5507,E02000522,2012,72,246000,237000,8,30,18,16,0,72,56,16
5508,E02000522,2013,89,261000,247000,15,28,17,29,1,88,62,27
5509,E02000522,2014,34,272000,262000,5,10,9,10,0,34,24,10
5510,E02000523,2009,60,206000,218000,2,25,21,12,1,59,47,13
5511,E02000523,2010,66,227000,234000,2,30,24,10,1,65,56,10
5512,E02000523,2011,152,195000,178000,3,41,21,87,81,71,65,87
5513,E02000523,2012,267,214000,197000,0,34,9,224,212,55,42,225
5514,E02000523,2013,94,231000,250000,2,29,13,50,28,66,43,51
5515,E02000523,2014,38,237000,245000,1,15,6,16,0,38,21,17
5516,E02000524,2009,29,206000,175000,4,9,4,12,0,29,17,12
5517,E02000524,2010,97,255000,250000,14,38,25,20,0,97,76,21
5518,E02000524,2011,95,253000,248000,11,37,26,21,2,93,75,20
5519,E02000524,2012,57,225000,218000,11,13,20,13,4,53,44,13
5520,E02000524,2013,48,225000,220000,7,12,9,20,0,48,28,20
5521,E02000524,2014,16,268000,264000,3,7,1,5,0,16,11,5
5522,E02000525,2009,65,185000,175000,0,20,14,31,14,51,32,33
5523,E02000525,2010,79,217000,215000,2,30,26,21,2,77,56,23
5524,E02000525,2011,72,194000,200000,1,21,22,28,0,72,44,28
5525,E02000525,2012,53,191000,197000,0,12,21,20,0,53,32,21
5526,E02000525,2013,88,215000,212000,1,29,25,33,0,88,55,33
5527,E02000525,2014,30,204000,190000,1,3,9,17,3,27,13,17
5528,E02000526,2009,96,633000,472000,3,22,27,44,8,88,50,46
5529,E02000526,2010,133,774000,650000,2,35,42,54,1,132,74,59
5530,E02000526,2011,136,855000,638000,3,26,46,61,1,135,76,60
5531,E02000526,2012,122,836000,750000,2,27,41,52,7,115,67,55
5532,E02000526,2013,134,956000,800000,1,29,40,64,3,131,68,66
5533,E02000526,2014,44,1053000,638000,1,9,8,26,1,43,18,26
5534,E02000528,2009,132,265000,250000,0,10,9,113,71,61,19,113
5535,E02000528,2010,142,281000,268000,0,7,15,120,59,83,21,121
5536,E02000528,2011,150,289000,272000,1,14,14,121,50,100,28,122
5537,E02000528,2012,200,360000,310000,0,5,17,178,93,107,21,179
5538,E02000528,2013,271,377000,270000,1,6,24,240,143,128,29,242
5539,E02000528,2014,73,365000,325000,0,2,6,65,13,60,8,65
5540,E02000529,2009,30,225000,249000,1,10,10,9,0,30,20,10
5541,E02000529,2010,54,234000,236000,1,21,11,21,6,48,31,23
5542,E02000529,2011,39,249000,225000,1,17,6,15,2,37,24,15
5543,E02000529,2012,42,223000,226000,0,11,14,17,3,39,21,21
5544,E02000529,2013,74,263000,270000,5,31,15,23,4,70,49,25
5545,E02000529,2014,18,301000,266000,2,5,8,3,0,18,10,8
5546,E02000530,2009,25,194000,175000,0,7,11,7,0,25,18,7
5547,E02000530,2010,30,187000,196000,0,6,12,12,0,30,18,12
5548,E02000530,2011,35,188000,180000,1,8,5,21,15,20,14,21
5549,E02000530,2012,33,184000,180000,1,5,10,17,5,28,16,17
5550,E02000530,2013,30,216000,238000,0,6,13,11,0,30,19,11
5551,E02000530,2014,12,231000,247000,0,4,4,4,0,12,8,4
5552,E02000531,2009,94,284000,250000,0,19,40,35,6,88,58,36
5553,E02000531,2010,107,297000,270000,0,9,40,58,8,99,47,60
5554,E02000531,2011,110,327000,290000,2,15,36,57,6,104,50,60
5555,E02000531,2012,107,339000,312000,2,11,41,53,0,107,53,54
5556,E02000531,2013,160,360000,345000,2,11,61,86,1,159,72,88
5557,E02000531,2014,64,387000,350000,0,8,22,34,3,61,30,34
5558,E02000532,2009,101,713000,640000,7,24,37,33,0,101,66,35
5559,E02000532,2010,132,731000,685000,6,33,40,53,4,128,76,56
5560,E02000532,2011,150,723000,645000,10,29,53,58,9,141,91,59
5561,E02000532,2012,97,732000,575000,1,19,32,45,5,92,52,45
5562,E02000532,2013,148,849000,742000,8,27,46,67,6,142,81,67
5563,E02000532,2014,56,846000,675000,1,16,13,26,0,56,29,27
5564,E02000533,2009,105,558000,445000,5,16,36,48,0,105,57,48
5565,E02000533,2010,135,618000,450000,5,23,38,69,1,134,64,71
5566,E02000533,2011,142,622000,490000,7,20,50,65,2,140,72,70
5567,E02000533,2012,116,574000,448000,3,7,34,72,6,110,43,73
5568,E02000533,2013,147,796000,575000,4,11,58,74,1,146,70,77
5569,E02000533,2014,49,698000,530000,2,6,13,28,2,47,20,29
5570,E02000534,2009,98,301000,237000,5,25,15,53,41,57,42,56
5571,E02000534,2010,84,320000,250000,2,30,10,42,8,76,39,45
5572,E02000534,2011,71,357000,350000,8,24,12,27,0,71,44,27
5573,E02000534,2012,71,381000,365000,7,28,8,28,0,71,43,28
5574,E02000534,2013,86,362000,336000,6,25,11,44,0,86,41,45
5575,E02000534,2014,53,432000,330000,6,15,6,26,0,53,26,27
5576,E02000535,2009,34,253000,250000,0,26,6,2,1,33,32,2
5577,E02000535,2010,46,274000,275000,5,27,7,7,1,45,37,9
5578,E02000535,2011,41,274000,285000,3,21,6,11,0,41,31,10
5579,E02000535,2012,51,285000,285000,1,37,6,7,0,51,42,9
5580,E02000535,2013,54,292000,298000,2,31,13,8,0,54,43,11
5581,E02000535,2014,19,285000,295000,0,8,7,4,0,19,15,4
5582,E02000536,2009,47,281000,250000,1,34,9,3,0,47,44,3
5583,E02000536,2010,53,274000,265000,1,32,11,9,1,52,43,10
5584,E02000536,2011,48,269000,281000,1,31,5,11,0,48,36,12
5585,E02000536,2012,42,288000,285000,2,25,7,8,0,42,33,9
5586,E02000536,2013,48,316000,315000,6,28,8,6,0,48,39,9
5587,E02000536,2014,17,350000,335000,0,10,4,3,0,17,14,3
5588,E02000537,2009,51,278000,250000,1,23,13,14,0,51,38,13
5589,E02000537,2010,63,306000,250000,2,22,21,18,0,63,46,17
5590,E02000537,2011,68,310000,267000,4,23,22,19,4,64,49,19
5591,E02000537,2012,77,389000,355000,12,22,29,14,24,53,64,13
5592,E02000537,2013,103,410000,370000,4,38,37,24,35,68,79,24
5593,E02000537,2014,23,435000,408000,1,14,5,3,0,23,20,3
5594,E02000538,2009,24,225000,236000,0,10,6,8,0,24,16,8
5595,E02000538,2010,33,242000,238000,0,17,8,8,0,33,26,7
5596,E02000538,2011,39,256000,250000,3,12,17,7,1,38,31,8
5597,E02000538,2012,38,251000,249000,3,13,16,6,0,38,32,6
5598,E02000538,2013,70,252000,248000,2,9,29,30,38,32,40,30
5599,E02000538,2014,9,277000,279000,0,3,5,1,0,9,8,1
5600,E02000539,2009,116,240000,230000,0,13,46,57,25,91,62,54
5601,E02000539,2010,260,247000,242000,2,21,60,177,127,133,80,180
5602,E02000539,2011,133,269000,250000,3,14,51,65,19,114,67,66
5603,E02000539,2012,150,288000,281000,0,19,74,57,0,150,91,59
5604,E02000539,2013,163,343000,310000,1,15,85,62,0,163,100,63
5605,E02000539,2014,77,323000,306000,2,6,26,43,1,76,34,43
5606,E02000540,2009,62,233000,218000,0,19,13,30,3,59,32,30
5607,E02000540,2010,61,268000,236000,2,19,15,25,0,61,36,25
5608,E02000540,2011,83,266000,245000,4,24,25,30,0,83,52,31
5609,E02000540,2012,74,295000,250000,3,22,24,25,0,74,47,27
5610,E02000540,2013,94,302000,292000,3,27,26,38,2,92,55,39
5611,E02000540,2014,41,324000,295000,0,11,11,19,0,41,19,22
5612,E02000541,2009,36,203000,161000,2,7,7,20,10,26,16,20
5613,E02000541,2010,42,227000,234000,1,10,19,12,5,37,30,12
5614,E02000541,2011,17,236000,250000,0,9,3,5,0,17,12,5
5615,E02000541,2012,21,260000,259000,0,3,14,4,0,21,16,5
5616,E02000541,2013,29,270000,280000,0,9,14,6,6,23,21,8
5617,E02000541,2014,28,252000,242000,0,6,10,12,13,15,16,12
5618,E02000542,2009,42,210000,214000,1,17,6,18,0,42,25,17
5619,E02000542,2010,46,233000,221000,0,14,18,14,0,46,32,14
5620,E02000542,2011,51,225000,235000,0,13,13,25,15,36,25,26
5621,E02000542,2012,65,238000,240000,4,11,17,33,27,38,32,33
5622,E02000542,2013,47,232000,230000,2,9,15,21,3,44,25,22
5623,E02000542,2014,27,240000,217000,1,5,4,17,3,24,10,17
5624,E02000543,2009,55,240000,225000,4,21,12,18,0,55,37,18
5625,E02000543,2010,84,243000,228000,5,20,28,31,0,84,53,31
5626,E02000543,2011,67,259000,228000,1,22,16,28,0,67,39,28
5627,E02000543,2012,76,242000,229000,3,14,26,33,0,76,43,33
5628,E02000543,2013,97,250000,229000,8,10,22,57,5,92,40,57
5629,E02000543,2014,37,262000,245000,3,6,8,20,1,36,17,20
5630,E02000544,2009,43,245000,250000,3,28,8,4,0,43,39,4
5631,E02000544,2010,66,263000,274000,2,32,27,5,0,66,55,11
5632,E02000544,2011,77,270000,270000,0,44,23,10,0,77,69,8
5633,E02000544,2012,67,302000,298000,3,38,22,4,9,58,63,4
5634,E02000544,2013,77,324000,325000,3,46,20,8,0,77,70,7
5635,E02000544,2014,29,341000,340000,1,14,7,7,0,29,22,7
5636,E02000545,2009,56,298000,254000,0,16,19,21,4,52,35,21
5637,E02000545,2010,101,287000,252000,1,22,46,32,4,97,67,34
5638,E02000545,2011,79,300000,275000,0,22,33,24,1,78,54,25
5639,E02000545,2012,106,303000,262000,2,16,34,54,0,106,51,55
5640,E02000545,2013,108,371000,338000,4,21,46,37,2,106,67,41
5641,E02000545,2014,38,373000,305000,1,5,12,20,2,36,16,22
5642,E02000546,2009,28,237000,245000,0,13,13,2,0,28,25,3
5643,E02000546,2010,57,223000,230000,2,21,25,9,0,57,45,12
5644,E02000546,2011,63,221000,203000,4,15,11,33,18,45,29,34
5645,E02000546,2012,45,232000,240000,0,10,24,11,0,45,34,11
5646,E02000546,2013,53,253000,240000,0,15,23,15,0,53,38,15
5647,E02000546,2014,26,265000,250000,1,6,8,11,0,26,15,11
5648,E02000547,2009,58,192000,195000,3,26,12,17,0,58,39,19
5649,E02000547,2010,82,214000,217000,5,47,14,16,0,82,61,21
5650,E02000547,2011,91,201000,209000,2,44,17,28,0,91,64,27
5651,E02000547,2012,71,216000,222000,6,33,11,21,0,71,50,21
5652,E02000547,2013,107,220000,230000,1,55,21,30,1,106,77,30
5653,E02000547,2014,33,231000,237000,1,13,7,12,0,33,21,12
5654,E02000548,2009,54,189000,201000,2,26,13,13,1,53,40,14
5655,E02000548,2010,77,207000,218000,8,26,27,16,5,72,55,22
5656,E02000548,2011,81,193000,186000,1,25,19,36,24,57,43,38
5657,E02000548,2012,91,183000,171000,0,29,19,43,0,91,44,47
5658,E02000548,2013,96,216000,218000,2,41,21,32,0,96,61,35
5659,E02000548,2014,33,196000,165000,2,3,7,21,0,33,11,22
5660,E02000549,2009,97,208000,210000,3,51,28,15,0,97,81,16
5661,E02000549,2010,109,223000,230000,5,59,27,18,1,108,88,21
5662,E02000549,2011,83,222000,230000,2,39,27,15,0,83,68,15
5663,E02000549,2012,108,222000,224000,2,45,33,28,5,103,78,30
5664,E02000549,2013,114,247000,242000,7,46,37,24,3,111,89,25
5665,E02000549,2014,31,240000,260000,0,16,7,8,1,30,23,8
5666,E02000550,2009,50,190000,195000,0,22,17,11,4,46,38,12
5667,E02000550,2010,76,199000,208000,0,27,30,19,0,76,56,20
5668,E02000550,2011,65,194000,197000,0,11,31,23,0,65,42,23
5669,E02000550,2012,85,199000,200000,3,15,38,29,0,85,56,29
5670,E02000550,2013,99,206000,219000,3,18,44,34,0,99,64,35
5671,E02000550,2014,40,215000,224000,0,10,9,21,0,40,19,21
5672,E02000551,2009,45,177000,175000,0,6,27,12,0,45,32,13
5673,E02000551,2010,59,195000,196000,1,15,28,15,0,59,44,15
5674,E02000551,2011,47,179000,182000,0,6,25,16,0,47,29,18
5675,E02000551,2012,62,200000,205000,1,18,30,13,0,62,50,12
5676,E02000551,2013,60,197000,200000,1,8,31,20,0,60,38,22
5677,E02000551,2014,28,223000,230000,0,5,13,10,0,28,18,10
5678,E02000552,2009,84,184000,185000,6,22,24,32,4,80,51,33
5679,E02000552,2010,118,193000,204000,4,30,40,44,0,118,73,45
5680,E02000552,2011,99,195000,210000,5,19,46,29,0,99,66,33
5681,E02000552,2012,85,209000,212000,6,18,38,23,0,85,61,24
5682,E02000552,2013,121,206000,217000,7,27,39,48,1,120,68,53
5683,E02000552,2014,38,206000,211000,2,4,13,19,0,38,19,19
5684,E02000553,2009,64,213000,200000,2,29,25,8,0,64,55,9
5685,E02000553,2010,59,214000,205000,4,21,15,19,0,59,39,20
5686,E02000553,2011,68,236000,229000,4,31,27,6,0,68,62,6
5687,E02000553,2012,76,235000,224000,4,30,31,11,0,76,65,11
5688,E02000553,2013,98,252000,240000,4,36,38,20,5,93,78,20
5689,E02000553,2014,35,276000,249000,3,10,14,8,0,35,29,6
5690,E02000554,2009,58,324000,285000,0,2,12,44,0,58,13,45
5691,E02000554,2010,69,360000,310000,3,1,7,58,1,68,11,58
5692,E02000554,2011,67,362000,315000,1,0,12,54,0,67,10,57
5693,E02000554,2012,70,378000,299000,0,2,12,56,0,70,14,56
5694,E02000554,2013,101,396000,325000,0,3,13,85,1,100,15,86
5695,E02000554,2014,38,405000,352000,0,1,3,34,0,38,4,34
5696,E02000555,2009,80,364000,280000,1,2,20,57,13,67,20,60
5697,E02000555,2010,101,457000,353000,0,5,31,65,11,90,35,66
5698,E02000555,2011,101,508000,375000,0,3,40,58,4,97,41,60
5699,E02000555,2012,123,465000,357000,1,5,32,85,1,122,37,86
5700,E02000555,2013,104,468000,381000,1,1,33,69,0,104,33,71
5701,E02000555,2014,36,554000,445000,0,0,11,25,2,34,11,25
5702,E02000556,2009,78,326000,293000,0,1,26,51,0,78,25,53
5703,E02000556,2010,119,355000,320000,2,2,25,90,0,119,31,88
5704,E02000556,2011,115,370000,335000,0,3,31,81,3,112,32,83
5705,E02000556,2012,141,369000,320000,0,1,34,106,22,119,34,107
5706,E02000556,2013,137,430000,355000,1,2,36,98,5,132,34,103
5707,E02000556,2014,48,476000,416000,0,0,11,37,0,48,10,38
5708,E02000557,2009,81,321000,260000,0,2,18,61,3,78,20,61
5709,E02000557,2010,97,378000,310000,0,4,18,75,0,97,23,74
5710,E02000557,2011,84,394000,328000,1,5,19,59,0,84,20,64
5711,E02000557,2012,71,465000,390000,1,3,12,55,0,71,15,56
5712,E02000557,2013,114,448000,395000,0,0,20,94,22,92,20,94
5713,E02000557,2014,20,498000,412000,0,0,5,15,0,20,5,15
5714,E02000558,2009,20,217000,199000,0,0,1,19,1,19,1,19
5715,E02000558,2010,43,297000,250000,0,1,6,36,0,43,7,36
5716,E02000558,2011,37,326000,250000,0,1,7,29,0,37,8,29
5717,E02000558,2012,110,255000,240000,0,0,6,104,69,41,6,104
5718,E02000558,2013,61,329000,310000,0,0,12,49,2,59,12,49
5719,E02000558,2014,24,389000,330000,0,0,3,21,0,24,3,21
5720,E02000559,2009,256,404000,370000,0,4,29,223,180,76,32,224
5721,E02000559,2010,210,435000,402000,1,5,36,168,112,98,46,164
5722,E02000559,2011,171,499000,420000,1,4,55,111,22,149,60,111
5723,E02000559,2012,150,526000,440000,0,1,46,103,26,124,46,104
5724,E02000559,2013,214,542000,485000,1,0,53,160,62,152,53,161
5725,E02000559,2014,82,652000,571000,0,0,18,64,43,39,18,64
5726,E02000560,2009,147,267000,250000,0,0,14,133,79,68,14,133
5727,E02000560,2010,109,308000,275000,0,1,13,95,10,99,14,95
5728,E02000560,2011,89,348000,315000,0,1,22,66,2,87,23,66
5729,E02000560,2012,129,365000,330000,0,0,17,112,38,91,15,114
5730,E02000560,2013,103,419000,375000,0,0,19,84,5,98,18,85
5731,E02000560,2014,33,492000,462000,0,0,8,25,0,33,8,25
5732,E02000561,2009,82,440000,338000,0,4,22,56,1,81,26,56
5733,E02000561,2010,103,521000,370000,0,8,25,70,1,102,33,70
5734,E02000561,2011,117,581000,406000,1,8,34,74,2,115,38,79
5735,E02000561,2012,108,529000,425000,1,4,16,87,0,108,22,86
5736,E02000561,2013,85,694000,550000,1,4,25,55,0,85,28,57
5737,E02000561,2014,47,753000,585000,1,2,13,31,0,47,15,32
5738,E02000562,2009,96,421000,329000,0,5,12,79,4,92,15,81
5739,E02000562,2010,109,459000,395000,1,3,11,94,0,109,15,94
5740,E02000562,2011,92,617000,425000,2,2,17,71,1,91,21,71
5741,E02000562,2012,111,556000,385000,2,0,16,93,6,105,18,93
5742,E02000562,2013,166,675000,538000,1,3,27,135,55,111,30,136
5743,E02000562,2014,34,697000,482000,0,2,7,25,2,32,8,26
5744,E02000563,2009,73,279000,250000,0,1,3,69,3,70,5,68
5745,E02000563,2010,70,311000,276000,1,1,6,62,0,70,8,62
5746,E02000563,2011,76,346000,311000,1,3,4,68,8,68,8,68
5747,E02000563,2012,83,387000,302000,0,3,13,67,3,80,16,67
5748,E02000563,2013,87,357000,315000,0,4,4,79,0,87,7,80
5749,E02000563,2014,22,448000,350000,1,0,1,20,0,22,2,20
5750,E02000564,2009,103,312000,280000,0,2,9,92,5,98,10,93
5751,E02000564,2010,125,337000,320000,0,2,8,115,5,120,10,115
5752,E02000564,2011,118,405000,375000,1,5,10,102,1,117,16,102
5753,E02000564,2012,178,376000,378000,0,1,5,172,30,148,6,172
5754,E02000564,2013,228,424000,409000,0,3,5,220,71,157,8,220
5755,E02000564,2014,56,445000,392000,0,2,2,52,14,42,3,53
5756,E02000565,2009,47,320000,270000,0,0,7,40,0,47,4,43
5757,E02000565,2010,88,375000,320000,2,1,9,76,1,87,10,78
5758,E02000565,2011,72,366000,335000,0,0,6,66,13,59,6,66
5759,E02000565,2012,59,376000,325000,0,1,8,50,2,57,7,52
5760,E02000565,2013,71,480000,375000,0,2,8,61,0,71,8,63
5761,E02000565,2014,33,529000,392000,0,0,6,27,0,33,5,28
5762,E02000566,2009,154,451000,390000,4,4,23,123,33,121,30,124
5763,E02000566,2010,145,649000,500000,0,2,40,103,25,120,38,107
5764,E02000566,2011,152,580000,450000,1,4,36,111,52,100,39,113
5765,E02000566,2012,128,780000,568000,2,2,45,79,15,113,48,80
5766,E02000566,2013,117,718000,575000,1,5,28,83,2,115,34,83
5767,E02000566,2014,37,1150000,750000,0,1,12,24,1,36,11,26
5768,E02000567,2009,185,375000,315000,2,3,21,159,82,103,24,161
5769,E02000567,2010,176,441000,372000,0,2,25,149,3,173,23,153
5770,E02000567,2011,174,487000,415000,4,4,18,148,3,171,23,151
5771,E02000567,2012,151,498000,416000,1,4,23,123,24,127,23,128
5772,E02000567,2013,187,532000,437000,0,1,24,162,42,145,23,164
5773,E02000567,2014,40,687000,512000,0,0,6,34,0,40,4,36
5774,E02000568,2009,44,290000,238000,2,1,3,38,11,33,6,38
5775,E02000568,2010,70,305000,282000,0,3,14,53,10,60,16,54
5776,E02000568,2011,86,334000,323000,0,0,8,78,22,64,7,79
5777,E02000568,2012,129,372000,350000,0,1,19,109,55,74,19,110
5778,E02000568,2013,125,396000,368000,1,0,7,117,50,75,7,118
5779,E02000568,2014,39,417000,336000,0,0,5,34,7,32,5,34
5780,E02000569,2009,80,607000,378000,1,8,13,58,0,80,21,59
5781,E02000569,2010,115,606000,410000,1,4,18,92,0,115,22,93
5782,E02000569,2011,102,662000,425000,1,4,17,80,0,102,21,81
5783,E02000569,2012,90,715000,492000,0,7,19,64,0,90,26,64
5784,E02000569,2013,104,805000,500000,1,5,22,76,0,104,26,78
5785,E02000569,2014,31,689000,575000,0,1,4,26,0,31,5,26
5786,E02000570,2009,127,636000,485000,2,2,49,74,11,116,52,75
5787,E02000570,2010,313,572000,485000,5,2,42,264,164,149,49,264
5788,E02000570,2011,176,678000,486000,1,3,40,132,25,151,40,136
5789,E02000570,2012,124,775000,582000,0,2,36,86,3,121,38,86
5790,E02000570,2013,151,841000,675000,4,1,43,103,24,127,47,104
5791,E02000570,2014,52,998000,812000,2,0,17,33,3,49,18,34
5792,E02000571,2009,101,411000,325000,0,5,25,71,23,78,31,70
5793,E02000571,2010,102,560000,533000,1,5,40,56,1,101,45,57
5794,E02000571,2011,104,502000,380000,0,5,31,68,15,89,34,70
5795,E02000571,2012,161,499000,451000,1,1,30,129,64,97,30,131
5796,E02000571,2013,125,618000,475000,0,1,36,88,17,108,36,89
5797,E02000571,2014,28,698000,555000,0,0,8,20,3,25,8,20
5798,E02000572,2009,44,346000,265000,0,1,5,38,14,30,6,38
5799,E02000572,2010,46,374000,295000,0,1,8,37,0,46,8,38
5800,E02000572,2011,45,352000,290000,0,1,3,41,7,38,3,42
5801,E02000572,2012,46,333000,312000,0,0,2,44,5,41,3,43
5802,E02000572,2013,44,449000,348000,0,1,4,39,2,42,5,39
5803,E02000572,2014,21,398000,350000,0,0,3,18,0,21,1,20
5804,E02000573,2009,122,613000,500000,1,7,47,67,21,101,50,72
5805,E02000573,2010,149,738000,571000,2,5,58,84,4,145,60,89
5806,E02000573,2011,146,677000,555000,1,3,49,93,0,146,49,97
5807,E02000573,2012,155,756000,585000,0,0,44,111,26,129,42,113
5808,E02000573,2013,118,869000,682000,1,1,38,78,3,115,38,80
5809,E02000573,2014,36,1322000,1187000,0,0,20,16,0,36,19,17
5810,E02000574,2009,105,472000,380000,2,1,10,92,10,95,12,93
5811,E02000574,2010,104,486000,482000,0,0,7,97,0,104,5,99
5812,E02000574,2011,86,543000,455000,0,0,10,76,1,85,9,77
5813,E02000574,2012,94,619000,554000,0,1,8,85,2,92,9,85
5814,E02000574,2013,121,661000,608000,0,0,10,111,36,85,9,112
5815,E02000574,2014,20,691000,721000,0,0,0,20,0,20,0,20
5816,E02000575,2009,202,493000,475000,2,0,11,189,58,144,12,190
5817,E02000575,2010,181,539000,455000,3,0,10,168,12,169,13,168
5818,E02000575,2011,191,506000,448000,0,0,8,183,20,171,8,183
5819,E02000575,2012,163,653000,590000,0,0,6,157,4,159,6,157
5820,E02000575,2013,173,667000,630000,0,0,6,167,20,153,5,168
5821,E02000575,2014,50,750000,678000,0,0,2,48,1,49,3,47
5822,E02000576,2009,81,347000,315000,0,0,1,80,36,45,0,81
5823,E02000576,2010,160,479000,430000,0,0,1,159,83,77,1,159
5824,E02000576,2011,155,492000,442000,0,0,1,154,67,88,1,154
5825,E02000576,2012,209,543000,446000,1,0,1,207,61,148,1,208
5826,E02000576,2013,261,645000,595000,0,1,0,260,75,186,1,260
5827,E02000576,2014,51,667000,568000,0,0,0,51,6,45,0,51
5828,E02000577,2009,24,377000,291000,0,0,2,22,15,9,2,22
5829,E02000577,2010,40,382000,230000,0,0,3,37,21,19,4,36
5830,E02000577,2011,17,465000,320000,0,0,2,15,1,16,2,15
5831,E02000577,2012,26,356000,328000,0,0,1,25,0,26,1,25
5832,E02000577,2013,64,487000,460000,0,0,3,61,32,32,2,62
5833,E02000577,2014,21,670000,530000,0,0,1,20,7,14,1,20
5834,E02000578,2009,24,429000,402000,0,0,2,22,9,15,3,21
5835,E02000578,2010,58,535000,482000,0,1,4,53,36,22,5,53
5836,E02000578,2011,23,539000,500000,0,0,3,20,0,23,3,20
5837,E02000578,2012,27,655000,500000,0,1,7,19,1,26,8,19
5838,E02000578,2013,28,512000,483000,0,0,4,24,0,28,3,25
5839,E02000578,2014,15,453000,450000,0,0,1,14,0,15,2,13
5840,E02000579,2009,78,604000,468000,0,2,24,52,2,76,28,50
5841,E02000579,2010,111,843000,535000,3,3,27,78,0,111,33,78
5842,E02000579,2011,86,730000,497000,1,2,21,62,0,86,25,61
5843,E02000579,2012,116,940000,660000,2,4,31,79,3,113,36,80
5844,E02000579,2013,115,942000,660000,2,2,28,83,2,113,30,85
5845,E02000579,2014,32,1078000,804000,1,0,10,21,0,32,11,21
5846,E02000580,2009,74,550000,438000,0,0,9,65,3,71,6,68
5847,E02000580,2010,81,910000,620000,0,0,15,66,0,81,11,70
5848,E02000580,2011,95,869000,550000,0,1,21,73,0,95,19,76
5849,E02000580,2012,71,912000,600000,0,0,11,60,1,70,11,60
5850,E02000580,2013,98,860000,628000,0,0,14,84,0,98,13,85
5851,E02000580,2014,32,1149000,797000,0,0,4,28,0,32,4,28
5852,E02000581,2009,23,962000,640000,0,1,11,11,0,23,14,9
5853,E02000581,2010,16,955000,805000,0,1,9,6,0,16,9,7
5854,E02000581,2011,27,711000,439000,1,1,7,18,0,27,7,20
5855,E02000581,2012,26,937000,444000,0,0,8,18,0,26,8,18
5856,E02000581,2013,43,777000,415000,0,0,8,35,1,42,8,35
5857,E02000581,2014,11,1059000,485000,0,0,4,7,0,11,4,7
5858,E02000582,2009,103,912000,595000,2,0,15,86,0,103,17,86
5859,E02000582,2010,122,1414000,739000,4,0,13,105,0,122,17,105
5860,E02000582,2011,137,1227000,825000,1,2,20,114,0,137,21,116
5861,E02000582,2012,114,1491000,950000,0,1,20,93,0,114,21,93
5862,E02000582,2013,106,1540000,995000,0,2,21,83,0,106,23,83
5863,E02000582,2014,49,2180000,1100000,0,1,11,37,0,49,12,37
5864,E02000583,2009,106,1264000,592000,2,1,33,70,0,106,36,70
5865,E02000583,2010,122,1805000,1015000,0,2,50,70,0,122,51,71
5866,E02000583,2011,121,1504000,670000,0,2,32,87,0,121,34,87
5867,E02000583,2012,121,2198000,950000,1,4,32,84,2,119,37,84
5868,E02000583,2013,139,2017000,890000,0,4,45,90,1,138,48,91
5869,E02000583,2014,49,2006000,1310000,0,0,14,35,2,47,14,35
5870,E02000584,2009,123,1530000,981000,0,0,40,83,0,123,39,84
5871,E02000584,2010,141,1480000,825000,0,2,32,107,0,141,33,108
5872,E02000584,2011,142,1709000,1100000,2,1,37,102,5,137,41,101
5873,E02000584,2012,129,1863000,1350000,1,1,35,92,1,128,36,93
5874,E02000584,2013,148,2176000,1412000,0,0,39,109,1,147,40,108
5875,E02000584,2014,67,2582000,1590000,1,1,16,49,0,67,17,50
5876,E02000585,2009,98,1030000,622000,0,0,21,77,0,98,21,77
5877,E02000585,2010,107,1282000,652000,3,0,16,88,0,107,19,88
5878,E02000585,2011,117,1356000,755000,0,2,22,93,0,117,20,97
5879,E02000585,2012,97,1326000,690000,2,1,13,81,0,97,13,84
5880,E02000585,2013,136,1825000,888000,2,0,32,102,1,135,31,105
5881,E02000585,2014,56,2825000,1298000,3,0,16,37,0,56,16,40
5882,E02000586,2009,99,1224000,980000,0,0,12,87,0,99,13,86
5883,E02000586,2010,151,1457000,1050000,0,2,16,133,0,151,20,131
5884,E02000586,2011,129,1528000,1115000,0,2,23,104,0,129,23,106
5885,E02000586,2012,102,2158000,1673000,0,4,15,83,0,102,20,82
5886,E02000586,2013,111,2213000,1545000,0,1,19,91,2,109,20,91
5887,E02000586,2014,57,2418000,1650000,0,1,5,51,0,57,6,51
5888,E02000587,2009,111,1218000,945000,0,2,27,82,0,111,28,83
5889,E02000587,2010,119,1630000,1075000,0,3,26,90,1,118,28,91
5890,E02000587,2011,119,1635000,925000,0,6,25,88,0,119,35,84
5891,E02000587,2012,111,2249000,1175000,0,5,29,77,0,111,33,78
5892,E02000587,2013,134,2353000,1662000,0,7,35,92,0,134,42,92
5893,E02000587,2014,44,2294000,1125000,0,2,5,37,0,44,7,37
5894,E02000588,2009,138,1230000,1035000,0,1,24,113,0,138,24,114
5895,E02000588,2010,147,1551000,1325000,0,1,33,113,0,147,30,117
5896,E02000588,2011,157,1854000,1424000,1,1,32,123,0,157,34,123
5897,E02000588,2012,141,2362000,1600000,1,0,35,105,0,141,34,107
5898,E02000588,2013,212,2880000,2250000,1,1,49,161,7,205,49,163
5899,E02000588,2014,70,2964000,2260000,0,0,12,58,0,70,12,58
5900,E02000589,2009,125,774000,645000,0,0,11,114,0,125,10,115
5901,E02000589,2010,165,1144000,780000,2,0,19,144,0,165,20,145
5902,E02000589,2011,174,1058000,828000,1,0,22,151,0,174,23,151
5903,E02000589,2012,133,1195000,895000,0,1,11,121,1,132,11,122
5904,E02000589,2013,177,1382000,1055000,1,0,13,163,0,177,14,163
5905,E02000589,2014,69,1271000,921000,1,0,2,66,0,69,3,66
5906,E02000590,2009,137,1049000,580000,0,3,18,116,0,137,21,116
5907,E02000590,2010,117,1014000,550000,1,0,18,98,0,117,18,99
5908,E02000590,2011,123,1362000,784000,0,2,23,98,0,123,20,103
5909,E02000590,2012,106,1329000,548000,0,0,18,88,0,106,19,87
5910,E02000590,2013,154,1551000,932000,1,0,31,122,0,154,32,122
5911,E02000590,2014,41,2110000,1695000,0,0,7,34,0,41,7,34
5912,E02000591,2009,57,466000,430000,0,0,2,55,0,57,1,56
5913,E02000591,2010,100,668000,562000,0,0,4,96,0,100,4,96
5914,E02000591,2011,107,616000,550000,0,0,3,104,0,107,2,105
5915,E02000591,2012,89,815000,700000,0,0,4,85,3,86,4,85
5916,E02000591,2013,117,893000,760000,0,0,2,115,18,99,1,116
5917,E02000591,2014,74,1201000,989000,0,1,1,72,38,36,2,72
5918,E02000592,2009,129,1187000,860000,1,0,22,106,0,129,19,110
5919,E02000592,2010,146,1344000,998000,0,0,15,131,0,146,12,134
5920,E02000592,2011,149,1470000,1100000,0,2,18,129,0,149,18,131
5921,E02000592,2012,140,1580000,1292000,0,1,14,125,1,139,15,125
5922,E02000592,2013,151,1679000,1375000,1,0,13,137,0,151,13,138
5923,E02000592,2014,43,1791000,1500000,0,0,4,39,0,43,3,40
5924,E02000593,2009,141,797000,595000,0,0,11,130,1,140,12,129
5925,E02000593,2010,156,768000,608000,0,0,5,151,6,150,5,151
5926,E02000593,2011,191,872000,585000,0,1,7,183,4,187,6,185
5927,E02000593,2012,124,1483000,795000,0,1,8,115,0,124,6,118
5928,E02000593,2013,179,1069000,762000,0,0,9,170,2,177,9,170
5929,E02000593,2014,64,1119000,938000,0,0,2,62,0,64,1,63
5930,E02000594,2009,136,1240000,838000,0,0,27,109,0,136,26,110
5931,E02000594,2010,153,1697000,1160000,1,0,42,110,0,153,39,114
5932,E02000594,2011,133,1367000,895000,0,1,20,112,0,133,20,113
5933,E02000594,2012,132,1694000,1175000,0,0,30,102,0,132,30,102
5934,E02000594,2013,132,1908000,1244000,0,1,32,99,1,131,33,99
5935,E02000594,2014,45,2516000,1850000,1,0,16,28,0,45,14,31
5936,E02000595,2009,121,1372000,745000,1,3,34,83,0,121,41,80
5937,E02000595,2010,140,1668000,910000,0,1,42,97,0,140,40,100
5938,E02000595,2011,136,1902000,960000,0,4,43,89,0,136,45,91
5939,E02000595,2012,130,1677000,898000,1,1,29,99,2,128,30,100
5940,E02000595,2013,156,2216000,997000,1,7,36,112,7,149,38,118
5941,E02000595,2014,62,1856000,1112000,0,2,16,44,0,62,16,46
5942,E02000596,2009,121,976000,675000,0,4,13,104,0,121,19,102
5943,E02000596,2010,170,1040000,690000,0,3,26,141,0,170,28,142
5944,E02000596,2011,180,1215000,748000,1,2,29,148,0,180,32,148
5945,E02000596,2012,171,1242000,765000,0,1,28,142,1,170,27,144
5946,E02000596,2013,158,1536000,973000,0,0,30,128,0,158,28,130
5947,E02000596,2014,66,2003000,1040000,0,2,10,54,0,66,11,55
5948,E02000597,2009,52,755000,675000,0,0,15,37,0,52,14,38
5949,E02000597,2010,60,864000,640000,0,1,13,46,0,60,14,46
5950,E02000597,2011,96,876000,630000,0,3,15,78,10,86,15,81
5951,E02000597,2012,82,919000,619000,1,1,11,69,3,79,12,70
5952,E02000597,2013,109,929000,635000,0,1,16,92,0,109,12,97
5953,E02000597,2014,35,939000,778000,0,0,4,31,0,35,5,30
5954,E02000598,2009,103,423000,370000,17,43,28,15,1,102,84,19
5955,E02000598,2010,123,465000,422000,21,36,37,29,2,121,93,30
5956,E02000598,2011,97,496000,440000,20,23,29,25,0,97,71,26
5957,E02000598,2012,79,477000,445000,8,26,25,20,0,79,58,21
5958,E02000598,2013,103,604000,550000,19,35,33,16,3,100,87,16
5959,E02000598,2014,40,575000,538000,5,12,14,9,1,39,31,9
5960,E02000599,2009,69,845000,615000,47,9,4,9,1,68,60,9
5961,E02000599,2010,75,1301000,778000,43,18,5,9,2,73,63,12
5962,E02000599,2011,63,958000,750000,35,17,5,6,0,63,57,6
5963,E02000599,2012,81,1120000,800000,37,27,5,12,0,81,69,12
5964,E02000599,2013,76,1336000,955000,48,18,5,5,0,76,71,5
5965,E02000599,2014,35,966000,750000,12,15,2,6,0,35,29,6
5966,E02000600,2009,101,360000,280000,12,24,26,39,1,100,62,39
5967,E02000600,2010,126,386000,332000,11,35,18,62,0,126,65,61
5968,E02000600,2011,121,382000,288000,9,31,23,58,0,121,62,59
5969,E02000600,2012,101,394000,351000,8,20,27,46,0,101,54,47
5970,E02000600,2013,149,482000,315000,13,29,21,86,5,144,61,88
5971,E02000600,2014,47,488000,350000,5,6,7,29,3,44,18,29
5972,E02000601,2009,139,378000,353000,27,45,21,46,0,139,94,45
5973,E02000601,2010,208,397000,370000,32,63,16,97,34,174,111,97
5974,E02000601,2011,219,391000,345000,25,52,27,115,61,158,105,114
5975,E02000601,2012,160,446000,413000,24,40,21,75,12,148,85,75
5976,E02000601,2013,235,466000,425000,16,52,15,152,67,168,84,151
5977,E02000601,2014,65,537000,495000,7,13,12,33,8,57,33,32
5978,E02000602,2009,104,275000,250000,6,29,27,42,1,103,63,41
5979,E02000602,2010,136,306000,274000,14,39,17,66,7,129,70,66
5980,E02000602,2011,122,333000,297000,9,37,25,51,0,122,72,50
5981,E02000602,2012,120,325000,302000,11,39,25,45,0,120,73,47
5982,E02000602,2013,141,358000,330000,6,45,17,73,5,136,68,73
5983,E02000602,2014,60,433000,385000,8,18,9,25,0,60,35,25
5984,E02000603,2009,59,306000,250000,6,20,25,8,1,58,51,8
5985,E02000603,2010,52,313000,274000,2,21,22,7,0,52,44,8
5986,E02000603,2011,61,303000,265000,0,27,26,8,0,61,53,8
5987,E02000603,2012,76,308000,262000,1,21,31,23,1,75,52,24
5988,E02000603,2013,90,359000,301000,2,37,29,22,2,88,68,22
5989,E02000603,2014,25,386000,337000,1,9,11,4,0,25,21,4
5990,E02000604,2009,83,322000,310000,5,23,30,25,2,81,58,25
5991,E02000604,2010,123,330000,290000,12,34,26,51,7,116,69,54
5992,E02000604,2011,91,376000,325000,10,29,27,25,1,90,69,22
5993,E02000604,2012,120,384000,342000,7,36,46,31,0,120,90,30
5994,E02000604,2013,123,412000,370000,6,35,46,36,0,123,86,37
5995,E02000604,2014,43,480000,410000,4,8,21,10,1,42,33,10
5996,E02000605,2009,95,307000,300000,10,45,22,18,0,95,79,16
5997,E02000605,2010,138,372000,330000,17,57,34,30,1,137,105,33
5998,E02000605,2011,106,371000,330000,15,43,26,22,0,106,83,23
5999,E02000605,2012,107,403000,350000,14,36,37,20,2,105,84,23
6000,E02000605,2013,152,402000,366000,13,53,47,39,2,150,112,40
6001,E02000605,2014,37,507000,424000,3,10,11,13,4,33,24,13
6002,E02000606,2009,152,308000,262000,10,28,5,109,3,149,40,112
6003,E02000606,2010,187,338000,300000,10,22,18,137,0,187,49,138
6004,E02000606,2011,212,331000,285000,10,23,14,165,1,211,44,168
6005,E02000606,2012,232,381000,320000,8,35,14,175,22,210,57,175
6006,E02000606,2013,247,382000,330000,11,29,18,189,25,222,58,189
6007,E02000606,2014,74,409000,377000,4,3,6,61,0,74,13,61
6008,E02000607,2009,83,336000,305000,10,33,12,28,0,83,54,29
6009,E02000607,2010,106,386000,359000,15,38,17,36,7,99,69,37
6010,E02000607,2011,112,384000,361000,14,48,18,32,0,112,76,36
6011,E02000607,2012,103,391000,359000,12,38,13,40,1,102,63,40
6012,E02000607,2013,103,436000,404000,15,37,18,33,1,102,69,34
6013,E02000607,2014,48,463000,428000,6,13,13,16,1,47,30,18
6014,E02000608,2009,116,246000,232000,0,16,11,89,16,100,26,90
6015,E02000608,2010,159,301000,265000,1,13,17,128,0,159,29,130
6016,E02000608,2011,143,328000,285000,5,17,13,108,7,136,35,108
6017,E02000608,2012,159,344000,330000,2,8,19,130,39,120,27,132
6018,E02000608,2013,184,352000,310000,4,18,10,152,15,169,32,152
6019,E02000608,2014,58,385000,354000,1,3,7,47,0,58,11,47
6020,E02000609,2009,74,326000,305000,19,31,10,14,0,74,60,14
6021,E02000609,2010,57,425000,340000,16,25,7,9,3,54,48,9
6022,E02000609,2011,61,368000,355000,7,35,7,12,0,61,49,12
6023,E02000609,2012,55,371000,365000,13,26,5,11,0,55,44,11
6024,E02000609,2013,102,390000,390000,19,51,8,24,5,97,78,24
6025,E02000609,2014,29,451000,445000,13,9,0,7,0,29,23,6
6026,E02000610,2009,106,291000,240000,6,14,15,71,0,106,34,72
6027,E02000610,2010,151,340000,276000,12,18,26,95,1,150,56,95
6028,E02000610,2011,159,322000,250000,13,13,13,120,1,158,38,121
6029,E02000610,2012,144,322000,271000,5,14,19,106,1,143,37,107
6030,E02000610,2013,160,341000,296000,8,7,23,122,3,157,38,122
6031,E02000610,2014,56,406000,333000,5,4,6,41,9,47,15,41
6032,E02000611,2009,76,360000,352000,13,54,4,5,0,76,71,5
6033,E02000611,2010,77,403000,400000,16,61,0,0,0,77,77,0
6034,E02000611,2011,71,413000,385000,11,54,3,3,0,71,68,3
6035,E02000611,2012,88,460000,450000,17,67,2,2,0,88,86,2
6036,E02000611,2013,89,463000,455000,17,66,1,5,1,88,84,5
6037,E02000611,2014,33,518000,500000,9,20,1,3,0,33,30,3
6038,E02000612,2009,92,310000,308000,9,46,23,14,0,92,78,14
6039,E02000612,2010,101,356000,362000,5,57,25,14,0,101,86,15
6040,E02000612,2011,96,375000,368000,12,48,28,8,0,96,88,8
6041,E02000612,2012,98,375000,368000,22,36,22,18,1,97,80,18
6042,E02000612,2013,117,394000,375000,19,48,31,19,0,117,98,19
6043,E02000612,2014,52,405000,397000,7,16,13,16,0,52,36,16
6044,E02000613,2009,122,317000,250000,16,35,20,51,16,106,71,51
6045,E02000613,2010,140,335000,268000,19,34,38,49,0,140,90,50
6046,E02000613,2011,142,356000,270000,18,45,29,50,2,140,92,50
6047,E02000613,2012,165,363000,280000,18,50,27,70,7,158,93,72
6048,E02000613,2013,169,414000,350000,25,41,38,65,2,167,102,67
6049,E02000613,2014,47,439000,325000,7,12,7,21,1,46,26,21
6050,E02000614,2009,92,215000,219000,1,26,43,22,0,92,71,21
6051,E02000614,2010,87,248000,248000,2,21,50,14,0,87,74,13
6052,E02000614,2011,90,264000,250000,4,30,47,9,0,90,78,12
6053,E02000614,2012,116,282000,262000,3,43,51,19,0,116,98,18
6054,E02000614,2013,154,307000,304000,4,53,48,49,35,119,103,51
6055,E02000614,2014,41,325000,330000,0,13,19,9,0,41,32,9
6056,E02000615,2009,80,263000,241000,10,45,12,13,0,80,68,12
6057,E02000615,2010,98,257000,249000,6,43,25,24,0,98,74,24
6058,E02000615,2011,67,256000,250000,5,33,17,12,0,67,55,12
6059,E02000615,2012,91,268000,250000,6,53,20,12,0,91,79,12
6060,E02000615,2013,124,281000,276000,18,53,26,27,14,110,97,27
6061,E02000615,2014,34,289000,298000,1,19,5,9,1,33,24,10
6062,E02000616,2009,57,214000,215000,2,10,38,7,0,57,50,7
6063,E02000616,2010,82,241000,241000,6,13,53,10,0,82,71,11
6064,E02000616,2011,88,243000,240000,5,16,55,12,1,87,74,14
6065,E02000616,2012,101,237000,237000,4,12,67,18,0,101,83,18
6066,E02000616,2013,99,262000,260000,7,13,70,9,2,97,91,8
6067,E02000616,2014,30,314000,316000,2,1,22,5,0,30,25,5
6068,E02000617,2009,74,242000,225000,10,22,25,17,0,74,57,17
6069,E02000617,2010,105,255000,240000,8,44,25,28,0,105,77,28
6070,E02000617,2011,113,256000,250000,15,37,37,24,0,113,90,23
6071,E02000617,2012,104,259000,245000,17,27,33,27,3,101,77,27
6072,E02000617,2013,132,275000,250000,13,40,40,39,1,131,93,39
6073,E02000617,2014,41,313000,315000,6,15,13,7,1,40,34,7
6074,E02000619,2009,58,353000,250000,0,0,9,49,5,53,8,50
6075,E02000619,2010,78,372000,288000,0,2,14,62,20,58,15,63
6076,E02000619,2011,77,349000,288000,0,2,8,67,23,54,10,67
6077,E02000619,2012,70,414000,329000,0,2,14,54,9,61,16,54
6078,E02000619,2013,58,553000,440000,0,0,15,43,1,57,14,44
6079,E02000619,2014,29,519000,400000,0,0,7,22,0,29,6,23
6080,E02000620,2009,68,359000,332000,0,2,11,55,15,53,14,54
6081,E02000620,2010,106,460000,367000,0,0,21,85,3,103,20,86
6082,E02000620,2011,103,461000,380000,0,0,20,83,0,103,20,83
6083,E02000620,2012,106,491000,445000,1,0,16,89,1,105,17,89
6084,E02000620,2013,130,527000,425000,0,0,21,109,4,126,22,108
6085,E02000620,2014,40,607000,497000,0,1,6,33,1,39,6,34
6086,E02000621,2009,87,405000,310000,1,0,7,79,16,71,8,79
6087,E02000621,2010,241,393000,355000,0,2,23,216,115,126,21,220
6088,E02000621,2011,161,464000,390000,0,1,21,139,37,124,18,143
6089,E02000621,2012,117,523000,396000,0,0,18,99,1,116,16,101
6090,E02000621,2013,190,839000,665000,1,1,19,169,59,131,20,170
6091,E02000621,2014,94,1443000,925000,0,0,7,87,45,49,6,88
6092,E02000622,2009,69,316000,265000,0,1,13,55,2,67,14,55
6093,E02000622,2010,80,342000,295000,1,0,21,58,0,80,22,58
6094,E02000622,2011,87,432000,320000,2,2,30,53,0,87,30,57
6095,E02000622,2012,89,377000,310000,1,2,20,66,0,89,21,68
6096,E02000622,2013,98,409000,365000,1,0,20,77,0,98,19,79
6097,E02000622,2014,36,424000,350000,0,0,4,32,0,36,5,31
6098,E02000623,2009,36,273000,219000,1,0,5,30,1,35,5,31
6099,E02000623,2010,43,374000,248000,0,2,7,34,1,42,9,34
6100,E02000623,2011,44,384000,249000,0,1,8,35,0,44,9,35
6101,E02000623,2012,63,324000,250000,1,2,8,52,0,63,9,54
6102,E02000623,2013,52,418000,328000,1,2,8,41,1,51,11,41
6103,E02000623,2014,16,388000,326000,0,0,3,13,1,15,3,13
6104,E02000624,2009,44,283000,274000,0,0,3,41,1,43,3,41
6105,E02000624,2010,63,344000,311000,1,4,3,55,0,63,8,55
6106,E02000624,2011,123,343000,320000,1,0,10,112,42,81,8,115
6107,E02000624,2012,99,401000,320000,1,2,15,81,31,68,5,94
6108,E02000624,2013,156,405000,347000,2,3,7,144,14,142,12,144
6109,E02000624,2014,76,446000,380000,0,1,5,70,23,53,4,72
6110,E02000625,2009,39,260000,215000,2,0,3,34,0,39,5,34
6111,E02000625,2010,62,256000,241000,1,0,3,58,1,61,3,59
6112,E02000625,2011,50,276000,230000,0,1,5,44,0,50,6,44
6113,E02000625,2012,80,290000,270000,0,0,3,77,14,66,3,77
6114,E02000625,2013,162,327000,295000,0,1,3,158,75,87,3,159
6115,E02000625,2014,38,337000,316000,0,0,0,38,8,30,0,38
6116,E02000626,2009,17,231000,195000,0,0,4,13,1,16,4,13
6117,E02000626,2010,38,223000,210000,0,0,4,34,2,36,4,34
6118,E02000626,2011,41,264000,218000,0,2,6,33,1,40,7,34
6119,E02000626,2012,38,291000,248000,0,0,8,30,1,37,8,30
6120,E02000626,2013,54,363000,298000,0,0,15,39,0,54,14,40
6121,E02000626,2014,20,303000,257000,0,1,1,18,0,20,2,18
6122,E02000627,2009,66,295000,250000,1,3,6,56,4,62,9,57
6123,E02000627,2010,84,351000,293000,0,3,24,57,4,80,25,59
6124,E02000627,2011,83,374000,320000,1,3,26,53,0,83,31,52
6125,E02000627,2012,96,397000,334000,1,1,21,73,0,96,20,76
6126,E02000627,2013,126,419000,354000,1,2,31,92,3,123,30,96
6127,E02000627,2014,33,459000,383000,0,1,5,27,0,33,6,27
6128,E02000628,2009,29,218000,208000,0,0,5,24,2,27,5,24
6129,E02000628,2010,59,236000,245000,0,1,4,54,14,45,4,55
6130,E02000628,2011,44,238000,230000,0,0,5,39,1,43,5,39
6131,E02000628,2012,46,269000,240000,0,0,3,43,9,37,2,44
6132,E02000628,2013,72,306000,274000,1,1,3,67,3,69,4,68
6133,E02000628,2014,32,398000,327000,0,0,5,27,2,30,5,27
6134,E02000629,2009,97,410000,340000,0,2,24,71,8,89,25,72
6135,E02000629,2010,137,384000,325000,0,2,24,111,10,127,25,112
6136,E02000629,2011,178,397000,359000,2,3,22,151,29,149,25,153
6137,E02000629,2012,158,498000,386000,0,8,30,120,11,147,34,124
6138,E02000629,2013,220,506000,445000,2,8,40,170,8,212,45,175
6139,E02000629,2014,38,675000,502000,1,2,7,28,0,38,9,29
6140,E02000630,2009,104,510000,354000,1,2,23,78,15,89,26,78
6141,E02000630,2010,111,587000,405000,1,0,34,76,1,110,37,74
6142,E02000630,2011,125,583000,382000,3,4,30,88,1,124,34,91
6143,E02000630,2012,117,693000,427000,2,4,31,80,3,114,35,82
6144,E02000630,2013,133,593000,469000,1,4,32,96,6,127,33,100
6145,E02000630,2014,40,941000,525000,1,2,15,22,1,39,16,24
6146,E02000631,2009,64,311000,260000,2,7,24,31,1,63,33,31
6147,E02000631,2010,107,358000,282000,5,9,33,60,1,106,45,62
6148,E02000631,2011,109,404000,316000,0,7,42,60,3,106,48,61
6149,E02000631,2012,130,424000,349000,4,10,49,67,3,127,62,68
6150,E02000631,2013,123,509000,400000,5,12,38,68,0,123,52,71
6151,E02000631,2014,45,536000,425000,1,3,10,31,0,45,12,33
6152,E02000632,2009,106,323000,305000,0,0,25,81,6,100,26,80
6153,E02000632,2010,196,341000,321000,2,0,26,168,12,184,28,168
6154,E02000632,2011,205,378000,350000,0,4,60,141,22,183,61,144
6155,E02000632,2012,276,389000,365000,1,1,43,231,88,188,38,238
6156,E02000632,2013,201,462000,439000,0,0,37,164,11,190,34,167
6157,E02000632,2014,74,500000,500000,0,1,16,57,2,72,15,59
6158,E02000633,2009,55,293000,295000,0,0,16,39,1,54,17,38
6159,E02000633,2010,75,322000,300000,1,1,15,58,1,74,17,58
6160,E02000633,2011,64,309000,286000,0,0,11,53,0,64,12,52
6161,E02000633,2012,91,311000,286000,0,0,8,83,0,91,5,86
6162,E02000633,2013,108,380000,351000,0,0,16,92,8,100,16,92
6163,E02000633,2014,27,478000,385000,0,0,5,22,2,25,5,22
6164,E02000634,2009,54,384000,279000,0,1,7,46,10,44,7,47
6165,E02000634,2010,78,363000,328000,1,2,7,68,6,72,10,68
6166,E02000634,2011,70,388000,319000,1,0,8,61,2,68,9,61
6167,E02000634,2012,98,433000,400000,0,2,14,82,12,86,15,83
6168,E02000634,2013,87,525000,400000,1,3,13,70,2,85,17,70
6169,E02000634,2014,29,528000,465000,0,2,3,24,0,29,5,24
6170,E02000635,2009,86,304000,286000,0,2,31,53,6,80,31,55
6171,E02000635,2010,124,371000,301000,1,10,48,65,4,120,58,66
6172,E02000635,2011,101,418000,340000,1,7,39,54,0,101,46,55
6173,E02000635,2012,98,370000,337000,0,2,27,69,2,96,29,69
6174,E02000635,2013,214,397000,346000,2,4,41,167,98,116,45,169
6175,E02000635,2014,20,576000,458000,0,2,5,13,0,20,7,13
6176,E02000636,2009,125,589000,472000,1,15,44,65,3,122,60,65
6177,E02000636,2010,168,622000,465000,2,21,49,96,4,164,65,103
6178,E02000636,2011,171,642000,490000,1,17,55,98,15,156,70,101
6179,E02000636,2012,180,681000,499000,0,12,61,107,21,159,71,109
6180,E02000636,2013,182,855000,658000,1,12,76,93,1,181,88,94
6181,E02000636,2014,53,852000,635000,0,2,20,31,0,53,20,33
6182,E02000637,2009,101,289000,275000,1,3,27,70,7,94,29,72
6183,E02000637,2010,165,317000,290000,0,3,51,111,7,158,52,113
6184,E02000637,2011,123,316000,288000,0,7,27,89,3,120,33,90
6185,E02000637,2012,114,354000,346000,0,4,33,77,3,111,35,79
6186,E02000637,2013,167,414000,385000,0,9,33,125,3,164,42,125
6187,E02000637,2014,50,489000,468000,0,1,12,37,0,50,12,38
6188,E02000638,2009,73,242000,230000,0,2,14,57,6,67,16,57
6189,E02000638,2010,91,280000,247000,0,4,21,66,2,89,24,67
6190,E02000638,2011,89,271000,250000,1,4,18,66,3,86,22,67
6191,E02000638,2012,129,303000,295000,1,1,31,96,0,129,28,101
6192,E02000638,2013,140,346000,305000,0,0,37,103,1,139,35,105
6193,E02000638,2014,49,400000,382000,0,2,12,35,1,48,15,34
6194,E02000639,2009,26,241000,202000,0,2,2,22,1,25,4,22
6195,E02000639,2010,41,234000,200000,0,3,3,35,1,40,6,35
6196,E02000639,2011,43,215000,180000,0,2,0,41,0,43,3,40
6197,E02000639,2012,51,254000,193000,1,4,0,46,0,51,5,46
6198,E02000639,2013,117,300000,250000,0,8,3,106,23,94,10,107
6199,E02000639,2014,32,305000,262000,0,2,0,30,1,31,2,30
6200,E02000640,2009,123,384000,350000,1,5,30,87,3,120,35,88
6201,E02000640,2010,163,437000,395000,2,5,50,106,3,160,55,108
6202,E02000640,2011,172,475000,425000,1,6,70,95,2,170,69,103
6203,E02000640,2012,172,495000,462000,2,9,57,104,3,169,60,112
6204,E02000640,2013,208,530000,493000,4,6,57,141,1,207,59,149
6205,E02000640,2014,52,621000,596000,0,0,16,36,0,52,13,39
6206,E02000641,2009,33,215000,190000,0,1,8,24,0,33,9,24
6207,E02000641,2010,40,228000,228000,0,0,6,34,1,39,5,35
6208,E02000641,2011,53,207000,211000,0,1,8,44,1,52,8,45
6209,E02000641,2012,59,269000,270000,0,1,16,42,1,58,17,42
6210,E02000641,2013,78,299000,283000,0,0,13,65,15,63,14,64
6211,E02000641,2014,27,347000,300000,0,1,3,23,0,27,4,23
6212,E02000642,2009,73,347000,300000,2,6,26,39,5,68,31,42
6213,E02000642,2010,117,364000,300000,1,11,34,71,5,112,45,72
6214,E02000642,2011,115,368000,310000,2,13,30,70,1,114,42,73
6215,E02000642,2012,120,367000,290000,2,8,31,79,3,117,41,79
6216,E02000642,2013,162,397000,339000,3,11,45,103,8,154,54,108
6217,E02000642,2014,60,424000,364000,0,3,16,41,1,59,16,44
6218,E02000643,2009,67,283000,250000,0,6,11,50,1,66,13,54
6219,E02000643,2010,111,389000,310000,0,9,25,77,1,110,33,78
6220,E02000643,2011,162,364000,290000,0,20,25,117,0,162,39,123
6221,E02000643,2012,132,398000,312000,2,16,23,91,0,132,38,94
6222,E02000643,2013,162,423000,360000,1,11,25,125,3,159,36,126
6223,E02000643,2014,51,481000,400000,0,6,5,40,0,51,11,40
6224,E02000644,2009,66,258000,245000,2,5,8,51,5,61,15,51
6225,E02000644,2010,91,303000,260000,2,22,14,53,3,88,39,52
6226,E02000644,2011,116,308000,270000,4,25,21,66,2,114,48,68
6227,E02000644,2012,155,326000,285000,4,31,26,94,3,152,59,96
6228,E02000644,2013,178,347000,295000,5,24,27,122,3,175,54,124
6229,E02000644,2014,40,370000,348000,0,7,5,28,1,39,12,28
6230,E02000645,2009,98,306000,239000,2,8,30,58,2,96,42,56
6231,E02000645,2010,122,336000,250000,1,17,25,79,2,120,43,79
6232,E02000645,2011,133,371000,267000,1,24,31,77,3,130,54,79
6233,E02000645,2012,145,401000,300000,1,24,42,78,2,143,66,79
6234,E02000645,2013,174,382000,295000,2,24,42,106,14,160,63,111
6235,E02000645,2014,60,403000,365000,1,3,20,36,0,60,23,37
6236,E02000646,2009,93,276000,228000,3,6,24,60,6,87,30,63
6237,E02000646,2010,107,335000,275000,5,9,27,66,1,106,39,68
6238,E02000646,2011,130,312000,248000,9,15,20,86,1,129,42,88
6239,E02000646,2012,167,319000,262000,3,16,32,116,7,160,45,122
6240,E02000646,2013,216,360000,295000,7,22,28,159,7,209,54,162
6241,E02000646,2014,62,454000,353000,3,6,5,48,1,61,14,48
6242,E02000647,2009,55,249000,230000,1,10,11,33,0,55,22,33
6243,E02000647,2010,90,265000,250000,2,11,19,58,0,90,32,58
6244,E02000647,2011,95,312000,290000,3,31,13,48,0,95,48,47
6245,E02000647,2012,98,337000,290000,6,21,22,49,3,95,48,50
6246,E02000647,2013,152,328000,282000,7,24,21,100,1,151,50,102
6247,E02000647,2014,44,381000,350000,2,4,8,30,1,43,14,30
6248,E02000648,2009,57,220000,220000,1,7,23,26,13,44,32,25
6249,E02000648,2010,56,240000,235000,0,3,28,25,0,56,34,22
6250,E02000648,2011,65,216000,191000,0,6,17,42,0,65,23,42
6251,E02000648,2012,57,258000,250000,0,11,23,23,0,57,34,23
6252,E02000648,2013,110,265000,250000,0,3,40,67,7,103,41,69
6253,E02000648,2014,36,276000,224000,1,3,5,27,3,33,8,28
6254,E02000649,2009,93,285000,240000,2,7,20,64,1,92,29,64
6255,E02000649,2010,128,270000,241000,0,9,23,96,3,125,30,98
6256,E02000649,2011,127,263000,230000,1,11,20,95,0,127,30,97
6257,E02000649,2012,194,303000,247000,6,22,32,134,4,190,61,133
6258,E02000649,2013,244,312000,265000,3,16,27,198,4,240,46,198
6259,E02000649,2014,86,386000,326000,6,5,14,61,0,86,23,63
6260,E02000650,2009,58,254000,235000,2,7,9,40,3,55,19,39
6261,E02000650,2010,81,276000,239000,0,17,11,53,4,77,30,51
6262,E02000650,2011,86,278000,239000,1,14,15,56,1,85,29,57
6263,E02000650,2012,105,283000,268000,2,8,23,72,0,105,29,76
6264,E02000650,2013,142,327000,295000,2,12,28,100,1,141,38,104
6265,E02000650,2014,51,337000,295000,0,3,13,35,0,51,16,35
6266,E02000651,2009,50,272000,230000,0,9,12,29,4,46,23,27
6267,E02000651,2010,88,305000,250000,1,19,22,46,1,87,41,47
6268,E02000651,2011,70,264000,247000,1,10,17,42,2,68,29,41
6269,E02000651,2012,101,315000,272000,3,17,25,56,2,99,45,56
6270,E02000651,2013,156,340000,300000,2,24,29,101,11,145,54,102
6271,E02000651,2014,54,431000,371000,0,11,16,27,4,50,27,27
6272,E02000652,2009,29,226000,230000,0,0,25,4,0,29,26,3
6273,E02000652,2010,51,244000,250000,0,2,44,5,0,51,47,4
6274,E02000652,2011,49,239000,245000,0,4,42,3,0,49,45,4
6275,E02000652,2012,50,256000,250000,0,1,43,6,0,50,46,4
6276,E02000652,2013,65,281000,279000,1,1,53,10,0,65,54,11
6277,E02000652,2014,26,338000,365000,0,0,20,6,0,26,19,7
6278,E02000653,2009,36,224000,206000,0,0,10,26,2,34,10,26
6279,E02000653,2010,45,250000,245000,0,3,14,28,0,45,15,30
6280,E02000653,2011,55,240000,246000,0,3,22,30,0,55,20,35
6281,E02000653,2012,52,264000,275000,0,1,21,30,0,52,18,34
6282,E02000653,2013,143,302000,288000,0,0,17,126,53,90,13,130
6283,E02000653,2014,26,296000,295000,0,0,7,19,0,26,7,19
6284,E02000654,2009,52,208000,205000,1,0,1,50,44,8,2,50
6285,E02000654,2010,39,185000,160000,2,0,3,34,3,36,5,34
6286,E02000654,2011,34,164000,147000,0,0,2,32,0,34,2,32
6287,E02000654,2012,38,203000,174000,0,0,9,29,1,37,8,30
6288,E02000654,2013,43,229000,214000,0,0,5,38,0,43,5,38
6289,E02000654,2014,14,212000,230000,0,0,0,14,0,14,0,14
6290,E02000655,2009,64,193000,164000,0,0,20,44,20,44,21,43
6291,E02000655,2010,71,200000,175000,1,0,22,48,3,68,23,48
6292,E02000655,2011,60,232000,246000,0,3,29,28,0,60,31,29
6293,E02000655,2012,60,221000,206000,0,0,20,40,1,59,20,40
6294,E02000655,2013,100,233000,199000,0,1,27,72,1,99,25,75
6295,E02000655,2014,41,247000,205000,1,0,6,34,0,41,7,34
6296,E02000657,2009,60,275000,240000,0,3,29,28,6,54,32,28
6297,E02000657,2010,68,318000,250000,3,3,25,37,1,67,30,38
6298,E02000657,2011,126,272000,250000,0,2,25,99,58,68,25,101
6299,E02000657,2012,136,276000,250000,0,7,35,94,43,93,40,96
6300,E02000657,2013,185,322000,278000,1,3,45,136,52,133,47,138
6301,E02000657,2014,37,370000,305000,1,0,11,25,4,33,12,25
6302,E02000658,2009,54,296000,249000,0,7,16,31,0,54,23,31
6303,E02000658,2010,63,352000,248000,0,7,20,36,1,62,24,39
6304,E02000658,2011,79,317000,248000,0,9,19,51,0,79,26,53
6305,E02000658,2012,93,367000,270000,0,11,20,62,7,86,31,62
6306,E02000658,2013,107,353000,310000,1,6,24,76,1,106,28,79
6307,E02000658,2014,31,482000,350000,0,4,7,20,1,30,10,21
6308,E02000659,2009,78,373000,267000,3,9,17,49,0,78,29,49
6309,E02000659,2010,81,415000,330000,2,9,21,49,0,81,31,50
6310,E02000659,2011,98,409000,350000,4,14,17,63,0,98,33,65
6311,E02000659,2012,127,407000,295000,6,10,13,98,17,110,28,99
6312,E02000659,2013,169,444000,312000,11,11,15,132,39,130,37,132
6313,E02000659,2014,36,530000,371000,2,3,4,27,3,33,8,28
6314,E02000660,2009,55,258000,231000,0,5,15,35,0,55,18,37
6315,E02000660,2010,98,309000,267000,4,6,12,76,0,98,22,76
6316,E02000660,2011,100,276000,250000,2,4,16,78,3,97,21,79
6317,E02000660,2012,217,274000,250000,0,6,25,186,65,152,31,186
6318,E02000660,2013,182,318000,280000,5,5,17,155,17,165,24,158
6319,E02000660,2014,53,347000,305000,0,3,4,46,1,52,7,46
6320,E02000661,2009,92,314000,244000,1,3,22,66,12,80,24,68
6321,E02000661,2010,94,378000,318000,1,4,30,59,0,94,31,63
6322,E02000661,2011,85,425000,335000,3,6,21,55,0,85,27,58
6323,E02000661,2012,96,434000,362000,2,3,24,67,1,95,26,70
6324,E02000661,2013,109,425000,365000,2,2,28,77,3,106,30,79
6325,E02000661,2014,42,510000,382000,1,4,7,30,3,39,12,30
6326,E02000662,2009,38,228000,225000,0,3,14,21,0,38,17,21
6327,E02000662,2010,62,263000,250000,0,5,31,26,0,62,35,27
6328,E02000662,2011,73,262000,234000,0,4,28,41,0,73,31,42
6329,E02000662,2012,94,331000,254000,0,8,38,48,5,89,45,49
6330,E02000662,2013,96,299000,245000,0,2,28,66,8,88,28,68
6331,E02000662,2014,26,413000,343000,0,1,11,14,2,24,12,14
6332,E02000663,2009,46,240000,225000,0,2,22,22,0,46,23,23
6333,E02000663,2010,90,278000,266000,1,3,45,41,0,90,47,43
6334,E02000663,2011,83,278000,268000,0,5,37,41,8,75,39,44
6335,E02000663,2012,94,307000,275000,3,4,41,46,6,88,44,50
6336,E02000663,2013,116,373000,342000,2,16,43,55,0,116,57,59
6337,E02000663,2014,31,384000,300000,0,2,8,21,2,29,10,21
6338,E02000664,2009,89,198000,180000,0,7,12,70,33,56,18,71
6339,E02000664,2010,254,196000,174000,0,2,22,230,144,110,22,232
6340,E02000664,2011,190,208000,190000,1,6,24,159,105,85,32,158
6341,E02000664,2012,277,229000,214000,4,6,29,238,184,93,36,241
6342,E02000664,2013,276,251000,247000,1,8,27,240,78,198,35,241
6343,E02000664,2014,101,292000,280000,1,6,6,88,42,59,13,88
6344,E02000665,2009,75,272000,260000,2,10,38,25,1,74,52,23
6345,E02000665,2010,90,312000,281000,4,6,46,34,0,90,55,35
6346,E02000665,2011,90,329000,285000,1,7,53,29,0,90,60,30
6347,E02000665,2012,97,308000,298000,0,8,48,41,10,87,55,42
6348,E02000665,2013,151,355000,312000,3,8,72,68,18,133,83,68
6349,E02000665,2014,51,415000,400000,0,3,29,19,2,49,32,19
6350,E02000666,2009,73,261000,248000,0,10,31,32,1,72,41,32
6351,E02000666,2010,70,269000,250000,0,8,29,33,0,70,36,34
6352,E02000666,2011,80,320000,298000,0,9,51,20,0,80,59,21
6353,E02000666,2012,65,283000,270000,3,5,29,28,2,63,34,31
6354,E02000666,2013,81,335000,288000,0,6,36,39,0,81,42,39
6355,E02000666,2014,42,366000,338000,0,6,13,23,0,42,19,23
6356,E02000667,2009,63,260000,242000,0,3,45,15,0,63,49,14
6357,E02000667,2010,85,291000,290000,1,6,60,18,0,85,66,19
6358,E02000667,2011,87,303000,305000,0,9,58,20,0,87,67,20
6359,E02000667,2012,99,315000,315000,1,11,60,27,1,98,72,27
6360,E02000667,2013,125,372000,380000,0,9,78,38,1,124,85,40
6361,E02000667,2014,29,446000,470000,0,2,21,6,0,29,23,6
6362,E02000668,2009,69,264000,245000,0,12,38,19,0,69,48,21
6363,E02000668,2010,88,285000,250000,2,12,36,38,1,87,49,39
6364,E02000668,2011,91,294000,275000,0,17,46,28,1,90,62,29
6365,E02000668,2012,78,299000,303000,2,11,41,24,3,75,54,24
6366,E02000668,2013,113,365000,340000,5,21,50,37,0,113,73,40
6367,E02000668,2014,39,434000,414000,1,9,14,15,0,39,23,16
6368,E02000669,2009,54,225000,212000,0,1,28,25,2,52,27,27
6369,E02000669,2010,84,239000,222000,0,6,33,45,0,84,42,42
6370,E02000669,2011,121,224000,219000,0,4,56,61,0,121,60,61
6371,E02000669,2012,113,248000,232000,0,6,42,65,1,112,46,67
6372,E02000669,2013,134,267000,244000,2,3,39,90,2,132,40,94
6373,E02000669,2014,55,311000,250000,1,3,16,35,2,53,20,35
6374,E02000670,2009,43,180000,172000,1,6,11,25,0,43,17,26
6375,E02000670,2010,43,223000,200000,2,4,20,17,0,43,24,19
6376,E02000670,2011,50,209000,191000,0,4,25,21,0,50,25,25
6377,E02000670,2012,54,207000,185000,1,4,13,36,3,51,18,36
6378,E02000670,2013,78,234000,217000,1,3,27,47,0,78,31,47
6379,E02000670,2014,26,293000,280000,0,2,9,15,0,26,11,15
6380,E02000671,2009,89,236000,238000,2,6,49,32,3,86,57,32
6381,E02000671,2010,161,277000,250000,2,7,74,78,1,160,79,82
6382,E02000671,2011,120,283000,253000,1,14,49,56,2,118,60,60
6383,E02000671,2012,154,311000,286000,3,8,67,76,5,149,75,79
6384,E02000671,2013,134,349000,313000,4,5,58,67,7,127,66,68
6385,E02000671,2014,51,410000,363000,3,6,15,27,0,51,23,28
6386,E02000672,2009,69,191000,173000,2,2,22,43,1,68,28,41
6387,E02000672,2010,58,219000,212000,0,8,23,27,0,58,30,28
6388,E02000672,2011,70,230000,210000,0,7,31,32,0,70,37,33
6389,E02000672,2012,82,250000,245000,1,15,36,30,0,82,50,32
6390,E02000672,2013,94,272000,242000,1,11,36,46,3,91,48,46
6391,E02000672,2014,25,247000,214000,0,1,8,16,1,24,7,18
6392,E02000673,2009,81,286000,244000,5,18,14,44,7,74,34,47
6393,E02000673,2010,111,365000,285000,8,28,21,54,0,111,54,57
6394,E02000673,2011,106,307000,248000,7,18,12,69,1,105,36,70
6395,E02000673,2012,105,353000,285000,8,17,11,69,1,104,32,73
6396,E02000673,2013,154,399000,310000,13,21,23,97,3,151,56,98
6397,E02000673,2014,61,497000,430000,4,17,9,31,1,60,30,31
6398,E02000674,2009,72,236000,232000,1,4,51,16,4,68,54,18
6399,E02000674,2010,74,250000,250000,0,4,60,10,0,74,60,14
6400,E02000674,2011,71,227000,220000,0,0,55,16,0,71,52,19
6401,E02000674,2012,90,257000,248000,1,3,66,20,0,90,66,24
6402,E02000674,2013,118,280000,277000,1,4,85,28,0,118,84,34
6403,E02000674,2014,47,284000,270000,0,4,25,18,1,46,25,22
6404,E02000675,2009,66,216000,215000,2,18,28,18,0,66,48,18
6405,E02000675,2010,74,250000,238000,4,19,26,25,0,74,48,26
6406,E02000675,2011,77,263000,245000,8,27,26,16,1,76,60,17
6407,E02000675,2012,95,265000,250000,5,25,41,24,0,95,70,25
6408,E02000675,2013,131,269000,265000,3,44,42,42,0,131,87,44
6409,E02000675,2014,55,291000,288000,1,15,19,20,0,55,34,21
6410,E02000676,2009,74,230000,217000,0,8,25,41,0,74,34,40
6411,E02000676,2010,114,277000,250000,2,6,44,62,0,114,52,62
6412,E02000676,2011,106,286000,255000,3,11,44,48,0,106,51,55
6413,E02000676,2012,119,303000,266000,6,12,42,59,2,117,57,62
6414,E02000676,2013,162,348000,318000,3,10,66,83,7,155,77,85
6415,E02000676,2014,60,401000,354000,1,5,19,35,0,60,24,36
6416,E02000677,2009,47,256000,240000,3,7,26,11,0,47,35,12
6417,E02000677,2010,54,260000,242000,1,16,17,20,0,54,33,21
6418,E02000677,2011,56,285000,270000,1,18,19,18,0,56,38,18
6419,E02000677,2012,60,277000,246000,2,21,14,23,1,59,37,23
6420,E02000677,2013,82,308000,287000,1,30,20,31,0,82,50,32
6421,E02000677,2014,33,345000,320000,1,11,10,11,0,33,21,12
6422,E02000678,2009,36,186000,175000,0,2,31,3,0,36,33,3
6423,E02000678,2010,70,182000,172000,0,9,33,28,20,50,42,28
6424,E02000678,2011,63,166000,152000,0,0,31,32,23,40,31,32
6425,E02000678,2012,51,206000,210000,0,1,43,7,0,51,44,7
6426,E02000678,2013,80,193000,193000,0,5,50,25,1,79,55,25
6427,E02000678,2014,35,217000,222000,0,2,24,9,0,35,26,9
6428,E02000679,2009,46,247000,230000,3,9,22,12,0,46,33,13
6429,E02000679,2010,123,260000,248000,3,11,30,79,44,79,44,79
6430,E02000679,2011,78,278000,258000,5,7,34,32,2,76,43,35
6431,E02000679,2012,90,270000,248000,4,7,27,52,1,89,39,51
6432,E02000679,2013,128,278000,240000,6,7,39,76,1,127,50,78
6433,E02000679,2014,44,343000,292000,4,2,11,27,0,44,17,27
6434,E02000680,2009,50,229000,220000,0,5,22,23,1,49,27,23
6435,E02000680,2010,64,264000,232000,2,8,15,39,1,63,25,39
6436,E02000680,2011,67,277000,235000,1,10,20,36,0,67,31,36
6437,E02000680,2012,94,298000,248000,4,12,26,52,5,89,41,53
6438,E02000680,2013,96,309000,240000,2,9,26,59,0,96,35,61
6439,E02000680,2014,49,372000,300000,1,3,14,31,0,49,18,31
6440,E02000681,2009,45,200000,185000,0,6,24,15,0,45,31,14
6441,E02000681,2010,53,209000,212000,0,10,27,16,0,53,38,15
6442,E02000681,2011,61,218000,220000,0,16,35,10,0,61,51,10
6443,E02000681,2012,46,236000,218000,2,10,25,9,0,46,37,9
6444,E02000681,2013,69,239000,227000,1,18,30,20,0,69,49,20
6445,E02000681,2014,27,288000,280000,0,4,17,6,0,27,21,6
6446,E02000682,2009,56,199000,213000,0,15,29,12,0,56,45,11
6447,E02000682,2010,54,213000,220000,1,17,24,12,0,54,42,12
6448,E02000682,2011,59,215000,235000,0,20,27,12,0,59,47,12
6449,E02000682,2012,53,228000,235000,2,20,21,10,2,51,43,10
6450,E02000682,2013,73,249000,250000,1,22,39,11,0,73,60,13
6451,E02000682,2014,33,252000,265000,0,9,14,10,0,33,21,12
6452,E02000683,2009,48,191000,182000,1,6,29,12,0,48,36,12
6453,E02000683,2010,42,182000,174000,1,2,22,17,0,42,25,17
6454,E02000683,2011,52,181000,185000,0,8,26,18,0,52,32,20
6455,E02000683,2012,52,205000,205000,0,12,26,14,0,52,38,14
6456,E02000683,2013,80,226000,206000,2,21,33,24,2,78,55,25
6457,E02000683,2014,30,207000,208000,0,2,12,16,4,26,14,16
6458,E02000685,2009,45,223000,195000,1,9,10,25,0,45,19,26
6459,E02000685,2010,72,229000,221000,1,4,23,44,1,71,26,46
6460,E02000685,2011,80,282000,248000,3,14,28,35,0,80,41,39
6461,E02000685,2012,87,243000,232000,2,8,25,52,0,87,35,52
6462,E02000685,2013,120,274000,241000,3,7,25,85,6,114,34,86
6463,E02000685,2014,36,347000,334000,0,5,13,18,0,36,16,20
6464,E02000686,2009,27,175000,175000,0,1,14,12,0,27,15,12
6465,E02000686,2010,22,158000,154000,0,4,3,15,0,22,7,15
6466,E02000686,2011,43,180000,182000,0,11,14,18,0,43,25,18
6467,E02000686,2012,33,198000,203000,0,7,14,12,0,33,21,12
6468,E02000686,2013,70,199000,200000,0,7,15,48,18,52,21,49
6469,E02000686,2014,26,230000,209000,0,2,11,13,1,25,13,13
6470,E02000687,2009,57,247000,225000,2,7,27,21,0,57,36,21
6471,E02000687,2010,70,264000,250000,2,5,28,35,0,70,35,35
6472,E02000687,2011,97,275000,245000,2,13,44,38,0,97,58,39
6473,E02000687,2012,103,306000,268000,2,15,42,44,1,102,57,46
6474,E02000687,2013,120,321000,295000,2,14,41,63,0,120,55,65
6475,E02000687,2014,32,432000,388000,0,1,18,13,0,32,19,13
6476,E02000689,2009,239,389000,225000,9,16,49,165,91,148,74,165
6477,E02000689,2010,149,524000,495000,4,12,82,51,0,149,98,51
6478,E02000689,2011,139,698000,582000,11,15,73,40,0,139,98,41
6479,E02000689,2012,128,646000,550000,3,11,73,41,5,123,87,41
6480,E02000689,2013,166,647000,598000,5,9,84,68,10,156,95,71
6481,E02000689,2014,46,730000,698000,2,4,27,13,0,46,33,13
6482,E02000690,2009,63,1230000,825000,21,12,9,21,0,63,39,24
6483,E02000690,2010,97,2065000,1400000,40,13,21,23,7,90,70,27
6484,E02000690,2011,82,1615000,1150000,29,11,20,22,2,80,56,26
6485,E02000690,2012,74,1693000,1175000,32,5,14,23,0,74,49,25
6486,E02000690,2013,90,1925000,1288000,30,14,21,25,1,89,60,30
6487,E02000690,2014,31,1828000,1395000,13,1,5,12,0,31,18,13
6488,E02000691,2009,124,453000,344000,2,24,21,77,37,87,45,79
6489,E02000691,2010,136,503000,407000,5,27,24,80,18,118,54,82
6490,E02000691,2011,137,562000,400000,3,30,28,76,7,130,58,79
6491,E02000691,2012,124,553000,392000,1,27,26,70,7,117,51,73
6492,E02000691,2013,129,706000,590000,6,35,34,54,1,128,74,55
6493,E02000691,2014,47,700000,550000,0,12,10,25,0,47,23,24
6494,E02000692,2009,138,657000,450000,16,18,19,85,9,129,48,90
6495,E02000692,2010,139,708000,450000,12,15,15,97,10,129,37,102
6496,E02000692,2011,143,778000,450000,15,17,22,89,4,139,49,94
6497,E02000692,2012,143,815000,500000,15,16,22,90,10,133,52,91
6498,E02000692,2013,190,864000,537000,18,21,25,126,6,184,61,129
6499,E02000692,2014,59,855000,571000,7,3,8,41,0,59,18,41
6500,E02000693,2009,109,259000,242000,0,11,42,56,0,109,44,65
6501,E02000693,2010,133,262000,243000,0,9,34,90,0,133,37,96
6502,E02000693,2011,150,267000,240000,3,15,37,95,0,150,44,106
6503,E02000693,2012,155,283000,250000,1,15,34,105,1,154,44,111
6504,E02000693,2013,217,306000,270000,0,11,44,162,2,215,55,162
6505,E02000693,2014,61,355000,318000,0,5,14,42,0,61,18,43
6506,E02000694,2009,121,396000,390000,3,14,80,24,0,121,96,25
6507,E02000694,2010,178,399000,369000,2,16,109,51,4,174,126,52
6508,E02000694,2011,175,426000,392000,1,17,108,49,0,175,125,50
6509,E02000694,2012,154,443000,389000,1,19,81,53,1,153,101,53
6510,E02000694,2013,205,510000,475000,3,22,113,67,0,205,135,70
6511,E02000694,2014,71,592000,600000,0,3,46,22,0,71,48,23
6512,E02000695,2009,47,246000,245000,0,2,42,3,0,47,45,2
6513,E02000695,2010,61,262000,250000,2,7,44,8,1,60,53,8
6514,E02000695,2011,70,263000,250000,1,8,48,13,1,69,58,12
6515,E02000695,2012,64,303000,297000,5,3,50,6,0,64,58,6
6516,E02000695,2013,75,328000,320000,1,2,62,10,1,74,64,11
6517,E02000695,2014,35,420000,440000,0,2,30,3,0,35,32,3
6518,E02000696,2009,63,202000,198000,0,3,32,28,1,62,33,30
6519,E02000696,2010,84,209000,199000,1,3,40,40,0,84,39,45
6520,E02000696,2011,81,212000,214000,1,5,29,46,0,81,34,47
6521,E02000696,2012,106,216000,215000,0,2,42,62,1,105,40,66
6522,E02000696,2013,101,242000,230000,0,3,38,60,2,99,37,64
6523,E02000696,2014,53,268000,250000,0,2,19,32,1,52,21,32
6524,E02000697,2009,115,384000,382000,5,15,46,49,8,107,65,50
6525,E02000697,2010,180,435000,420000,2,29,78,71,5,175,108,72
6526,E02000697,2011,147,450000,445000,3,15,73,56,0,147,88,59
6527,E02000697,2012,136,456000,448000,3,10,63,60,1,135,75,61
6528,E02000697,2013,172,517000,435000,2,20,65,85,0,172,84,88
6529,E02000697,2014,44,582000,570000,1,7,16,20,0,44,22,22
6530,E02000698,2009,112,552000,468000,20,28,24,40,3,109,70,42
6531,E02000698,2010,120,666000,542000,28,28,22,42,0,120,78,42
6532,E02000698,2011,140,779000,581000,27,38,37,38,3,137,100,40
6533,E02000698,2012,119,746000,605000,23,35,24,37,1,118,79,40
6534,E02000698,2013,153,875000,674000,33,30,25,65,8,145,87,66
6535,E02000698,2014,57,740000,650000,3,15,16,23,0,57,33,24
6536,E02000699,2009,103,348000,318000,2,15,42,44,1,102,57,46
6537,E02000699,2010,139,409000,380000,5,26,59,49,0,139,85,54
6538,E02000699,2011,143,411000,380000,3,24,64,52,1,142,88,55
6539,E02000699,2012,142,461000,402000,3,16,69,54,4,138,82,60
6540,E02000699,2013,172,513000,450000,5,20,76,71,5,167,95,77
6541,E02000699,2014,59,550000,525000,1,8,26,24,1,58,33,26
6542,E02000700,2009,60,197000,194000,0,5,28,27,0,60,32,28
6543,E02000700,2010,63,213000,215000,0,1,30,32,0,63,30,33
6544,E02000700,2011,73,217000,205000,2,5,27,39,0,73,36,37
6545,E02000700,2012,85,213000,217000,0,2,28,55,8,77,30,55
6546,E02000700,2013,88,233000,236000,1,4,37,46,0,88,44,44
6547,E02000700,2014,41,254000,245000,1,2,18,20,2,39,22,19
6548,E02000701,2009,58,205000,202000,0,8,35,15,2,56,43,15
6549,E02000701,2010,59,213000,220000,3,10,30,16,0,59,44,15
6550,E02000701,2011,65,214000,225000,1,4,50,10,2,63,54,11
6551,E02000701,2012,74,213000,230000,0,12,41,21,6,68,52,22
6552,E02000701,2013,75,234000,235000,4,3,47,21,0,75,54,21
6553,E02000701,2014,20,300000,322000,0,4,12,4,0,20,15,5
6554,E02000702,2009,62,189000,200000,1,6,34,21,0,62,42,20
6555,E02000702,2010,56,190000,184000,0,4,23,29,0,56,28,28
6556,E02000702,2011,52,205000,216000,0,3,35,14,1,51,39,13
6557,E02000702,2012,131,205000,210000,0,7,29,95,50,81,36,95
6558,E02000702,2013,114,222000,226000,1,12,49,52,28,86,61,53
6559,E02000702,2014,38,265000,252000,2,2,21,13,0,38,24,14
6560,E02000703,2009,84,381000,350000,5,29,28,22,4,80,63,21
6561,E02000703,2010,100,417000,388000,4,30,37,29,0,100,70,30
6562,E02000703,2011,109,484000,421000,7,35,45,22,1,108,87,22
6563,E02000703,2012,103,466000,435000,2,32,38,31,0,103,72,31
6564,E02000703,2013,125,493000,475000,4,41,38,42,0,125,84,41
6565,E02000703,2014,44,670000,555000,5,8,22,9,0,44,33,11
6566,E02000704,2009,111,265000,250000,3,24,33,51,0,111,61,50
6567,E02000704,2010,130,301000,250000,1,16,49,64,1,129,64,66
6568,E02000704,2011,155,304000,265000,1,18,42,94,48,107,60,95
6569,E02000704,2012,154,335000,305000,5,23,36,90,21,133,62,92
6570,E02000704,2013,175,373000,310000,4,25,58,88,9,166,83,92
6571,E02000704,2014,65,391000,345000,2,7,19,37,1,64,27,38
6572,E02000705,2009,68,210000,216000,0,5,55,8,0,68,59,9
6573,E02000705,2010,60,226000,226000,0,7,49,4,0,60,55,5
6574,E02000705,2011,62,227000,230000,0,11,43,8,0,62,53,9
6575,E02000705,2012,129,248000,247000,0,10,92,27,47,82,102,27
6576,E02000705,2013,185,274000,265000,1,15,123,46,100,85,139,46
6577,E02000705,2014,51,301000,290000,0,4,36,11,8,43,39,12
6578,E02000706,2009,45,169000,175000,0,4,25,16,2,43,30,15
6579,E02000706,2010,52,184000,186000,1,4,32,15,1,51,34,18
6580,E02000706,2011,58,186000,188000,2,3,31,22,1,57,34,24
6581,E02000706,2012,52,195000,198000,0,1,34,17,4,48,35,17
6582,E02000706,2013,96,226000,236000,8,6,43,39,22,74,57,39
6583,E02000706,2014,35,238000,242000,0,4,14,17,7,28,18,17
6584,E02000707,2009,48,188000,198000,0,5,35,8,2,46,39,9
6585,E02000707,2010,50,204000,220000,0,8,37,5,0,50,46,4
6586,E02000707,2011,51,203000,210000,0,5,37,9,0,51,42,9
6587,E02000707,2012,43,224000,241000,0,4,36,3,0,43,39,4
6588,E02000707,2013,38,226000,236000,0,3,27,8,0,38,29,9
6589,E02000707,2014,17,260000,285000,0,3,11,3,0,17,14,3
6590,E02000708,2009,70,291000,306000,1,14,47,8,0,70,59,11
6591,E02000708,2010,98,330000,330000,4,16,65,13,0,98,85,13
6592,E02000708,2011,138,312000,319000,1,15,70,52,36,102,85,53
6593,E02000708,2012,144,345000,345000,5,21,69,49,42,102,93,51
6594,E02000708,2013,127,404000,405000,3,20,86,18,2,125,103,24
6595,E02000708,2014,44,426000,434000,1,9,26,8,0,44,33,11
6596,E02000709,2009,84,275000,273000,3,21,46,14,0,84,67,17
6597,E02000709,2010,63,321000,306000,0,11,43,9,0,63,53,10
6598,E02000709,2011,80,303000,315000,0,24,37,19,0,80,61,19
6599,E02000709,2012,98,342000,344000,1,21,67,9,0,98,84,14
6600,E02000709,2013,105,352000,365000,1,18,62,24,0,105,81,24
6601,E02000709,2014,37,437000,435000,0,7,26,4,0,37,32,5
6602,E02000710,2009,76,218000,208000,4,15,24,33,3,73,44,32
6603,E02000710,2010,76,226000,220000,2,22,20,32,2,74,44,32
6604,E02000710,2011,60,213000,210000,6,14,15,25,6,54,35,25
6605,E02000710,2012,64,236000,228000,5,10,22,27,3,61,37,27
6606,E02000710,2013,79,279000,250000,5,25,24,25,4,75,54,25
6607,E02000710,2014,29,271000,258000,0,8,10,11,0,29,18,11
6608,E02000711,2009,76,204000,200000,0,10,50,16,0,76,60,16
6609,E02000711,2010,165,222000,200000,1,10,68,86,91,74,78,87
6610,E02000711,2011,145,212000,210000,1,7,58,79,56,89,66,79
6611,E02000711,2012,138,234000,218000,1,6,64,67,61,77,71,67
6612,E02000711,2013,129,224000,215000,2,4,44,79,46,83,51,78
6613,E02000711,2014,54,250000,250000,2,4,19,29,12,42,26,28
6614,E02000712,2009,64,204000,199000,0,8,43,13,0,64,50,14
6615,E02000712,2010,60,212000,210000,0,7,35,18,0,60,42,18
6616,E02000712,2011,68,219000,220000,0,7,47,14,0,68,53,15
6617,E02000712,2012,77,231000,226000,0,4,58,15,0,77,61,16
6618,E02000712,2013,91,256000,248000,0,6,69,16,0,91,75,16
6619,E02000712,2014,23,255000,248000,0,3,12,8,0,23,15,8
6620,E02000713,2009,73,224000,230000,1,16,43,13,0,73,60,13
6621,E02000713,2010,84,253000,250000,0,19,45,20,0,84,63,21
6622,E02000713,2011,72,263000,250000,0,18,45,9,0,72,63,9
6623,E02000713,2012,85,265000,270000,0,12,59,14,0,85,70,15
6624,E02000713,2013,130,281000,282000,2,19,82,27,0,130,102,28
6625,E02000713,2014,40,291000,295000,0,3,29,8,0,40,32,8
6626,E02000714,2009,31,205000,180000,1,1,21,8,0,31,23,8
6627,E02000714,2010,31,215000,205000,0,2,23,6,0,31,25,6
6628,E02000714,2011,46,231000,212000,0,1,38,7,0,46,38,8
6629,E02000714,2012,39,242000,222000,1,3,26,9,0,39,30,9
6630,E02000714,2013,65,260000,241000,1,4,46,14,0,65,51,14
6631,E02000714,2014,25,288000,270000,0,1,13,11,0,25,14,11
6632,E02000715,2009,26,172000,173000,0,0,18,8,1,25,17,9
6633,E02000715,2010,26,187000,205000,0,0,22,4,0,26,23,3
6634,E02000715,2011,23,194000,190000,0,1,19,3,0,23,20,3
6635,E02000715,2012,24,195000,214000,0,0,18,6,0,24,18,6
6636,E02000715,2013,33,212000,225000,0,0,25,8,0,33,26,7
6637,E02000715,2014,19,214000,235000,0,0,12,7,0,19,12,7
6638,E02000716,2009,23,225000,195000,0,1,17,5,0,23,18,5
6639,E02000716,2010,48,239000,228000,0,3,36,9,0,48,39,9
6640,E02000716,2011,38,230000,210000,0,1,28,9,0,38,29,9
6641,E02000716,2012,30,213000,202000,0,0,20,10,0,30,19,11
6642,E02000716,2013,67,241000,217000,0,1,47,19,0,67,47,20
6643,E02000716,2014,23,263000,228000,0,0,15,8,0,23,15,8
6644,E02000717,2009,27,184000,180000,0,0,19,8,0,27,19,8
6645,E02000717,2010,30,200000,205000,0,0,20,10,0,30,20,10
6646,E02000717,2011,27,192000,200000,0,0,16,11,0,27,15,12
6647,E02000717,2012,36,192000,185000,0,0,19,17,2,34,19,17
6648,E02000717,2013,39,197000,195000,0,0,19,20,1,38,19,20
6649,E02000717,2014,22,223000,235000,0,0,15,7,0,22,15,7
6650,E02000718,2009,14,175000,175000,0,0,10,4,0,14,11,3
6651,E02000718,2010,43,173000,165000,0,0,24,19,13,30,23,20
6652,E02000718,2011,35,178000,175000,0,2,14,19,13,22,16,19
6653,E02000718,2012,34,163000,146000,0,1,11,22,9,25,12,22
6654,E02000718,2013,35,174000,170000,0,0,17,18,3,32,17,18
6655,E02000718,2014,21,179000,171000,0,1,8,12,0,21,8,13
6656,E02000719,2009,36,192000,198000,0,4,18,14,0,36,22,14
6657,E02000719,2010,33,223000,230000,1,1,21,10,0,33,23,10
6658,E02000719,2011,35,214000,225000,0,1,18,16,0,35,18,17
6659,E02000719,2012,43,235000,240000,0,7,22,14,0,43,29,14
6660,E02000719,2013,66,237000,241000,0,5,30,31,0,66,34,32
6661,E02000719,2014,23,248000,230000,0,1,8,14,0,23,8,15
6662,E02000720,2009,28,238000,238000,0,1,24,3,0,28,25,3
6663,E02000720,2010,42,269000,250000,0,1,33,8,0,42,35,7
6664,E02000720,2011,30,240000,243000,1,1,25,3,0,30,27,3
6665,E02000720,2012,28,275000,249000,1,1,23,3,0,28,24,4
6666,E02000720,2013,40,273000,266000,3,0,27,10,0,40,30,10
6667,E02000720,2014,19,441000,430000,0,0,17,2,0,19,17,2
6668,E02000721,2009,34,232000,205000,2,1,20,11,0,34,24,10
6669,E02000721,2010,34,219000,198000,2,4,14,14,0,34,20,14
6670,E02000721,2011,44,194000,175000,0,1,21,22,4,40,22,22
6671,E02000721,2012,24,217000,222000,0,1,15,8,0,24,17,7
6672,E02000721,2013,45,249000,240000,1,3,21,20,2,43,25,20
6673,E02000721,2014,11,221000,200000,0,1,2,8,0,11,3,8
6674,E02000722,2009,35,197000,195000,0,1,15,19,1,34,16,19
6675,E02000722,2010,45,233000,240000,0,1,32,12,0,45,32,13
6676,E02000722,2011,50,238000,235000,1,2,21,26,5,45,24,26
6677,E02000722,2012,58,247000,250000,0,2,32,24,2,56,34,24
6678,E02000722,2013,70,245000,249000,0,1,31,38,0,70,32,38
6679,E02000722,2014,38,310000,312000,2,1,15,20,0,38,18,20
6680,E02000723,2009,28,199000,208000,0,0,25,3,1,27,25,3
6681,E02000723,2010,46,246000,249000,0,0,43,3,0,46,43,3
6682,E02000723,2011,27,221000,231000,1,0,21,5,0,27,22,5
6683,E02000723,2012,21,240000,250000,1,0,17,3,0,21,17,4
6684,E02000723,2013,37,238000,247000,0,1,31,5,0,37,32,5
6685,E02000723,2014,17,235000,250000,0,0,14,3,1,16,14,3
6686,E02000724,2009,27,183000,192000,0,1,19,7,0,27,20,7
6687,E02000724,2010,43,211000,215000,0,0,37,6,0,43,37,6
6688,E02000724,2011,27,207000,210000,0,0,23,4,1,26,23,4
6689,E02000724,2012,42,201000,204000,0,1,21,20,15,27,22,20
6690,E02000724,2013,54,211000,224000,0,2,39,13,0,54,41,13
6691,E02000724,2014,14,264000,281000,0,1,12,1,0,14,13,1
6692,E02000725,2009,68,207000,206000,0,0,31,37,18,50,33,35
6693,E02000725,2010,67,219000,230000,0,1,27,39,14,53,28,39
6694,E02000725,2011,54,222000,226000,0,3,33,18,1,53,34,20
6695,E02000725,2012,69,243000,240000,0,1,32,36,1,68,33,36
6696,E02000725,2013,101,241000,249000,0,0,38,63,0,101,38,63
6697,E02000725,2014,26,246000,241000,0,0,9,17,1,25,9,17
6698,E02000726,2009,161,242000,238000,0,0,17,144,133,28,17,144
6699,E02000726,2010,74,236000,235000,0,0,15,59,41,33,15,59
6700,E02000726,2011,166,238000,233000,0,1,13,152,99,67,13,153
6701,E02000726,2012,155,237000,240000,0,0,16,139,47,108,17,138
6702,E02000726,2013,113,244000,246000,0,2,17,94,18,95,18,95
6703,E02000726,2014,57,275000,268000,0,1,14,42,6,51,14,43
6704,E02000727,2009,25,176000,175000,0,0,17,8,1,24,17,8
6705,E02000727,2010,31,209000,216000,1,0,20,10,0,31,21,10
6706,E02000727,2011,28,203000,215000,0,1,16,11,1,27,18,10
6707,E02000727,2012,22,225000,233000,0,0,18,4,0,22,17,5
6708,E02000727,2013,30,224000,237000,0,0,21,9,0,30,21,9
6709,E02000727,2014,13,237000,250000,0,0,8,5,0,13,8,5
6710,E02000728,2009,31,206000,218000,0,0,25,6,0,31,24,7
6711,E02000728,2010,48,209000,230000,0,1,39,8,0,48,39,9
6712,E02000728,2011,35,217000,235000,0,0,30,5,0,35,30,5
6713,E02000728,2012,34,212000,221000,0,0,29,5,0,34,28,6
6714,E02000728,2013,44,206000,216000,0,0,33,11,0,44,33,11
6715,E02000728,2014,16,239000,250000,0,1,13,2,0,16,13,3
6716,E02000729,2009,28,199000,205000,0,3,14,11,0,28,16,12
6717,E02000729,2010,29,263000,250000,0,3,18,8,0,29,22,7
6718,E02000729,2011,29,238000,250000,0,1,21,7,0,29,23,6
6719,E02000729,2012,18,215000,186000,0,1,7,10,0,18,8,10
6720,E02000729,2013,43,277000,275000,0,5,26,12,0,43,31,12
6721,E02000729,2014,24,283000,264000,0,0,11,13,0,24,11,13
6722,E02000730,2009,19,232000,240000,0,1,17,1,1,18,18,1
6723,E02000730,2010,23,222000,230000,0,2,13,8,0,23,17,6
6724,E02000730,2011,35,224000,240000,0,2,28,5,0,35,29,6
6725,E02000730,2012,24,199000,176000,0,1,12,11,0,24,13,11
6726,E02000730,2013,29,233000,250000,0,1,23,5,0,29,24,5
6727,E02000730,2014,12,213000,209000,0,0,6,6,0,12,6,6
6728,E02000731,2009,38,184000,189000,0,0,26,12,1,37,26,12
6729,E02000731,2010,31,203000,213000,0,0,25,6,0,31,27,4
6730,E02000731,2011,57,198000,220000,0,0,39,18,6,51,38,19
6731,E02000731,2012,41,209000,230000,0,0,33,8,0,41,33,8
6732,E02000731,2013,38,215000,228000,0,0,31,7,0,38,31,7
6733,E02000731,2014,20,217000,240000,1,0,14,5,0,20,13,7
6734,E02000732,2009,23,180000,190000,0,0,17,6,0,23,16,7
6735,E02000732,2010,36,192000,202000,0,2,24,10,0,36,26,10
6736,E02000732,2011,22,197000,212000,0,1,17,4,0,22,18,4
6737,E02000732,2012,21,195000,210000,0,1,15,5,0,21,16,5
6738,E02000732,2013,29,198000,216000,0,0,22,7,0,29,22,7
6739,E02000732,2014,11,221000,250000,0,0,9,2,0,11,9,2
6740,E02000733,2009,39,187000,190000,0,0,30,9,1,38,30,9
6741,E02000733,2010,50,204000,206000,0,1,31,18,0,50,32,18
6742,E02000733,2011,48,220000,222000,0,3,32,13,0,48,35,13
6743,E02000733,2012,56,208000,229000,0,0,26,30,8,48,26,30
6744,E02000733,2013,60,208000,218000,0,1,33,26,0,60,33,27
6745,E02000733,2014,29,237000,250000,0,0,16,13,0,29,16,13
6746,E02000734,2009,24,194000,206000,0,1,20,3,0,24,21,3
6747,E02000734,2010,28,230000,239000,0,0,21,7,0,28,21,7
6748,E02000734,2011,24,183000,192000,0,1,13,10,0,24,13,11
6749,E02000734,2012,29,214000,240000,0,1,17,11,0,29,18,11
6750,E02000734,2013,26,252000,247000,0,1,17,8,0,26,18,8
6751,E02000734,2014,10,197000,176000,0,0,3,7,0,10,3,7
6752,E02000735,2009,31,178000,176000,0,1,20,10,0,31,21,10
6753,E02000735,2010,45,202000,208000,0,0,35,10,7,38,35,10
6754,E02000735,2011,31,184000,195000,0,0,21,10,0,31,20,11
6755,E02000735,2012,35,206000,222000,0,0,27,8,0,35,27,8
6756,E02000735,2013,46,192000,191000,0,0,25,21,1,45,24,22
6757,E02000735,2014,12,208000,198000,0,0,8,4,0,12,7,5
6758,E02000736,2009,29,183000,175000,0,3,21,5,0,29,24,5
6759,E02000736,2010,31,190000,198000,0,0,25,6,0,31,25,6
6760,E02000736,2011,50,197000,208000,0,2,42,6,0,50,43,7
6761,E02000736,2012,43,194000,201000,0,1,34,8,0,43,34,9
6762,E02000736,2013,53,208000,210000,0,4,43,6,0,53,47,6
6763,E02000736,2014,28,222000,226000,0,0,23,5,0,28,22,6
6764,E02000737,2009,51,185000,183000,0,1,45,5,1,50,46,5
6765,E02000737,2010,49,208000,210000,0,1,45,3,0,49,44,5
6766,E02000737,2011,54,193000,195000,0,2,42,10,0,54,44,10
6767,E02000737,2012,49,207000,210000,0,0,43,6,0,49,43,6
6768,E02000737,2013,64,198000,208000,0,0,52,12,0,64,52,12
6769,E02000737,2014,31,228000,233000,0,0,25,6,0,31,25,6
6770,E02000738,2009,57,200000,190000,0,4,51,2,1,56,56,1
6771,E02000738,2010,51,209000,216000,0,0,46,5,0,51,47,4
6772,E02000738,2011,42,218000,223000,0,2,38,2,0,42,40,2
6773,E02000738,2012,44,213000,216000,0,0,40,4,0,44,40,4
6774,E02000738,2013,59,224000,227000,1,2,51,5,0,59,54,5
6775,E02000738,2014,23,240000,245000,0,1,21,1,0,23,21,2
6776,E02000739,2009,29,197000,200000,0,2,22,5,0,29,24,5
6777,E02000739,2010,36,196000,216000,0,2,28,6,0,36,30,6
6778,E02000739,2011,23,201000,220000,0,1,15,7,1,22,16,7
6779,E02000739,2012,33,202000,202000,0,1,27,5,0,33,28,5
6780,E02000739,2013,41,212000,226000,0,1,30,10,0,41,30,11
6781,E02000739,2014,13,233000,241000,0,0,11,2,0,13,10,3
6782,E02000740,2009,20,173000,173000,0,2,8,10,0,20,10,10
6783,E02000740,2010,25,191000,198000,1,2,16,6,0,25,20,5
6784,E02000740,2011,24,212000,216000,0,5,13,6,0,24,18,6
6785,E02000740,2012,32,193000,192000,0,2,15,15,1,31,17,15
6786,E02000740,2013,38,197000,196000,0,4,18,16,0,38,20,18
6787,E02000740,2014,21,209000,235000,0,2,9,10,0,21,11,10
6788,E02000741,2009,38,177000,175000,0,1,31,6,1,37,32,6
6789,E02000741,2010,44,190000,191000,1,2,33,8,0,44,37,7
6790,E02000741,2011,41,194000,195000,1,1,31,8,0,41,34,7
6791,E02000741,2012,48,184000,186000,0,1,37,10,0,48,38,10
6792,E02000741,2013,61,207000,210000,0,0,48,13,2,59,48,13
6793,E02000741,2014,27,221000,225000,0,0,21,6,0,27,20,7
6794,E02000742,2009,51,184000,185000,0,1,40,10,1,50,41,10
6795,E02000742,2010,62,194000,204000,0,2,50,10,0,62,52,10
6796,E02000742,2011,56,196000,199000,0,2,47,7,0,56,49,7
6797,E02000742,2012,37,200000,207000,0,2,30,5,0,37,32,5
6798,E02000742,2013,69,199000,205000,0,1,51,17,1,68,52,17
6799,E02000742,2014,26,220000,235000,0,0,19,7,0,26,19,7
6800,E02000743,2009,14,203000,166000,0,1,6,7,1,13,7,7
6801,E02000743,2010,25,195000,188000,0,2,18,5,0,25,21,4
6802,E02000743,2011,30,165000,168000,0,1,16,13,0,30,16,14
6803,E02000743,2012,77,223000,220000,0,1,18,58,42,35,17,60
6804,E02000743,2013,75,241000,233000,0,0,24,51,28,47,24,51
6805,E02000743,2014,14,221000,238000,0,0,10,4,0,14,10,4
6806,E02000744,2009,36,160000,162000,0,0,17,19,5,31,17,19
6807,E02000744,2010,47,179000,163000,0,2,25,20,0,47,26,21
6808,E02000744,2011,37,170000,168000,0,0,28,9,0,37,28,9
6809,E02000744,2012,90,195000,190000,0,4,29,57,48,42,33,57
6810,E02000744,2013,63,186000,183000,0,0,37,26,2,61,37,26
6811,E02000744,2014,28,246000,246000,1,1,25,1,2,26,27,1
6812,E02000745,2009,37,189000,195000,1,3,30,3,0,37,34,3
6813,E02000745,2010,51,215000,217000,1,8,34,8,0,51,43,8
6814,E02000745,2011,45,202000,218000,1,8,27,9,0,45,34,11
6815,E02000745,2012,32,212000,228000,0,3,25,4,0,32,27,5
6816,E02000745,2013,51,218000,225000,4,10,22,15,0,51,36,15
6817,E02000745,2014,25,230000,227000,2,1,15,7,0,25,18,7
6818,E02000746,2009,68,243000,250000,0,1,6,61,53,15,7,61
6819,E02000746,2010,85,240000,248000,0,2,10,73,60,25,12,73
6820,E02000746,2011,69,243000,250000,1,0,12,56,19,50,14,55
6821,E02000746,2012,22,223000,249000,1,2,10,9,0,22,12,10
6822,E02000746,2013,40,213000,226000,1,5,14,20,0,40,19,21
6823,E02000746,2014,21,233000,225000,1,0,6,14,0,21,7,14
6824,E02000747,2009,80,254000,215000,0,0,11,69,39,41,11,69
6825,E02000747,2010,140,277000,260000,0,1,18,121,96,44,18,122
6826,E02000747,2011,45,232000,219000,0,1,11,33,0,45,13,32
6827,E02000747,2012,73,235000,223000,0,0,17,56,10,63,17,56
6828,E02000747,2013,145,262000,245000,1,0,12,132,18,127,13,132
6829,E02000747,2014,65,327000,300000,0,1,9,55,1,64,10,55
6830,E02000748,2009,26,177000,175000,0,3,17,6,0,26,19,7
6831,E02000748,2010,39,191000,190000,1,2,30,6,0,39,33,6
6832,E02000748,2011,39,199000,190000,1,3,25,10,0,39,28,11
6833,E02000748,2012,44,204000,207000,4,6,26,8,0,44,37,7
6834,E02000748,2013,45,225000,226000,4,6,28,7,0,45,38,7
6835,E02000748,2014,26,202000,202000,0,3,15,8,0,26,18,8
6836,E02000749,2009,26,174000,175000,0,0,17,9,0,26,16,10
6837,E02000749,2010,31,181000,187000,0,0,23,8,0,31,20,11
6838,E02000749,2011,23,175000,180000,0,1,12,10,0,23,12,11
6839,E02000749,2012,24,192000,202000,0,1,16,7,1,23,15,9
6840,E02000749,2013,132,216000,209000,0,3,49,80,80,52,50,82
6841,E02000749,2014,15,227000,240000,0,0,11,4,1,14,11,4
6842,E02000750,2009,56,232000,225000,0,0,18,38,0,56,10,46
6843,E02000750,2010,82,247000,237000,0,0,21,61,0,82,13,69
6844,E02000750,2011,107,255000,242000,1,0,16,90,16,91,11,96
6845,E02000750,2012,150,259000,246000,0,1,15,134,80,70,5,145
6846,E02000750,2013,295,276000,260000,0,0,34,261,108,187,20,275
6847,E02000750,2014,63,270000,265000,0,0,6,57,1,62,3,60
6848,E02000751,2009,135,430000,410000,42,30,18,45,10,125,89,46
6849,E02000751,2010,165,478000,400000,48,34,15,68,6,159,96,69
6850,E02000751,2011,158,482000,398000,45,31,17,65,13,145,93,65
6851,E02000751,2012,155,465000,387000,33,42,21,59,8,147,95,60
6852,E02000751,2013,179,514000,440000,50,38,22,69,2,177,110,69
6853,E02000751,2014,54,557000,558000,16,13,8,17,2,52,35,19
6854,E02000752,2009,66,186000,181000,0,22,29,15,1,65,51,15
6855,E02000752,2010,65,201000,210000,0,29,30,6,8,57,60,5
6856,E02000752,2011,57,209000,205000,0,32,19,6,0,57,51,6
6857,E02000752,2012,71,208000,218000,0,26,34,11,0,71,59,12
6858,E02000752,2013,80,217000,218000,0,38,27,15,1,79,66,14
6859,E02000752,2014,31,222000,230000,0,7,16,8,3,28,23,8
6860,E02000753,2009,68,213000,200000,3,17,39,9,0,68,59,9
6861,E02000753,2010,42,237000,232000,1,15,22,4,0,42,38,4
6862,E02000753,2011,69,237000,217000,4,18,37,10,0,69,60,9
6863,E02000753,2012,64,231000,216000,3,17,34,10,0,64,54,10
6864,E02000753,2013,89,234000,231000,2,16,53,18,0,89,71,18
6865,E02000753,2014,33,259000,250000,1,9,18,5,0,33,28,5
6866,E02000754,2009,67,285000,290000,2,17,37,11,2,65,55,12
6867,E02000754,2010,82,292000,293000,0,16,51,15,0,82,67,15
6868,E02000754,2011,78,297000,293000,3,24,39,12,0,78,65,13
6869,E02000754,2012,87,309000,308000,4,35,36,12,0,87,75,12
6870,E02000754,2013,107,321000,325000,2,40,43,22,5,102,84,23
6871,E02000754,2014,30,332000,348000,0,8,15,7,3,27,23,7
6872,E02000755,2009,67,249000,235000,4,11,43,9,0,67,59,8
6873,E02000755,2010,63,251000,241000,1,12,35,15,0,63,47,16
6874,E02000755,2011,61,266000,250000,2,15,33,11,0,61,49,12
6875,E02000755,2012,54,256000,244000,2,10,29,13,3,51,41,13
6876,E02000755,2013,83,267000,260000,2,16,50,15,1,82,67,16
6877,E02000755,2014,40,295000,292000,2,8,24,6,0,40,33,7
6878,E02000756,2009,149,261000,227000,7,37,73,32,8,141,113,36
6879,E02000756,2010,176,326000,265000,13,29,74,60,0,176,117,59
6880,E02000756,2011,153,274000,250000,6,34,65,48,0,153,105,48
6881,E02000756,2012,138,288000,260000,8,34,65,31,0,138,106,32
6882,E02000756,2013,171,311000,265000,12,35,88,36,1,170,133,38
6883,E02000756,2014,65,302000,270000,2,14,29,20,1,64,45,20
6884,E02000757,2009,167,283000,250000,4,25,35,103,39,128,65,102
6885,E02000757,2010,192,320000,270000,8,37,42,105,49,143,81,111
6886,E02000757,2011,219,317000,270000,8,47,38,126,50,169,90,129
6887,E02000757,2012,186,316000,285000,6,35,33,112,17,169,74,112
6888,E02000757,2013,213,359000,315000,11,47,43,112,2,211,99,114
6889,E02000757,2014,66,339000,312000,1,6,15,44,0,66,20,46
6890,E02000758,2009,65,236000,245000,3,33,17,12,2,63,54,11
6891,E02000758,2010,79,274000,278000,8,40,20,11,0,79,67,12
6892,E02000758,2011,54,268000,267000,2,33,9,10,0,54,43,11
6893,E02000758,2012,57,282000,281000,4,39,8,6,1,56,51,6
6894,E02000758,2013,66,284000,288000,1,40,15,10,0,66,55,11
6895,E02000758,2014,21,304000,320000,3,10,4,4,0,21,17,4
6896,E02000759,2009,128,270000,259000,3,25,55,45,24,104,82,46
6897,E02000759,2010,159,296000,286000,6,39,69,45,2,157,112,47
6898,E02000759,2011,128,307000,302000,3,28,63,34,2,126,88,40
6899,E02000759,2012,133,324000,315000,2,43,52,36,1,132,96,37
6900,E02000759,2013,174,319000,306000,1,45,65,63,0,174,106,68
6901,E02000759,2014,66,324000,318000,0,20,17,29,0,66,37,29
6902,E02000760,2009,67,236000,235000,5,15,31,16,3,64,50,17
6903,E02000760,2010,71,242000,250000,1,18,31,21,0,71,51,20
6904,E02000760,2011,63,252000,270000,2,24,24,13,0,63,48,15
6905,E02000760,2012,70,255000,262000,4,20,30,16,0,70,53,17
6906,E02000760,2013,91,260000,269000,2,30,36,23,0,91,67,24
6907,E02000760,2014,25,277000,290000,0,6,9,10,0,25,15,10
6908,E02000762,2009,60,298000,305000,1,25,23,11,1,59,49,11
6909,E02000762,2010,61,321000,340000,3,19,26,13,0,61,48,13
6910,E02000762,2011,58,307000,282000,2,22,13,21,10,48,37,21
6911,E02000762,2012,55,315000,327000,8,15,17,15,9,46,40,15
6912,E02000762,2013,71,347000,360000,2,22,32,15,0,71,55,16
6913,E02000762,2014,29,376000,385000,2,16,6,5,1,28,24,5
6914,E02000763,2009,53,226000,235000,1,12,30,10,2,51,43,10
6915,E02000763,2010,56,257000,250000,2,13,33,8,0,56,47,9
6916,E02000763,2011,54,238000,244000,2,12,28,12,0,54,42,12
6917,E02000763,2012,53,250000,250000,0,11,31,11,0,53,42,11
6918,E02000763,2013,109,232000,235000,1,21,25,62,44,65,48,61
6919,E02000763,2014,35,300000,300000,1,3,19,12,12,23,22,13
6920,E02000764,2009,142,298000,246000,4,24,28,86,1,141,58,84
6921,E02000764,2010,181,372000,286000,13,38,39,91,2,179,86,95
6922,E02000764,2011,197,336000,262000,11,25,42,119,4,193,75,122
6923,E02000764,2012,182,385000,276000,12,21,39,110,1,181,71,111
6924,E02000764,2013,187,405000,300000,11,28,38,110,2,185,77,110
6925,E02000764,2014,80,425000,360000,4,14,21,41,1,79,39,41
6926,E02000765,2009,44,244000,245000,0,6,24,14,4,40,30,14
6927,E02000765,2010,61,288000,295000,1,15,36,9,0,61,52,9
6928,E02000765,2011,54,263000,282000,0,11,29,14,1,53,39,15
6929,E02000765,2012,61,284000,285000,1,10,29,21,12,49,40,21
6930,E02000765,2013,49,316000,335000,1,13,26,9,2,47,39,10
6931,E02000765,2014,12,275000,250000,0,1,5,6,0,12,6,6
6932,E02000767,2009,57,234000,245000,0,5,39,13,0,57,44,13
6933,E02000767,2010,59,251000,246000,1,7,36,15,1,58,45,14
6934,E02000767,2011,63,263000,270000,1,11,39,12,0,63,51,12
6935,E02000767,2012,53,267000,268000,1,9,39,4,0,53,49,4
6936,E02000767,2013,78,259000,265000,3,5,48,22,1,77,56,22
6937,E02000767,2014,20,331000,335000,1,2,15,2,0,20,18,2
6938,E02000768,2009,51,384000,350000,4,18,17,12,1,50,39,12
6939,E02000768,2010,72,457000,410000,5,28,22,17,0,72,54,18
6940,E02000768,2011,83,458000,418000,7,29,32,15,0,83,68,15
6941,E02000768,2012,86,498000,421000,5,31,22,28,21,65,58,28
6942,E02000768,2013,89,507000,496000,5,39,27,18,1,88,71,18
6943,E02000768,2014,19,522000,457000,0,4,7,8,0,19,12,7
6944,E02000769,2009,104,198000,201000,3,19,53,29,3,101,76,28
6945,E02000769,2010,148,209000,225000,2,25,74,47,0,148,104,44
6946,E02000769,2011,133,207000,230000,3,35,56,39,0,133,94,39
6947,E02000769,2012,137,229000,240000,1,35,78,23,3,134,114,23
6948,E02000769,2013,130,233000,248000,1,30,71,28,5,125,102,28
6949,E02000769,2014,59,243000,250000,0,8,34,17,0,59,41,18
6950,E02000770,2009,61,215000,232000,0,9,37,15,1,60,42,19
6951,E02000770,2010,50,245000,250000,2,6,30,12,0,50,39,11
6952,E02000770,2011,51,245000,250000,0,12,28,11,0,51,40,11
6953,E02000770,2012,48,245000,264000,0,8,27,13,0,48,35,13
6954,E02000770,2013,62,237000,250000,1,9,27,25,0,62,38,24
6955,E02000770,2014,22,261000,282000,1,5,10,6,0,22,15,7
6956,E02000772,2009,131,182000,164000,0,5,32,94,84,47,37,94
6957,E02000772,2010,60,247000,250000,1,5,46,8,0,60,51,9
6958,E02000772,2011,48,270000,269000,3,3,37,5,0,48,43,5
6959,E02000772,2012,50,237000,250000,0,7,32,11,1,49,39,11
6960,E02000772,2013,57,268000,273000,3,3,40,11,1,56,44,13
6961,E02000772,2014,27,255000,275000,0,1,17,9,2,25,18,9
6962,E02000773,2009,109,201000,190000,0,1,34,74,67,42,33,76
6963,E02000773,2010,121,239000,226000,1,4,54,62,52,69,59,62
6964,E02000773,2011,42,245000,259000,0,3,30,9,0,42,32,10
6965,E02000773,2012,50,292000,296000,0,5,37,8,1,49,42,8
6966,E02000773,2013,54,277000,282000,0,1,42,11,1,53,42,12
6967,E02000773,2014,22,304000,326000,0,1,18,3,0,22,19,3
6968,E02000774,2009,28,239000,237000,0,3,21,4,0,28,23,5
6969,E02000774,2010,41,256000,247000,2,2,34,3,0,41,37,4
6970,E02000774,2011,37,227000,245000,0,7,22,8,0,37,27,10
6971,E02000774,2012,32,253000,250000,0,4,27,1,1,31,31,1
6972,E02000774,2013,49,254000,250000,1,8,34,6,0,49,43,6
6973,E02000774,2014,15,247000,265000,0,3,7,5,0,15,10,5
6974,E02000776,2009,28,274000,278000,0,2,21,5,0,28,24,4
6975,E02000776,2010,47,233000,210000,0,4,25,18,0,47,26,21
6976,E02000776,2011,38,257000,255000,1,5,20,12,0,38,25,13
6977,E02000776,2012,49,252000,270000,1,3,28,17,0,49,32,17
6978,E02000776,2013,40,269000,272000,2,1,24,13,0,40,26,14
6979,E02000776,2014,15,323000,355000,1,2,7,5,0,15,10,5
6980,E02000777,2009,37,336000,365000,3,9,15,10,0,37,27,10
6981,E02000777,2010,57,363000,400000,2,12,23,20,0,57,37,20
6982,E02000777,2011,55,360000,395000,1,9,26,19,0,55,36,19
6983,E02000777,2012,64,404000,445000,2,14,27,21,0,64,43,21
6984,E02000777,2013,79,408000,428000,4,16,32,27,0,79,52,27
6985,E02000777,2014,30,411000,465000,1,8,11,10,0,30,19,11
6986,E02000779,2009,40,231000,191000,0,2,17,21,1,39,19,21
6987,E02000779,2010,51,211000,185000,0,2,22,27,0,51,22,29
6988,E02000779,2011,38,218000,212000,0,1,20,17,0,38,20,18
6989,E02000779,2012,27,255000,250000,0,2,16,9,0,27,18,9
6990,E02000779,2013,54,244000,172000,1,3,20,30,0,54,22,32
6991,E02000779,2014,15,259000,247000,0,1,7,7,0,15,8,7
6992,E02000780,2009,67,220000,205000,0,2,46,19,13,54,47,20
6993,E02000780,2010,187,207000,208000,1,5,45,136,123,64,49,138
6994,E02000780,2011,63,220000,225000,0,5,52,6,0,63,55,8
6995,E02000780,2012,78,202000,200000,0,0,55,23,5,73,54,24
6996,E02000780,2013,90,208000,220000,0,0,52,38,5,85,51,39
6997,E02000780,2014,54,230000,235000,0,0,36,18,1,53,32,22
6998,E02000781,2009,137,246000,240000,4,17,79,37,46,91,103,34
6999,E02000781,2010,119,289000,260000,6,17,83,13,7,112,106,13
7000,E02000781,2011,100,276000,260000,8,17,65,10,0,100,90,10
7001,E02000781,2012,80,263000,250000,3,10,58,9,0,80,71,9
7002,E02000781,2013,131,274000,260000,3,18,93,17,0,131,114,17
7003,E02000781,2014,44,296000,274000,4,6,25,9,0,44,34,10
7004,E02000782,2009,92,204000,208000,0,1,28,63,56,36,29,63
7005,E02000782,2010,118,206000,212000,0,1,36,81,75,43,37,81
7006,E02000782,2011,37,215000,215000,0,0,30,7,0,37,30,7
7007,E02000782,2012,67,193000,190000,0,0,38,29,0,67,37,30
7008,E02000782,2013,57,203000,217000,1,0,34,22,0,57,35,22
7009,E02000782,2014,53,199000,192000,0,0,14,39,0,53,14,39
7010,E02000783,2009,30,171000,184000,0,0,21,9,0,30,21,9
7011,E02000783,2010,43,190000,200000,0,0,30,13,0,43,30,13
7012,E02000783,2011,38,216000,223000,0,0,32,6,0,38,32,6
7013,E02000783,2012,27,210000,215000,0,1,22,4,0,27,23,4
7014,E02000783,2013,30,234000,224000,0,0,26,4,0,30,26,4
7015,E02000783,2014,16,236000,240000,0,0,14,2,0,16,14,2
7016,E02000784,2009,126,903000,728000,4,36,38,48,0,126,75,51
7017,E02000784,2010,159,941000,760000,9,44,36,70,1,158,88,71
7018,E02000784,2011,152,1026000,868000,7,42,43,60,0,152,88,64
7019,E02000784,2012,141,1089000,728000,4,29,45,63,0,141,76,65
7020,E02000784,2013,184,1322000,1000000,11,44,53,76,0,184,106,78
7021,E02000784,2014,42,1437000,1320000,1,10,15,16,0,42,26,16
7022,E02000785,2009,115,550000,475000,7,22,37,49,0,115,66,49
7023,E02000785,2010,195,621000,495000,13,28,64,90,8,187,103,92
7024,E02000785,2011,161,707000,600000,10,24,59,68,1,160,95,66
7025,E02000785,2012,157,721000,623000,14,19,60,64,0,157,93,64
7026,E02000785,2013,169,887000,725000,16,29,67,57,2,167,111,58
7027,E02000785,2014,51,936000,777000,4,12,18,17,0,51,34,17
7028,E02000786,2009,214,562000,463000,4,19,112,79,3,211,130,84
7029,E02000786,2010,253,591000,475000,4,18,120,111,8,245,132,121
7030,E02000786,2011,245,678000,545000,6,16,126,97,4,241,142,103
7031,E02000786,2012,224,668000,542000,6,7,95,116,38,186,106,118
7032,E02000786,2013,228,711000,592000,1,14,106,107,5,223,115,113
7033,E02000786,2014,73,791000,635000,1,5,27,40,2,71,31,42
7034,E02000787,2009,121,482000,390000,4,19,46,52,0,121,67,54
7035,E02000787,2010,179,517000,445000,4,30,62,83,6,173,97,82
7036,E02000787,2011,168,532000,470000,2,24,70,72,5,163,95,73
7037,E02000787,2012,177,510000,445000,1,19,65,92,13,164,82,95
7038,E02000787,2013,234,559000,471000,7,25,76,126,17,217,105,129
7039,E02000787,2014,63,664000,555000,2,7,19,35,1,62,28,35
7040,E02000788,2009,147,531000,515000,2,48,60,37,6,141,110,37
7041,E02000788,2010,170,597000,572000,10,43,67,50,1,169,120,50
7042,E02000788,2011,175,669000,618000,12,60,52,51,2,173,125,50
7043,E02000788,2012,174,652000,629000,5,47,65,57,1,173,118,56
7044,E02000788,2013,182,765000,690000,7,50,65,60,1,181,122,60
7045,E02000788,2014,52,832000,776000,3,14,18,17,1,51,35,17
7046,E02000789,2009,96,641000,458000,12,10,35,39,1,95,55,41
7047,E02000789,2010,137,773000,475000,20,20,31,66,0,137,68,69
7048,E02000789,2011,118,674000,459000,10,11,32,65,0,118,52,66
7049,E02000789,2012,131,685000,500000,13,9,40,69,0,131,61,70
7050,E02000789,2013,117,874000,557000,13,12,29,63,0,117,53,64
7051,E02000789,2014,41,849000,580000,5,3,7,26,0,41,15,26
7052,E02000790,2009,91,566000,438000,2,15,43,31,5,86,60,31
7053,E02000790,2010,141,755000,590000,11,15,62,53,15,126,85,56
7054,E02000790,2011,129,586000,495000,10,23,44,52,1,128,72,57
7055,E02000790,2012,146,689000,566000,7,20,65,54,12,134,89,57
7056,E02000790,2013,121,706000,587000,6,19,46,50,6,115,67,54
7057,E02000790,2014,38,1036000,818000,4,13,5,16,1,37,22,16
7058,E02000791,2009,115,811000,498000,6,19,16,74,0,115,41,74
7059,E02000791,2010,124,827000,490000,5,9,26,84,0,124,38,86
7060,E02000791,2011,111,901000,550000,2,20,18,71,0,111,39,72
7061,E02000791,2012,142,1044000,537000,7,16,25,94,8,134,41,101
7062,E02000791,2013,165,830000,550000,3,13,25,124,12,153,38,127
7063,E02000791,2014,50,1192000,815000,1,5,10,34,1,49,15,35
7064,E02000792,2009,114,609000,402000,3,21,27,63,0,114,51,63
7065,E02000792,2010,126,604000,439000,2,16,33,75,0,126,49,77
7066,E02000792,2011,127,658000,500000,3,24,28,72,8,119,55,72
7067,E02000792,2012,117,727000,545000,11,17,30,59,3,114,58,59
7068,E02000792,2013,140,789000,445000,11,17,24,88,2,138,50,90
7069,E02000792,2014,39,732000,485000,2,1,6,30,0,39,9,30
7070,E02000793,2009,64,277000,268000,3,25,24,12,0,64,53,11
7071,E02000793,2010,89,299000,295000,7,29,31,22,0,89,69,20
7072,E02000793,2011,74,305000,302000,4,25,24,21,0,74,53,21
7073,E02000793,2012,79,337000,332000,4,36,25,14,0,79,66,13
7074,E02000793,2013,108,343000,330000,10,33,40,25,4,104,82,26
7075,E02000793,2014,41,398000,403000,5,15,12,9,1,40,33,8
7076,E02000794,2009,120,348000,296000,11,38,23,48,2,118,71,49
7077,E02000794,2010,102,389000,337000,8,27,32,35,1,101,65,37
7078,E02000794,2011,103,455000,384000,7,32,29,35,0,103,68,35
7079,E02000794,2012,109,478000,390000,6,46,28,29,2,107,80,29
7080,E02000794,2013,137,520000,460000,8,52,33,44,0,137,91,46
7081,E02000794,2014,46,584000,458000,7,14,11,14,0,46,32,14
7082,E02000795,2009,99,753000,640000,23,25,30,21,2,97,78,21
7083,E02000795,2010,103,908000,810000,25,26,32,20,0,103,84,19
7084,E02000795,2011,101,987000,830000,27,23,31,20,0,101,79,22
7085,E02000795,2012,86,852000,826000,16,21,24,25,0,86,61,25
7086,E02000795,2013,100,1164000,980000,25,20,36,19,0,100,80,20
7087,E02000795,2014,45,1054000,1050000,11,6,15,13,0,45,31,14
7088,E02000796,2009,66,270000,250000,1,45,10,10,0,66,57,9
7089,E02000796,2010,99,301000,295000,3,68,12,16,0,99,82,17
7090,E02000796,2011,90,307000,300000,7,47,20,16,0,90,74,16
7091,E02000796,2012,119,323000,315000,9,74,15,21,2,117,98,21
7092,E02000796,2013,130,334000,336000,8,76,11,35,0,130,95,35
7093,E02000796,2014,37,354000,335000,2,19,9,7,0,37,30,7
7094,E02000797,2009,144,358000,330000,2,12,82,48,0,144,96,48
7095,E02000797,2010,166,412000,362000,2,21,88,55,0,166,109,57
7096,E02000797,2011,156,432000,376000,0,17,96,43,1,155,112,44
7097,E02000797,2012,150,437000,392000,5,12,70,63,12,138,85,65
7098,E02000797,2013,175,489000,420000,6,13,80,76,5,170,98,77
7099,E02000797,2014,58,475000,389000,0,4,26,28,1,57,30,28
7100,E02000798,2009,139,301000,290000,3,26,71,39,7,132,99,40
7101,E02000798,2010,174,353000,325000,3,40,81,50,2,172,123,51
7102,E02000798,2011,190,362000,340000,6,47,87,50,6,184,138,52
7103,E02000798,2012,159,381000,366000,1,35,78,45,0,159,112,47
7104,E02000798,2013,189,426000,402000,9,49,79,52,6,183,133,56
7105,E02000798,2014,86,449000,430000,3,15,44,24,0,86,59,27
7106,E02000799,2009,85,574000,500000,4,29,22,30,3,82,54,31
7107,E02000799,2010,102,548000,430000,5,27,29,41,1,101,58,44
7108,E02000799,2011,83,531000,450000,7,19,22,35,0,83,47,36
7109,E02000799,2012,98,607000,442000,8,20,27,43,1,97,53,45
7110,E02000799,2013,127,642000,525000,14,29,30,54,1,126,73,54
7111,E02000799,2014,28,756000,446000,2,8,3,15,0,28,12,16
7112,E02000800,2009,51,316000,312000,1,9,27,14,1,50,36,15
7113,E02000800,2010,58,331000,320000,3,10,26,19,0,58,39,19
7114,E02000800,2011,58,356000,362000,0,12,26,20,0,58,38,20
7115,E02000800,2012,56,361000,357000,2,6,26,22,3,53,32,24
7116,E02000800,2013,69,412000,392000,2,8,29,30,3,66,39,30
7117,E02000800,2014,27,419000,435000,1,3,15,8,0,27,18,9
7118,E02000801,2009,111,519000,392000,11,18,50,32,9,102,79,32
7119,E02000801,2010,136,434000,382000,5,19,54,58,2,134,76,60
7120,E02000801,2011,132,453000,399000,4,19,38,71,13,119,63,69
7121,E02000801,2012,133,516000,458000,6,27,51,49,1,132,84,49
7122,E02000801,2013,155,558000,496000,13,19,68,55,6,149,99,56
7123,E02000801,2014,44,501000,457000,3,5,13,23,2,42,21,23
7124,E02000802,2009,94,420000,341000,7,25,33,29,5,89,62,32
7125,E02000802,2010,129,440000,385000,10,26,45,48,1,128,81,48
7126,E02000802,2011,118,503000,401000,15,27,33,43,0,118,74,44
7127,E02000802,2012,134,482000,428000,13,33,38,50,0,134,84,50
7128,E02000802,2013,154,501000,419000,18,32,39,65,4,150,87,67
7129,E02000802,2014,49,510000,380000,6,12,4,27,0,49,21,28
7130,E02000803,2009,99,309000,250000,11,30,44,14,0,99,87,12
7131,E02000803,2010,112,310000,260000,13,28,46,25,0,112,85,27
7132,E02000803,2011,126,333000,286000,21,39,39,27,1,125,100,26
7133,E02000803,2012,128,375000,315000,20,42,47,19,1,127,109,19
7134,E02000803,2013,130,358000,314000,12,38,57,23,0,130,105,25
7135,E02000803,2014,54,374000,358000,7,10,24,13,0,54,41,13
7136,E02000804,2009,112,428000,334000,6,23,40,43,6,106,68,44
7137,E02000804,2010,138,463000,388000,8,21,53,56,0,138,81,57
7138,E02000804,2011,111,494000,395000,5,20,44,42,0,111,67,44
7139,E02000804,2012,118,537000,435000,6,18,44,50,1,117,68,50
7140,E02000804,2013,132,577000,516000,5,26,50,51,2,130,78,54
7141,E02000804,2014,49,625000,548000,1,9,21,18,4,45,31,18
7142,E02000805,2009,148,467000,402000,20,25,28,75,7,141,70,78
7143,E02000805,2010,168,487000,372000,11,33,40,84,2,166,81,87
7144,E02000805,2011,214,484000,388000,15,39,39,121,25,189,92,122
7145,E02000805,2012,288,486000,382000,16,39,35,198,81,207,86,202
7146,E02000805,2013,263,520000,420000,22,26,28,187,73,190,75,188
7147,E02000805,2014,74,618000,462000,6,8,15,45,4,70,27,47
7148,E02000806,2009,111,370000,315000,19,24,37,31,5,106,81,30
7149,E02000806,2010,124,411000,375000,17,40,41,26,0,124,97,27
7150,E02000806,2011,172,433000,390000,22,39,65,46,8,164,126,46
7151,E02000806,2012,145,467000,370000,17,38,38,52,4,141,92,53
7152,E02000806,2013,192,487000,420000,31,55,43,63,3,189,128,64
7153,E02000806,2014,57,660000,535000,9,19,14,15,1,56,43,14
7154,E02000807,2009,98,329000,314000,0,3,20,75,0,98,25,73
7155,E02000807,2010,124,344000,324000,1,5,24,94,0,124,31,93
7156,E02000807,2011,225,360000,358000,1,4,35,185,79,146,39,186
7157,E02000807,2012,138,368000,338000,0,7,37,94,0,138,42,96
7158,E02000807,2013,195,404000,392000,1,5,39,150,1,194,42,153
7159,E02000807,2014,69,436000,435000,1,0,7,61,0,69,9,60
7160,E02000808,2009,147,402000,375000,0,1,2,144,72,75,3,144
7161,E02000808,2010,130,552000,450000,0,1,0,129,20,110,1,129
7162,E02000808,2011,166,693000,475000,0,0,1,165,60,106,2,164
7163,E02000808,2012,193,708000,535000,0,0,3,190,47,146,3,190
7164,E02000808,2013,144,900000,600000,0,0,3,141,11,133,2,142
7165,E02000808,2014,42,961000,742000,0,0,1,41,3,39,1,41
7166,E02000809,2009,211,455000,395000,0,0,5,206,26,185,4,207
7167,E02000809,2010,294,511000,440000,0,2,6,286,12,282,3,291
7168,E02000809,2011,300,545000,460000,0,0,3,297,27,273,4,296
7169,E02000809,2012,276,586000,490000,0,0,3,273,45,231,1,275
7170,E02000809,2013,284,673000,565000,0,0,5,279,2,282,6,278
7171,E02000809,2014,87,770000,680000,0,0,1,86,1,86,1,86
7172,E02000810,2009,111,284000,270000,0,1,11,99,42,69,12,99
7173,E02000810,2010,158,296000,282000,0,1,10,147,92,66,11,147
7174,E02000810,2011,163,296000,275000,0,1,13,149,82,81,14,149
7175,E02000810,2012,154,369000,355000,0,2,11,141,80,74,13,141
7176,E02000810,2013,163,395000,343000,0,0,15,148,39,124,14,149
7177,E02000810,2014,93,397000,364000,0,0,3,90,52,41,3,90
7178,E02000812,2009,91,348000,343000,0,0,3,88,39,52,4,87
7179,E02000812,2010,100,370000,346000,0,2,6,92,17,83,7,93
7180,E02000812,2011,88,354000,308000,1,0,3,84,4,84,3,85
7181,E02000812,2012,101,382000,312000,0,0,2,99,0,101,2,99
7182,E02000812,2013,159,445000,378000,0,0,8,151,21,138,6,153
7183,E02000812,2014,50,518000,446000,0,0,2,48,15,35,2,48
7184,E02000813,2009,65,291000,250000,0,0,5,60,36,29,5,60
7185,E02000813,2010,185,320000,297000,0,1,10,174,121,64,11,174
7186,E02000813,2011,55,332000,260000,0,1,9,45,0,55,8,47
7187,E02000813,2012,191,344000,305000,1,1,9,180,130,61,11,180
7188,E02000813,2013,297,384000,372000,0,0,6,291,207,90,6,291
7189,E02000813,2014,40,368000,385000,0,0,7,33,0,40,5,35
7190,E02000814,2009,86,291000,270000,0,5,16,65,4,82,20,66
7191,E02000814,2010,110,315000,309000,1,1,19,89,1,109,21,89
7192,E02000814,2011,130,327000,306000,1,5,24,100,0,130,26,104
7193,E02000814,2012,126,327000,309000,1,1,23,101,0,126,24,102
7194,E02000814,2013,166,378000,360000,1,3,28,134,1,165,31,135
7195,E02000814,2014,46,427000,414000,0,0,4,42,0,46,4,42
7196,E02000815,2009,54,323000,308000,0,0,1,53,5,49,0,54
7197,E02000815,2010,46,333000,281000,0,1,1,44,0,46,1,45
7198,E02000815,2011,59,325000,250000,0,0,2,57,0,59,2,57
7199,E02000815,2012,65,535000,415000,0,0,3,62,19,46,0,65
7200,E02000815,2013,63,439000,310000,0,0,3,60,3,60,0,63
7201,E02000815,2014,27,361000,350000,0,0,0,27,0,27,0,27
7202,E02000816,2009,31,181000,175000,0,0,2,29,0,31,2,29
7203,E02000816,2010,62,242000,205000,0,4,16,42,2,60,19,43
7204,E02000816,2011,76,242000,200000,0,1,22,53,1,75,23,53
7205,E02000816,2012,96,245000,215000,1,3,29,63,0,96,32,64
7206,E02000816,2013,110,259000,239000,0,0,26,84,2,108,24,86
7207,E02000816,2014,32,255000,242000,0,0,3,29,0,32,3,29
7208,E02000817,2009,18,237000,224000,1,1,4,12,0,18,6,12
7209,E02000817,2010,28,219000,192000,0,0,5,23,0,28,7,21
7210,E02000817,2011,28,207000,185000,0,1,6,21,0,28,7,21
7211,E02000817,2012,20,246000,228000,0,0,6,14,0,20,6,14
7212,E02000817,2013,120,296000,300000,0,2,4,114,79,41,6,114
7213,E02000817,2014,18,357000,332000,0,0,2,16,7,11,2,16
7214,E02000818,2009,30,252000,204000,1,1,7,21,0,30,9,21
7215,E02000818,2010,40,305000,244000,0,0,7,33,0,40,8,32
7216,E02000818,2011,40,273000,221000,1,1,4,34,0,40,6,34
7217,E02000818,2012,48,299000,262000,0,0,9,39,0,48,9,39
7218,E02000818,2013,57,363000,316000,1,0,11,45,0,57,12,45
7219,E02000818,2014,32,327000,290000,1,0,0,31,5,27,2,30
7220,E02000819,2009,43,197000,170000,0,2,8,33,2,41,10,33
7221,E02000819,2010,55,256000,235000,0,0,18,37,9,46,17,38
7222,E02000819,2011,50,233000,218000,0,1,16,33,2,48,17,33
7223,E02000819,2012,58,273000,249000,2,1,16,39,3,55,19,39
7224,E02000819,2013,77,257000,235000,0,0,13,64,6,71,12,65
7225,E02000819,2014,17,297000,250000,0,1,3,13,0,17,4,13
7226,E02000820,2009,50,253000,220000,0,2,10,38,0,50,12,38
7227,E02000820,2010,349,340000,322000,0,4,15,330,286,63,20,329
7228,E02000820,2011,190,338000,311000,0,0,14,176,108,82,13,177
7229,E02000820,2012,85,380000,315000,0,0,13,72,8,77,13,72
7230,E02000820,2013,125,364000,330000,0,1,11,113,0,125,12,113
7231,E02000820,2014,38,411000,371000,0,0,5,33,1,37,4,34
7232,E02000821,2009,15,203000,185000,0,1,2,12,0,15,3,12
7233,E02000821,2010,19,350000,239000,0,2,6,11,0,19,8,11
7234,E02000821,2011,19,313000,210000,0,2,7,10,0,19,8,11
7235,E02000821,2012,30,243000,219000,0,1,2,27,4,26,3,27
7236,E02000821,2013,39,262000,205000,0,0,8,31,0,39,8,31
7237,E02000821,2014,14,287000,206000,0,1,1,12,0,14,2,12
7238,E02000822,2009,22,196000,174000,0,0,6,16,0,22,6,16
7239,E02000822,2010,23,234000,225000,0,2,5,16,0,23,6,17
7240,E02000822,2011,18,207000,198000,0,0,5,13,0,18,5,13
7241,E02000822,2012,30,249000,238000,0,0,8,22,0,30,6,24
7242,E02000822,2013,33,264000,240000,0,1,9,23,1,32,10,23
7243,E02000822,2014,21,275000,270000,0,0,2,19,0,21,2,19
7244,E02000823,2009,40,276000,250000,0,2,13,25,1,39,14,26
7245,E02000823,2010,50,286000,250000,0,2,13,35,1,49,13,37
7246,E02000823,2011,44,294000,250000,0,1,12,31,0,44,12,32
7247,E02000823,2012,59,327000,310000,1,2,15,41,3,56,18,41
7248,E02000823,2013,193,335000,305000,2,1,18,172,78,115,20,173
7249,E02000823,2014,44,420000,365000,0,0,9,35,15,29,8,36
7250,E02000824,2009,12,192000,170000,1,0,0,11,1,11,1,11
7251,E02000824,2010,23,196000,182000,0,0,4,19,0,23,5,18
7252,E02000824,2011,24,200000,197000,0,0,5,19,0,24,6,18
7253,E02000824,2012,16,220000,208000,0,0,4,12,0,16,3,13
7254,E02000824,2013,49,233000,235000,0,0,8,41,1,48,7,42
7255,E02000824,2014,21,278000,250000,0,0,5,16,1,20,5,16
7256,E02000825,2009,19,186000,172000,0,0,3,16,3,16,3,16
7257,E02000825,2010,32,204000,184000,0,0,6,26,0,32,5,27
7258,E02000825,2011,31,189000,175000,0,0,6,25,0,31,6,25
7259,E02000825,2012,43,208000,197000,0,1,4,38,0,43,5,38
7260,E02000825,2013,74,230000,206000,0,1,9,64,4,70,8,66
7261,E02000825,2014,18,246000,218000,0,0,1,17,0,18,1,17
7262,E02000826,2009,53,230000,205000,0,1,19,33,0,53,20,33
7263,E02000826,2010,39,260000,235000,0,1,13,25,0,39,14,25
7264,E02000826,2011,45,313000,305000,0,1,21,23,0,45,21,24
7265,E02000826,2012,68,238000,204000,0,0,13,55,0,68,13,55
7266,E02000826,2013,100,334000,278000,0,0,22,78,17,83,22,78
7267,E02000826,2014,37,345000,276000,0,0,6,31,2,35,6,31
7268,E02000827,2009,30,199000,168000,0,0,5,25,0,30,5,25
7269,E02000827,2010,54,240000,216000,0,1,6,47,13,41,6,48
7270,E02000827,2011,53,253000,215000,1,2,7,43,0,53,9,44
7271,E02000827,2012,68,303000,290000,0,1,8,59,16,52,9,59
7272,E02000827,2013,49,240000,210000,0,0,2,47,5,44,1,48
7273,E02000827,2014,19,301000,250000,0,0,1,18,2,17,1,18
7274,E02000828,2009,23,232000,190000,0,1,10,12,0,23,11,12
7275,E02000828,2010,54,212000,202000,0,1,22,31,0,54,23,31
7276,E02000828,2011,48,236000,194000,0,2,17,29,0,48,20,28
7277,E02000828,2012,45,243000,210000,0,1,14,30,2,43,12,33
7278,E02000828,2013,66,272000,243000,0,1,23,42,0,66,23,43
7279,E02000828,2014,26,345000,282000,0,2,9,15,0,26,11,15
7280,E02000829,2009,53,219000,197000,0,2,18,33,11,42,20,33
7281,E02000829,2010,74,256000,248000,3,1,21,49,9,65,26,48
7282,E02000829,2011,77,263000,218000,0,2,31,44,2,75,32,45
7283,E02000829,2012,76,283000,271000,0,1,34,41,1,75,33,43
7284,E02000829,2013,129,313000,270000,0,1,47,81,6,123,47,82
7285,E02000829,2014,37,344000,290000,0,0,8,29,0,37,8,29
7286,E02000830,2009,105,301000,245000,0,5,30,70,6,99,33,72
7287,E02000830,2010,124,356000,266000,2,6,29,87,11,113,36,88
7288,E02000830,2011,122,415000,310000,3,7,32,80,16,106,38,84
7289,E02000830,2012,136,429000,315000,2,3,47,84,10,126,46,90
7290,E02000830,2013,168,530000,405000,2,7,49,110,18,150,55,113
7291,E02000830,2014,55,449000,390000,0,1,12,42,12,43,12,43
7292,E02000831,2009,108,316000,302000,1,8,54,45,7,101,64,44
7293,E02000831,2010,138,362000,338000,2,13,65,58,4,134,81,57
7294,E02000831,2011,144,387000,378000,1,15,70,58,0,144,86,58
7295,E02000831,2012,141,385000,350000,2,12,50,77,7,134,63,78
7296,E02000831,2013,135,472000,390000,1,11,56,67,3,132,67,68
7297,E02000831,2014,31,539000,575000,1,2,15,13,0,31,16,15
7298,E02000832,2009,57,269000,250000,0,6,28,23,0,57,34,23
7299,E02000832,2010,83,248000,235000,0,2,33,48,1,82,36,47
7300,E02000832,2011,85,297000,255000,2,6,39,38,0,85,45,40
7301,E02000832,2012,94,307000,290000,1,2,45,46,5,89,47,47
7302,E02000832,2013,132,334000,288000,2,8,45,77,2,130,52,80
7303,E02000832,2014,35,345000,300000,0,1,9,25,1,34,10,25
7304,E02000833,2009,61,236000,225000,1,5,10,45,7,54,16,45
7305,E02000833,2010,70,250000,212000,1,4,13,52,3,67,13,57
7306,E02000833,2011,82,282000,258000,1,4,22,55,1,81,24,58
7307,E02000833,2012,92,342000,248000,0,11,22,59,0,92,32,60
7308,E02000833,2013,90,331000,250000,0,6,22,62,0,90,27,63
7309,E02000833,2014,27,368000,300000,0,0,5,22,0,27,5,22
7310,E02000834,2009,133,342000,320000,2,21,40,70,1,132,64,69
7311,E02000834,2010,172,392000,338000,2,21,59,90,7,165,84,88
7312,E02000834,2011,182,402000,352000,6,21,69,86,1,181,94,88
7313,E02000834,2012,141,464000,425000,2,16,56,67,1,140,71,70
7314,E02000834,2013,192,494000,411000,3,21,59,109,0,192,81,111
7315,E02000834,2014,43,552000,435000,0,4,17,22,3,40,19,24
7316,E02000835,2009,85,286000,265000,1,10,35,39,7,78,46,39
7317,E02000835,2010,109,337000,295000,0,12,46,51,10,99,57,52
7318,E02000835,2011,104,339000,298000,0,12,39,53,11,93,50,54
7319,E02000835,2012,113,357000,318000,1,13,47,52,3,110,61,52
7320,E02000835,2013,162,426000,373000,2,14,61,85,21,141,73,89
7321,E02000835,2014,59,425000,370000,0,6,16,37,5,54,22,37
7322,E02000836,2009,117,398000,385000,0,17,61,39,0,117,77,40
7323,E02000836,2010,139,460000,410000,2,21,65,51,5,134,86,53
7324,E02000836,2011,126,530000,460000,0,22,59,45,0,126,79,47
7325,E02000836,2012,173,483000,478000,1,22,86,64,0,173,107,66
7326,E02000836,2013,176,565000,533000,0,29,76,71,0,176,103,73
7327,E02000836,2014,50,579000,582000,1,1,26,22,0,50,27,23
7328,E02000837,2009,102,702000,650000,6,33,39,24,0,102,69,33
7329,E02000837,2010,124,756000,696000,6,34,53,31,1,123,82,42
7330,E02000837,2011,118,884000,718000,8,38,46,26,0,118,83,35
7331,E02000837,2012,102,739000,718000,6,19,41,36,1,101,57,45
7332,E02000837,2013,117,903000,900000,4,36,45,32,1,116,80,37
7333,E02000837,2014,41,1059000,956000,4,11,16,10,0,41,28,13
7334,E02000838,2009,138,354000,290000,2,21,41,74,7,131,63,75
7335,E02000838,2010,148,379000,308000,1,28,38,81,2,146,67,81
7336,E02000838,2011,126,360000,294000,5,13,31,77,1,125,47,79
7337,E02000838,2012,163,374000,315000,2,17,47,97,1,162,66,97
7338,E02000838,2013,170,429000,346000,3,27,38,102,2,168,67,103
7339,E02000838,2014,71,515000,425000,1,11,18,41,1,70,29,42
7340,E02000839,2009,66,354000,250000,7,6,16,37,3,63,25,41
7341,E02000839,2010,105,505000,280000,15,10,22,58,3,102,44,61
7342,E02000839,2011,90,432000,292000,11,8,21,50,0,90,38,52
7343,E02000839,2012,105,402000,268000,9,13,18,65,0,105,38,67
7344,E02000839,2013,143,452000,300000,16,6,18,103,1,142,37,106
7345,E02000839,2014,53,445000,315000,7,2,7,37,0,53,14,39
7346,E02000840,2009,71,170000,174000,1,3,48,19,9,62,53,18
7347,E02000840,2010,60,182000,184000,1,4,35,20,14,46,40,20
7348,E02000840,2011,54,181000,186000,1,5,31,17,3,51,37,17
7349,E02000840,2012,58,202000,200000,0,1,51,6,0,58,52,6
7350,E02000840,2013,74,210000,217000,3,7,53,11,2,72,63,11
7351,E02000840,2014,27,229000,236000,0,2,23,2,0,27,25,2
7352,E02000841,2009,54,175000,177000,0,1,44,9,0,54,44,10
7353,E02000841,2010,55,197000,200000,0,4,43,8,0,55,47,8
7354,E02000841,2011,59,189000,190000,0,3,49,7,0,59,53,6
7355,E02000841,2012,61,202000,202000,2,4,50,5,0,61,56,5
7356,E02000841,2013,81,205000,210000,0,1,64,16,0,81,64,17
7357,E02000841,2014,29,221000,235000,0,2,20,7,0,29,21,8
7358,E02000842,2009,63,239000,235000,2,26,26,9,0,63,54,9
7359,E02000842,2010,64,262000,260000,0,38,17,9,0,64,56,8
7360,E02000842,2011,78,261000,250000,3,43,22,10,0,78,68,10
7361,E02000842,2012,95,260000,250000,3,45,32,15,1,94,79,16
7362,E02000842,2013,98,281000,286000,3,44,35,16,2,96,82,16
7363,E02000842,2014,53,309000,320000,2,27,11,13,2,51,40,13
7364,E02000843,2009,105,178000,160000,1,19,28,57,0,105,49,56
7365,E02000843,2010,109,192000,168000,3,15,24,67,0,109,43,66
7366,E02000843,2011,89,187000,174000,2,15,23,49,1,88,39,50
7367,E02000843,2012,152,193000,179000,4,15,24,109,50,102,41,111
7368,E02000843,2013,125,212000,205000,3,19,37,66,4,121,56,69
7369,E02000843,2014,45,201000,178000,1,6,3,35,0,45,10,35
7370,E02000844,2009,77,196000,191000,1,18,45,13,0,77,62,15
7371,E02000844,2010,112,222000,226000,6,24,66,16,0,112,94,18
7372,E02000844,2011,91,215000,215000,0,24,56,11,0,91,78,13
7373,E02000844,2012,90,230000,236000,4,21,56,9,0,90,80,10
7374,E02000844,2013,106,226000,224000,3,14,57,32,0,106,74,32
7375,E02000844,2014,30,263000,276000,0,6,17,7,0,30,23,7
7376,E02000845,2009,112,247000,231000,3,13,73,23,1,111,88,24
7377,E02000845,2010,133,284000,262000,5,26,76,26,1,132,107,26
7378,E02000845,2011,161,322000,275000,6,23,91,41,55,106,119,42
7379,E02000845,2012,141,323000,296000,12,24,80,25,26,115,116,25
7380,E02000845,2013,168,307000,286000,4,36,75,53,12,156,115,53
7381,E02000845,2014,54,343000,320000,5,7,23,19,2,52,35,19
7382,E02000846,2009,73,224000,220000,3,22,26,22,0,73,51,22
7383,E02000846,2010,82,250000,240000,3,33,32,14,0,82,69,13
7384,E02000846,2011,70,243000,245000,4,33,21,12,0,70,58,12
7385,E02000846,2012,74,260000,250000,4,35,24,11,0,74,63,11
7386,E02000846,2013,77,271000,270000,4,26,29,18,1,76,59,18
7387,E02000846,2014,40,274000,276000,1,18,8,13,0,40,27,13
7388,E02000847,2009,129,263000,250000,11,44,55,19,7,122,109,20
7389,E02000847,2010,121,291000,275000,14,46,38,23,1,120,97,24
7390,E02000847,2011,129,277000,250000,8,45,51,25,5,124,104,25
7391,E02000847,2012,133,298000,275000,12,56,44,21,0,133,112,21
7392,E02000847,2013,148,321000,300000,22,51,47,28,0,148,120,28
7393,E02000847,2014,53,354000,350000,3,23,18,9,0,53,42,11
7394,E02000848,2009,99,233000,242000,2,24,51,22,5,94,77,22
7395,E02000848,2010,83,272000,275000,3,19,42,19,0,83,65,18
7396,E02000848,2011,97,266000,270000,2,19,58,18,0,97,77,20
7397,E02000848,2012,80,274000,274000,4,22,35,19,0,80,61,19
7398,E02000848,2013,104,288000,295000,0,22,56,26,1,103,77,27
7399,E02000848,2014,33,339000,335000,3,8,19,3,0,33,29,4
7400,E02000849,2009,97,215000,210000,11,21,31,34,0,97,63,34
7401,E02000849,2010,112,242000,238000,2,46,31,33,0,112,78,34
7402,E02000849,2011,84,227000,220000,1,24,36,23,0,84,61,23
7403,E02000849,2012,96,253000,250000,2,41,31,22,0,96,73,23
7404,E02000849,2013,136,249000,244000,4,44,34,54,0,136,80,56
7405,E02000849,2014,23,240000,228000,0,6,6,11,0,23,12,11
7406,E02000850,2009,130,220000,220000,5,40,57,28,0,130,101,29
7407,E02000850,2010,122,229000,227000,2,37,65,18,0,122,105,17
7408,E02000850,2011,121,239000,240000,6,42,53,20,0,121,102,19
7409,E02000850,2012,130,244000,248000,8,41,56,25,0,130,104,26
7410,E02000850,2013,141,260000,265000,7,56,52,26,1,140,115,26
7411,E02000850,2014,61,269000,270000,3,17,25,16,2,59,46,15
7412,E02000851,2009,143,176000,168000,3,23,30,87,11,132,53,90
7413,E02000851,2010,98,192000,176000,2,20,18,58,0,98,41,57
7414,E02000851,2011,110,183000,166000,1,19,19,71,0,110,38,72
7415,E02000851,2012,126,190000,183000,3,15,18,90,1,125,37,89
7416,E02000851,2013,145,216000,200000,3,21,24,97,6,139,48,97
7417,E02000851,2014,56,211000,204000,0,9,6,41,0,56,15,41
7418,E02000852,2009,108,214000,217000,5,35,34,34,0,108,77,31
7419,E02000852,2010,125,233000,235000,7,32,44,42,1,124,83,42
7420,E02000852,2011,103,227000,235000,3,24,40,36,4,99,67,36
7421,E02000852,2012,112,242000,240000,3,39,31,39,8,104,71,41
7422,E02000852,2013,124,251000,242000,6,35,34,49,0,124,74,50
7423,E02000852,2014,41,251000,232000,2,7,11,21,0,41,20,21
7424,E02000853,2009,124,221000,212000,4,34,61,25,6,118,99,25
7425,E02000853,2010,103,218000,215000,2,22,40,39,7,96,66,37
7426,E02000853,2011,88,229000,222000,4,17,41,26,1,87,62,26
7427,E02000853,2012,106,249000,250000,8,21,52,25,1,105,81,25
7428,E02000853,2013,145,247000,250000,8,28,61,48,0,145,97,48
7429,E02000853,2014,55,275000,285000,1,10,27,17,0,55,38,17
7430,E02000854,2009,87,248000,240000,8,31,25,23,4,83,62,25
7431,E02000854,2010,91,268000,250000,11,30,26,24,0,91,66,25
7432,E02000854,2011,108,275000,250000,13,34,29,32,6,102,75,33
7433,E02000854,2012,112,307000,289000,13,41,31,27,16,96,84,28
7434,E02000854,2013,150,318000,307000,22,46,47,35,15,135,115,35
7435,E02000854,2014,32,308000,278000,2,5,12,13,1,31,19,13
7436,E02000855,2009,84,321000,284000,6,42,18,18,1,83,66,18
7437,E02000855,2010,114,355000,335000,13,44,31,26,0,114,88,26
7438,E02000855,2011,111,387000,354000,26,39,19,27,0,111,84,27
7439,E02000855,2012,96,398000,365000,18,42,17,19,0,96,76,20
7440,E02000855,2013,102,414000,374000,14,48,18,22,0,102,80,22
7441,E02000855,2014,32,425000,388000,5,11,7,9,0,32,23,9
7442,E02000856,2009,106,226000,200000,5,28,23,50,0,106,53,53
7443,E02000856,2010,102,266000,250000,11,32,19,40,0,102,61,41
7444,E02000856,2011,195,218000,188000,11,26,20,138,84,111,55,140
7445,E02000856,2012,131,257000,198000,11,34,15,71,31,100,59,72
7446,E02000856,2013,144,265000,232000,11,40,16,77,10,134,67,77
7447,E02000856,2014,45,321000,318000,8,15,3,19,0,45,26,19
7448,E02000857,2009,153,227000,185000,11,9,18,115,19,134,35,118
7449,E02000857,2010,149,222000,198000,3,8,22,116,5,144,34,115
7450,E02000857,2011,149,219000,195000,7,6,23,113,0,149,34,115
7451,E02000857,2012,145,219000,205000,3,4,13,125,0,145,20,125
7452,E02000857,2013,197,235000,215000,7,4,20,166,8,189,31,166
7453,E02000857,2014,60,236000,215000,1,2,5,52,1,59,8,52
7454,E02000858,2009,67,209000,190000,1,15,29,22,15,52,45,22
7455,E02000858,2010,41,233000,215000,1,8,17,15,1,40,26,15
7456,E02000858,2011,42,211000,212000,6,4,17,15,2,40,26,16
7457,E02000858,2012,54,222000,210000,2,11,19,22,0,54,32,22
7458,E02000858,2013,45,216000,195000,3,4,17,21,0,45,23,22
7459,E02000858,2014,26,228000,225000,0,1,11,14,0,26,12,14
7460,E02000859,2009,125,251000,200000,17,31,16,61,0,125,65,60
7461,E02000859,2010,113,289000,247000,20,24,17,52,0,113,61,52
7462,E02000859,2011,113,285000,237000,16,25,16,56,10,103,58,55
7463,E02000859,2012,125,289000,234000,16,27,16,66,8,117,60,65
7464,E02000859,2013,133,314000,275000,19,39,18,57,6,127,78,55
7465,E02000859,2014,37,320000,240000,6,2,7,22,2,35,16,21
7466,E02000860,2009,143,193000,167000,6,6,10,121,2,141,20,123
7467,E02000860,2010,119,194000,176000,1,7,8,103,7,112,13,106
7468,E02000860,2011,136,213000,190000,3,3,14,116,9,127,20,116
7469,E02000860,2012,158,190000,174000,2,3,8,145,2,156,13,145
7470,E02000860,2013,158,207000,180000,2,3,7,146,1,157,12,146
7471,E02000860,2014,60,232000,190000,1,3,4,52,0,60,8,52
7472,E02000861,2009,88,380000,358000,32,28,8,20,2,86,69,19
7473,E02000861,2010,81,454000,446000,39,29,2,11,0,81,70,11
7474,E02000861,2011,81,441000,420000,29,32,4,16,0,81,64,17
7475,E02000861,2012,78,437000,424000,27,30,2,19,3,75,59,19
7476,E02000861,2013,117,456000,442000,52,33,6,26,1,116,92,25
7477,E02000861,2014,36,529000,502000,20,10,0,6,0,36,30,6
7478,E02000863,2009,62,324000,319000,20,23,8,11,0,62,51,11
7479,E02000863,2010,58,341000,328000,15,28,6,9,1,57,49,9
7480,E02000863,2011,54,369000,346000,20,17,10,7,0,54,48,6
7481,E02000863,2012,63,415000,410000,32,22,8,1,0,63,62,1
7482,E02000863,2013,163,332000,300000,36,41,28,58,75,88,105,58
7483,E02000863,2014,36,348000,380000,11,6,8,11,11,25,25,11
7484,E02000864,2009,35,246000,236000,0,0,7,28,0,35,10,25
7485,E02000864,2010,57,277000,235000,1,1,8,47,0,57,9,48
7486,E02000864,2011,67,232000,228000,0,2,8,57,0,67,8,59
7487,E02000864,2012,91,301000,265000,0,2,19,70,6,85,21,70
7488,E02000864,2013,96,322000,310000,0,2,17,77,1,95,19,77
7489,E02000864,2014,44,374000,354000,0,0,4,40,10,34,4,40
7490,E02000865,2009,28,220000,212000,0,0,1,27,1,27,0,28
7491,E02000865,2010,44,261000,250000,0,0,4,40,4,40,4,40
7492,E02000865,2011,40,273000,275000,0,0,1,39,10,30,0,40
7493,E02000865,2012,44,353000,283000,0,1,3,40,0,44,2,42
7494,E02000865,2013,48,278000,266000,0,0,4,44,0,48,2,46
7495,E02000865,2014,21,420000,350000,0,1,1,19,1,20,2,19
7496,E02000866,2009,77,346000,325000,0,3,30,44,1,76,34,43
7497,E02000866,2010,107,404000,378000,0,2,56,49,0,107,56,51
7498,E02000866,2011,109,398000,325000,0,1,52,56,0,109,50,59
7499,E02000866,2012,115,413000,370000,1,2,50,62,0,115,51,64
7500,E02000866,2013,120,455000,392000,1,2,50,67,0,120,50,70
7501,E02000866,2014,91,470000,430000,0,0,18,73,50,41,17,74
7502,E02000867,2009,159,257000,248000,0,0,12,147,94,65,14,145
7503,E02000867,2010,168,256000,238000,0,1,15,152,53,115,16,152
7504,E02000867,2011,175,271000,250000,1,1,20,153,39,136,20,155
7505,E02000867,2012,142,294000,264000,0,2,14,126,6,136,17,125
7506,E02000867,2013,229,311000,300000,0,1,16,212,56,173,17,212
7507,E02000867,2014,82,341000,320000,0,0,8,74,4,78,7,75
7508,E02000868,2009,33,249000,242000,0,0,2,31,1,32,2,31
7509,E02000868,2010,107,302000,280000,0,0,4,103,44,63,4,103
7510,E02000868,2011,60,295000,275000,1,0,3,56,0,60,2,58
7511,E02000868,2012,122,326000,328000,0,1,6,115,55,67,6,116
7512,E02000868,2013,77,360000,330000,0,0,4,73,2,75,4,73
7513,E02000868,2014,48,380000,367000,0,0,1,47,19,29,1,47
7514,E02000869,2009,33,377000,360000,0,0,16,17,0,33,16,17
7515,E02000869,2010,47,413000,375000,0,0,21,26,0,47,21,26
7516,E02000869,2011,34,381000,345000,0,0,8,26,0,34,8,26
7517,E02000869,2012,47,444000,385000,0,0,20,27,4,43,18,29
7518,E02000869,2013,62,450000,382000,0,0,12,50,12,50,12,50
7519,E02000869,2014,19,480000,420000,0,0,5,14,0,19,5,14
7520,E02000870,2009,57,236000,220000,0,0,5,52,15,42,5,52
7521,E02000870,2010,63,291000,265000,0,0,11,52,0,63,11,52
7522,E02000870,2011,58,278000,250000,0,1,11,46,0,58,12,46
7523,E02000870,2012,45,286000,268000,0,0,2,43,2,43,2,43
7524,E02000870,2013,74,311000,276000,1,0,7,66,3,71,8,66
7525,E02000870,2014,27,394000,350000,0,0,5,22,0,27,4,23
7526,E02000871,2009,21,192000,182000,0,0,2,19,0,21,1,20
7527,E02000871,2010,117,237000,222000,0,0,2,115,88,29,3,114
7528,E02000871,2011,117,242000,240000,0,0,1,116,88,29,0,117
7529,E02000871,2012,45,245000,245000,0,0,1,44,23,22,1,44
7530,E02000871,2013,209,282000,269000,0,0,5,204,155,54,5,204
7531,E02000871,2014,17,297000,250000,0,0,2,15,0,17,2,15
7532,E02000872,2009,106,309000,286000,0,0,1,105,72,34,1,105
7533,E02000872,2010,96,325000,310000,0,0,2,94,51,45,2,94
7534,E02000872,2011,68,330000,322000,0,0,5,63,11,57,5,63
7535,E02000872,2012,71,380000,356000,0,0,1,70,0,71,1,70
7536,E02000872,2013,88,494000,424000,0,0,3,85,9,79,3,85
7537,E02000872,2014,131,493000,483000,0,0,2,129,95,36,2,129
7538,E02000873,2009,30,244000,202000,0,0,2,28,10,20,2,28
7539,E02000873,2010,41,289000,245000,0,0,4,37,5,36,5,36
7540,E02000873,2011,53,282000,250000,0,0,5,48,2,51,4,49
7541,E02000873,2012,56,313000,306000,1,0,8,47,9,47,9,47
7542,E02000873,2013,66,333000,325000,0,0,7,59,0,66,7,59
7543,E02000873,2014,24,322000,321000,0,0,2,22,1,23,2,22
7544,E02000874,2009,25,267000,250000,0,0,6,19,6,19,6,19
7545,E02000874,2010,36,265000,250000,0,0,1,35,7,29,2,34
7546,E02000874,2011,27,277000,250000,1,0,3,23,2,25,1,26
7547,E02000874,2012,33,278000,286000,0,0,4,29,1,32,3,30
7548,E02000874,2013,44,277000,250000,0,0,3,41,0,44,3,41
7549,E02000874,2014,18,313000,268000,0,0,1,17,0,18,1,17
7550,E02000875,2009,174,252000,234000,0,1,0,173,143,31,1,173
7551,E02000875,2010,76,251000,225000,0,0,4,72,27,49,5,71
7552,E02000875,2011,226,248000,230000,0,1,10,215,94,132,6,220
7553,E02000875,2012,348,277000,250000,0,0,4,344,274,74,4,344
7554,E02000875,2013,170,290000,255000,0,0,8,162,62,108,6,164
7555,E02000875,2014,45,331000,282000,0,1,3,41,0,45,4,41
7556,E02000876,2009,46,244000,248000,0,0,5,41,11,35,4,42
7557,E02000876,2010,67,276000,250000,0,0,10,57,7,60,9,58
7558,E02000876,2011,55,253000,236000,0,0,2,53,0,55,2,53
7559,E02000876,2012,56,273000,250000,0,0,6,50,3,53,6,50
7560,E02000876,2013,73,307000,290000,0,0,10,63,0,73,9,64
7561,E02000876,2014,30,334000,292000,0,0,4,26,0,30,3,27
7562,E02000877,2009,43,234000,230000,0,1,3,39,12,31,5,38
7563,E02000877,2010,88,296000,296000,0,0,12,76,39,49,12,76
7564,E02000877,2011,52,294000,278000,0,0,9,43,25,27,8,44
7565,E02000877,2012,172,272000,250000,0,1,12,159,113,59,13,159
7566,E02000877,2013,196,273000,260000,0,0,12,184,129,67,12,184
7567,E02000877,2014,21,335000,320000,0,0,1,20,2,19,1,20
7568,E02000878,2009,67,331000,325000,0,1,3,63,5,62,5,62
7569,E02000878,2010,97,423000,370000,0,2,5,90,11,86,8,89
7570,E02000878,2011,118,424000,380000,1,0,6,111,7,111,6,112
7571,E02000878,2012,89,514000,415000,0,0,9,80,0,89,8,81
7572,E02000878,2013,119,603000,450000,1,0,7,111,23,96,8,111
7573,E02000878,2014,44,638000,561000,0,0,5,39,6,38,5,39
7574,E02000879,2009,43,251000,220000,0,1,4,38,1,42,8,35
7575,E02000879,2010,50,270000,240000,0,0,7,43,1,49,5,45
7576,E02000879,2011,64,315000,315000,0,3,7,54,33,31,7,57
7577,E02000879,2012,52,341000,355000,0,0,10,42,7,45,10,42
7578,E02000879,2013,98,329000,300000,0,0,10,88,44,54,10,88
7579,E02000879,2014,17,380000,365000,0,0,3,14,2,15,3,14
7580,E02000880,2009,29,269000,248000,0,0,6,23,1,28,7,22
7581,E02000880,2010,59,224000,212000,0,0,2,57,13,46,3,56
7582,E02000880,2011,58,275000,247000,0,0,3,55,13,45,3,55
7583,E02000880,2012,54,270000,250000,0,0,7,47,4,50,7,47
7584,E02000880,2013,85,288000,250000,0,0,6,79,10,75,6,79
7585,E02000880,2014,29,388000,320000,0,1,2,26,0,29,3,26
7586,E02000881,2009,21,200000,205000,0,1,4,16,3,18,6,15
7587,E02000881,2010,55,254000,248000,0,0,7,48,27,28,8,47
7588,E02000881,2011,28,220000,200000,0,0,9,19,0,28,6,22
7589,E02000881,2012,19,279000,245000,0,0,4,15,1,18,4,15
7590,E02000881,2013,94,272000,268000,0,0,7,87,54,40,6,88
7591,E02000881,2014,31,330000,265000,0,0,2,29,15,16,2,29
7592,E02000882,2009,36,238000,215000,0,0,7,29,20,16,7,29
7593,E02000882,2010,64,271000,270000,0,2,14,48,22,42,16,48
7594,E02000882,2011,41,263000,215000,0,0,13,28,2,39,13,28
7595,E02000882,2012,46,310000,281000,0,0,14,32,0,46,13,33
7596,E02000882,2013,192,319000,326000,0,0,10,182,139,53,10,182
7597,E02000882,2014,52,396000,370000,0,0,7,45,32,20,6,46
7598,E02000883,2009,21,199000,194000,0,2,4,15,0,21,4,17
7599,E02000883,2010,19,218000,200000,0,1,5,13,1,18,5,14
7600,E02000883,2011,56,242000,238000,0,1,3,52,27,29,2,54
7601,E02000883,2012,27,205000,208000,0,0,0,27,0,27,0,27
7602,E02000883,2013,139,265000,250000,0,0,7,132,83,56,6,133
7603,E02000883,2014,24,262000,260000,0,0,0,24,5,19,0,24
7604,E02000884,2009,210,369000,345000,0,1,8,201,155,55,8,202
7605,E02000884,2010,123,445000,390000,0,2,6,115,39,84,9,114
7606,E02000884,2011,158,336000,335000,0,0,5,153,68,90,4,154
7607,E02000884,2012,203,371000,330000,0,0,7,196,87,116,7,196
7608,E02000884,2013,221,532000,465000,1,0,8,212,92,129,9,212
7609,E02000884,2014,121,611000,630000,0,0,1,120,76,45,1,120
7610,E02000885,2009,10,233000,220000,0,0,0,10,1,9,0,10
7611,E02000885,2010,27,237000,215000,0,0,2,25,11,16,2,25
7612,E02000885,2011,26,258000,238000,0,0,1,25,1,25,1,25
7613,E02000885,2012,31,276000,242000,0,1,3,27,2,29,4,27
7614,E02000885,2013,57,328000,250000,0,0,7,50,5,52,7,50
7615,E02000885,2014,24,321000,292000,0,0,0,24,1,23,0,24
7616,E02000886,2009,81,413000,350000,0,0,7,74,1,80,7,74
7617,E02000886,2010,97,428000,348000,0,0,11,86,0,97,9,88
7618,E02000886,2011,129,358000,315000,0,0,6,123,21,108,5,124
7619,E02000886,2012,165,355000,315000,0,1,3,161,78,87,4,161
7620,E02000886,2013,178,435000,366000,0,0,7,171,26,152,6,172
7621,E02000886,2014,37,430000,400000,1,0,2,34,0,37,3,34
7622,E02000887,2009,58,233000,245000,0,1,6,51,17,41,5,53
7623,E02000887,2010,33,217000,211000,0,0,4,29,1,32,3,30
7624,E02000887,2011,48,247000,230000,0,1,8,39,1,47,9,39
7625,E02000887,2012,79,246000,238000,0,0,3,76,34,45,2,77
7626,E02000887,2013,125,287000,275000,0,0,9,116,52,73,9,116
7627,E02000887,2014,29,297000,268000,0,1,4,24,2,27,5,24
7628,E02000888,2009,68,382000,370000,0,1,1,66,1,67,1,67
7629,E02000888,2010,83,388000,370000,1,0,2,80,3,80,2,81
7630,E02000888,2011,130,394000,340000,0,0,3,127,47,83,1,129
7631,E02000888,2012,88,396000,341000,0,0,3,85,7,81,4,84
7632,E02000888,2013,153,412000,375000,0,1,4,148,6,147,5,148
7633,E02000888,2014,107,412000,360000,1,0,0,106,63,44,1,106
7634,E02000889,2009,55,385000,355000,1,0,6,48,0,55,7,48
7635,E02000889,2010,77,376000,336000,0,0,10,67,0,77,9,68
7636,E02000889,2011,98,375000,325000,0,0,14,84,18,80,12,86
7637,E02000889,2012,246,356000,305000,0,0,12,234,167,79,10,236
7638,E02000889,2013,97,438000,375000,0,0,17,80,3,94,13,84
7639,E02000889,2014,73,376000,325000,0,0,5,68,37,36,5,68
7640,E02000890,2009,108,481000,378000,0,0,3,105,5,103,4,104
7641,E02000890,2010,136,514000,458000,1,1,6,128,2,134,6,130
7642,E02000890,2011,118,606000,454000,0,0,2,116,0,118,1,117
7643,E02000890,2012,123,608000,488000,1,0,4,118,1,122,3,120
7644,E02000890,2013,117,713000,565000,0,0,6,111,0,117,5,112
7645,E02000890,2014,47,837000,670000,1,0,1,45,0,47,2,45
7646,E02000891,2009,267,267000,242000,1,0,7,259,164,103,10,257
7647,E02000891,2010,230,342000,302000,0,0,13,217,92,138,13,217
7648,E02000891,2011,338,375000,340000,1,2,9,326,216,122,12,326
7649,E02000891,2012,394,395000,360000,1,0,16,377,176,218,18,376
7650,E02000891,2013,338,401000,366000,0,1,16,321,16,322,18,320
7651,E02000891,2014,105,388000,370000,0,0,2,103,0,105,2,103
7652,E02000893,2009,41,282000,248000,0,0,8,33,0,41,8,33
7653,E02000893,2010,75,295000,275000,0,3,11,61,2,73,13,62
7654,E02000893,2011,61,322000,300000,0,1,13,47,0,61,14,47
7655,E02000893,2012,62,302000,265000,0,3,12,47,0,62,15,47
7656,E02000893,2013,85,350000,324000,1,3,22,59,0,85,21,64
7657,E02000893,2014,28,384000,360000,0,0,5,23,0,28,5,23
7658,E02000894,2009,110,322000,305000,0,2,21,87,4,106,21,89
7659,E02000894,2010,156,319000,298000,1,3,16,136,2,154,20,136
7660,E02000894,2011,178,324000,304000,0,3,34,141,0,178,31,147
7661,E02000894,2012,156,336000,330000,0,1,25,130,3,153,21,135
7662,E02000894,2013,255,358000,342000,0,3,42,210,27,228,37,218
7663,E02000894,2014,66,422000,376000,0,1,5,60,7,59,6,60
7664,E02000895,2009,75,237000,230000,0,30,25,20,0,75,54,21
7665,E02000895,2010,71,270000,250000,3,37,19,12,0,71,58,13
7666,E02000895,2011,67,295000,275000,4,36,16,11,0,67,56,11
7667,E02000895,2012,81,289000,250000,6,43,13,19,1,80,62,19
7668,E02000895,2013,115,277000,280000,3,56,29,27,3,112,87,28
7669,E02000895,2014,39,317000,308000,2,22,8,7,5,34,32,7
7670,E02000896,2009,91,300000,270000,7,26,27,31,2,89,59,32
7671,E02000896,2010,114,299000,268000,4,33,32,45,0,114,68,46
7672,E02000896,2011,122,310000,295000,8,47,26,41,0,122,79,43
7673,E02000896,2012,109,302000,273000,8,23,30,48,0,109,60,49
7674,E02000896,2013,140,352000,320000,9,42,42,47,0,140,93,47
7675,E02000896,2014,45,374000,325000,4,9,17,15,0,45,30,15
7676,E02000897,2009,78,228000,210000,3,19,40,16,1,77,61,17
7677,E02000897,2010,88,266000,249000,6,30,29,23,0,88,65,23
7678,E02000897,2011,91,272000,235000,3,32,32,24,0,91,65,26
7679,E02000897,2012,83,281000,235000,4,22,42,15,0,83,68,15
7680,E02000897,2013,98,309000,282000,4,37,38,19,0,98,79,19
7681,E02000897,2014,39,298000,250000,0,10,13,16,0,39,23,16
7682,E02000898,2009,71,240000,240000,0,26,24,21,0,71,49,22
7683,E02000898,2010,83,257000,250000,1,28,33,21,0,83,60,23
7684,E02000898,2011,74,254000,247000,1,24,20,29,0,74,45,29
7685,E02000898,2012,83,272000,275000,3,29,27,24,0,83,59,24
7686,E02000898,2013,105,288000,285000,3,40,36,26,0,105,79,26
7687,E02000898,2014,26,289000,292000,0,5,15,6,0,26,19,7
7688,E02000899,2009,85,237000,240000,1,21,49,14,1,84,71,14
7689,E02000899,2010,84,264000,264000,1,17,53,13,2,82,71,13
7690,E02000899,2011,103,234000,234000,1,15,42,45,28,75,59,44
7691,E02000899,2012,88,256000,250000,2,22,49,15,0,88,73,15
7692,E02000899,2013,94,290000,290000,0,26,56,12,1,93,82,12
7693,E02000899,2014,30,327000,335000,3,8,16,3,0,30,27,3
7694,E02000900,2009,76,215000,220000,2,10,51,13,1,75,63,13
7695,E02000900,2010,88,218000,232000,1,7,57,23,0,88,63,25
7696,E02000900,2011,71,219000,235000,2,14,39,16,0,71,55,16
7697,E02000900,2012,78,230000,241000,3,18,39,18,0,78,59,19
7698,E02000900,2013,73,249000,258000,3,11,40,19,0,73,53,20
7699,E02000900,2014,37,252000,250000,3,5,17,12,1,36,25,12
7700,E02000901,2009,85,269000,250000,2,22,47,14,2,83,73,12
7701,E02000901,2010,116,285000,270000,5,22,58,31,0,116,84,32
7702,E02000901,2011,107,281000,277000,4,21,62,20,0,107,86,21
7703,E02000901,2012,109,286000,250000,4,17,47,41,15,94,69,40
7704,E02000901,2013,182,318000,298000,7,32,99,44,43,139,139,43
7705,E02000901,2014,66,299000,265000,0,10,19,37,21,45,29,37
7706,E02000902,2009,64,219000,229000,1,4,43,16,0,64,50,14
7707,E02000902,2010,64,233000,240000,1,5,39,19,0,64,45,19
7708,E02000902,2011,83,238000,250000,1,5,60,17,0,83,66,17
7709,E02000902,2012,69,227000,234000,1,3,43,22,0,69,47,22
7710,E02000902,2013,91,256000,260000,1,4,66,20,1,90,71,20
7711,E02000902,2014,33,264000,275000,0,0,20,13,0,33,20,13
7712,E02000903,2009,46,196000,200000,0,2,38,6,1,45,38,8
7713,E02000903,2010,58,205000,210000,2,6,38,12,0,58,45,13
7714,E02000903,2011,46,202000,204000,1,2,32,11,0,46,34,12
7715,E02000903,2012,55,221000,230000,2,4,40,9,0,55,45,10
7716,E02000903,2013,86,256000,250000,0,11,56,19,0,86,64,22
7717,E02000903,2014,33,292000,320000,0,1,22,10,0,33,20,13
7718,E02000904,2009,61,221000,215000,1,10,37,13,0,61,48,13
7719,E02000904,2010,69,238000,235000,0,9,48,12,0,69,57,12
7720,E02000904,2011,80,249000,248000,0,14,57,9,0,80,71,9
7721,E02000904,2012,76,256000,250000,0,13,55,8,0,76,66,10
7722,E02000904,2013,97,301000,300000,2,25,52,18,0,97,78,19
7723,E02000904,2014,27,346000,350000,0,2,19,6,0,27,21,6
7724,E02000905,2009,80,210000,215000,0,5,54,21,1,79,56,24
7725,E02000905,2010,101,221000,228000,1,1,68,31,0,101,67,34
7726,E02000905,2011,103,229000,240000,2,4,67,30,0,103,64,39
7727,E02000905,2012,98,247000,250000,0,5,67,26,0,98,63,35
7728,E02000905,2013,111,289000,275000,0,3,76,32,0,111,69,42
7729,E02000905,2014,47,328000,350000,0,1,34,12,0,47,30,17
7730,E02000906,2009,68,187000,181000,0,0,29,39,0,68,27,41
7731,E02000906,2010,99,204000,200000,0,5,45,49,0,99,45,54
7732,E02000906,2011,98,209000,208000,0,4,50,44,0,98,47,51
7733,E02000906,2012,88,228000,220000,0,0,42,46,0,88,39,49
7734,E02000906,2013,113,271000,270000,0,1,59,53,0,113,51,62
7735,E02000906,2014,44,321000,320000,0,2,20,22,0,44,18,26
7736,E02000907,2009,49,207000,215000,0,2,28,19,0,49,29,20
7737,E02000907,2010,62,218000,212000,2,0,32,28,7,55,31,31
7738,E02000907,2011,66,225000,220000,2,6,26,32,0,66,33,33
7739,E02000907,2012,55,255000,250000,0,6,24,25,0,55,30,25
7740,E02000907,2013,96,283000,245000,2,4,36,54,9,87,40,56
7741,E02000907,2014,30,286000,261000,1,1,11,17,0,30,12,18
7742,E02000908,2009,75,183000,175000,0,4,37,34,0,75,36,39
7743,E02000908,2010,109,198000,185000,1,3,40,65,16,93,42,67
7744,E02000908,2011,137,190000,191000,2,1,56,78,39,98,49,88
7745,E02000908,2012,112,213000,218000,0,2,65,45,4,108,65,47
7746,E02000908,2013,102,261000,250000,0,3,54,45,0,102,55,47
7747,E02000908,2014,31,275000,270000,0,0,16,15,0,31,14,17
7748,E02000909,2009,102,251000,247000,4,11,62,25,1,101,77,25
7749,E02000909,2010,84,274000,276000,2,10,39,33,0,84,52,32
7750,E02000909,2011,100,290000,289000,1,17,51,31,0,100,69,31
7751,E02000909,2012,88,310000,312000,1,12,48,27,0,88,59,29
7752,E02000909,2013,119,344000,345000,3,14,56,46,0,119,73,46
7753,E02000909,2014,52,396000,435000,1,6,24,21,0,52,30,22
7754,E02000910,2009,85,214000,205000,1,2,52,30,2,83,53,32
7755,E02000910,2010,100,246000,245000,1,13,51,35,1,99,62,38
7756,E02000910,2011,102,247000,242000,1,8,59,34,0,102,63,39
7757,E02000910,2012,114,273000,267000,5,6,54,49,11,103,63,51
7758,E02000910,2013,108,319000,310000,1,4,58,45,6,102,62,46
7759,E02000910,2014,50,357000,330000,0,2,23,25,1,49,24,26
7760,E02000911,2009,147,190000,186000,0,2,57,88,35,112,56,91
7761,E02000911,2010,94,218000,211000,0,1,52,41,3,91,51,43
7762,E02000911,2011,109,232000,215000,0,1,59,49,3,106,56,53
7763,E02000911,2012,109,228000,217000,1,1,52,55,6,103,54,55
7764,E02000911,2013,120,259000,249000,0,1,58,61,5,115,48,72
7765,E02000911,2014,58,299000,292000,0,0,24,34,1,57,21,37
7766,E02000912,2009,55,212000,215000,0,1,45,9,0,55,47,8
7767,E02000912,2010,61,226000,240000,0,5,48,8,0,61,50,11
7768,E02000912,2011,87,220000,230000,0,3,65,19,0,87,69,18
7769,E02000912,2012,86,237000,246000,1,0,63,22,0,86,64,22
7770,E02000912,2013,89,273000,270000,1,1,71,16,1,88,72,17
7771,E02000912,2014,42,322000,337000,0,2,30,10,0,42,31,11
7772,E02000913,2009,64,228000,235000,1,2,48,13,1,63,49,15
7773,E02000913,2010,53,276000,268000,1,5,38,9,0,53,44,9
7774,E02000913,2011,69,276000,250000,0,11,45,13,0,69,55,14
7775,E02000913,2012,72,278000,272000,3,5,46,18,0,72,51,21
7776,E02000913,2013,78,295000,292000,0,4,49,25,0,78,52,26
7777,E02000913,2014,28,375000,400000,0,2,18,8,0,28,20,8
7778,E02000914,2009,51,194000,185000,0,1,27,23,8,43,28,23
7779,E02000914,2010,55,224000,216000,1,1,36,17,0,55,37,18
7780,E02000914,2011,56,228000,232000,1,7,30,18,0,56,38,18
7781,E02000914,2012,44,220000,199000,1,3,21,19,1,43,24,20
7782,E02000914,2013,72,254000,220000,0,3,34,35,10,62,35,37
7783,E02000914,2014,43,296000,250000,2,2,16,23,1,42,20,23
7784,E02000915,2009,52,247000,240000,0,10,18,24,0,52,28,24
7785,E02000915,2010,70,266000,234000,2,8,24,36,1,69,33,37
7786,E02000915,2011,62,296000,250000,3,6,26,27,0,62,33,29
7787,E02000915,2012,64,290000,238000,3,9,19,33,0,64,30,34
7788,E02000915,2013,93,296000,240000,2,3,31,57,1,92,33,60
7789,E02000915,2014,25,384000,410000,2,3,8,12,0,25,13,12
7790,E02000916,2009,56,174000,171000,0,2,19,35,1,55,19,37
7791,E02000916,2010,81,186000,180000,0,3,32,46,0,81,29,52
7792,E02000916,2011,82,190000,184000,0,1,34,47,0,82,30,52
7793,E02000916,2012,93,205000,192000,0,0,41,52,0,93,37,56
7794,E02000916,2013,111,224000,218000,1,1,41,68,0,111,42,69
7795,E02000916,2014,39,278000,265000,0,0,14,25,1,38,10,29
7796,E02000917,2009,75,197000,190000,1,1,32,41,9,66,31,44
7797,E02000917,2010,95,196000,190000,1,1,43,50,10,85,35,60
7798,E02000917,2011,75,200000,198000,2,1,30,42,0,75,29,46
7799,E02000917,2012,96,217000,212000,0,4,48,44,0,96,49,47
7800,E02000917,2013,135,252000,230000,1,5,53,76,11,124,57,78
7801,E02000917,2014,39,262000,250000,0,1,12,26,2,37,12,27
7802,E02000918,2009,47,241000,220000,0,2,30,15,0,47,32,15
7803,E02000918,2010,56,244000,236000,1,3,27,25,0,56,31,25
7804,E02000918,2011,56,245000,233000,0,4,28,24,0,56,31,25
7805,E02000918,2012,62,284000,298000,1,4,37,20,0,62,40,22
7806,E02000918,2013,88,316000,315000,1,0,53,34,0,88,52,36
7807,E02000918,2014,29,332000,320000,0,0,14,15,2,27,14,15
7808,E02000919,2009,49,211000,215000,0,1,29,19,1,48,30,19
7809,E02000919,2010,80,232000,234000,0,4,54,22,1,79,59,21
7810,E02000919,2011,79,223000,228000,0,1,57,21,1,78,56,23
7811,E02000919,2012,77,237000,235000,0,2,47,28,0,77,49,28
7812,E02000919,2013,97,272000,275000,0,5,60,32,0,97,64,33
7813,E02000919,2014,27,312000,290000,0,1,17,9,0,27,18,9
7814,E02000920,2009,63,215000,212000,2,1,28,32,22,41,30,33
7815,E02000920,2010,66,207000,224000,0,4,26,36,17,49,31,35
7816,E02000920,2011,63,198000,198000,1,2,25,35,7,56,27,36
7817,E02000920,2012,47,225000,232000,0,0,27,20,0,47,27,20
7818,E02000920,2013,66,248000,241000,0,2,36,28,0,66,37,29
7819,E02000920,2014,27,238000,250000,0,1,11,15,1,26,12,15
7820,E02000921,2009,56,198000,215000,0,2,42,12,2,54,44,12
7821,E02000921,2010,56,221000,215000,0,2,36,18,0,56,38,18
7822,E02000921,2011,51,221000,235000,1,5,36,9,0,51,40,11
7823,E02000921,2012,56,213000,227000,0,0,36,20,0,56,36,20
7824,E02000921,2013,72,233000,236000,0,3,48,21,0,72,48,24
7825,E02000921,2014,21,292000,305000,0,0,15,6,0,21,15,6
7826,E02000922,2009,73,207000,200000,1,2,63,7,0,73,66,7
7827,E02000922,2010,87,206000,215000,0,3,69,15,1,86,74,13
7828,E02000922,2011,66,211000,220000,1,3,51,11,0,66,55,11
7829,E02000922,2012,85,221000,226000,0,2,67,16,2,83,68,17
7830,E02000922,2013,121,233000,245000,0,1,90,30,0,121,91,30
7831,E02000922,2014,50,284000,275000,0,1,40,9,0,50,41,9
7832,E02000923,2009,141,650000,435000,1,5,13,122,0,141,17,124
7833,E02000923,2010,170,642000,471000,1,4,17,148,21,149,20,150
7834,E02000923,2011,150,793000,518000,1,3,17,129,6,144,18,132
7835,E02000923,2012,143,758000,495000,1,1,17,124,9,134,14,129
7836,E02000923,2013,158,941000,655000,1,2,19,136,2,156,21,137
7837,E02000923,2014,55,757000,610000,1,0,3,51,0,55,4,51
7838,E02000924,2009,181,431000,415000,0,0,5,176,35,146,3,178
7839,E02000924,2010,142,417000,362000,0,0,10,132,4,138,8,134
7840,E02000924,2011,196,435000,374000,0,0,11,185,20,176,8,188
7841,E02000924,2012,150,447000,383000,0,1,10,139,10,140,9,141
7842,E02000924,2013,159,529000,460000,0,0,3,156,0,159,3,156
7843,E02000924,2014,53,566000,495000,0,0,2,51,1,52,2,51
7844,E02000925,2009,82,357000,302000,0,1,8,73,18,64,11,71
7845,E02000925,2010,89,536000,390000,0,3,23,63,17,72,26,63
7846,E02000925,2011,71,518000,391000,0,3,12,56,0,71,13,58
7847,E02000925,2012,75,521000,410000,0,3,13,59,1,74,15,60
7848,E02000925,2013,122,598000,515000,1,2,19,100,33,89,22,100
7849,E02000925,2014,24,958000,715000,0,0,7,17,0,24,7,17
7850,E02000926,2009,216,448000,400000,1,8,18,189,88,128,27,189
7851,E02000926,2010,208,516000,432000,0,14,17,177,47,161,27,181
7852,E02000926,2011,194,524000,442000,3,14,14,163,19,175,28,166
7853,E02000926,2012,334,497000,437000,2,11,12,309,148,186,25,309
7854,E02000926,2013,269,549000,485000,2,9,22,236,17,252,31,238
7855,E02000926,2014,106,610000,540000,0,3,2,101,26,80,5,101
7856,E02000927,2009,99,366000,340000,0,3,43,53,1,98,48,51
7857,E02000927,2010,132,421000,410000,0,1,63,68,1,131,64,68
7858,E02000927,2011,121,421000,400000,0,4,54,63,2,119,59,62
7859,E02000927,2012,107,507000,455000,0,0,65,42,8,99,58,49
7860,E02000927,2013,140,551000,540000,0,0,67,73,23,117,65,75
7861,E02000927,2014,31,648000,634000,0,0,18,13,2,29,17,14
7862,E02000928,2009,154,576000,450000,5,12,47,90,9,145,64,90
7863,E02000928,2010,153,634000,520000,1,15,58,79,3,150,72,81
7864,E02000928,2011,166,745000,690000,4,15,67,80,4,162,86,80
7865,E02000928,2012,161,711000,650000,3,8,64,86,5,156,73,88
7866,E02000928,2013,154,828000,670000,1,13,58,82,0,154,71,83
7867,E02000928,2014,64,882000,758000,1,5,20,38,0,64,25,39
7868,E02000929,2009,42,233000,210000,0,1,7,34,8,34,7,35
7869,E02000929,2010,67,272000,254000,0,1,10,56,25,42,12,55
7870,E02000929,2011,43,232000,225000,0,0,5,38,0,43,5,38
7871,E02000929,2012,87,283000,250000,0,2,6,79,29,58,7,80
7872,E02000929,2013,56,321000,270000,0,1,14,41,0,56,15,41
7873,E02000929,2014,20,324000,332000,0,0,3,17,0,20,2,18
7874,E02000930,2009,160,474000,419000,2,1,78,79,1,159,81,79
7875,E02000930,2010,221,467000,430000,0,3,86,132,12,209,87,134
7876,E02000930,2011,171,472000,450000,1,2,67,101,0,171,62,109
7877,E02000930,2012,211,535000,480000,1,2,73,135,1,210,74,137
7878,E02000930,2013,203,616000,534000,0,0,75,128,4,199,73,130
7879,E02000930,2014,60,708000,675000,0,0,21,39,0,60,21,39
7880,E02000931,2009,148,538000,471000,0,5,66,77,0,148,68,80
7881,E02000931,2010,209,609000,550000,1,6,91,111,6,203,94,115
7882,E02000931,2011,203,633000,515000,1,9,85,108,5,198,83,120
7883,E02000931,2012,187,684000,580000,1,3,71,112,4,183,73,114
7884,E02000931,2013,197,801000,685000,1,2,84,110,1,196,84,113
7885,E02000931,2014,55,929000,721000,1,3,17,34,1,54,21,34
7886,E02000932,2009,173,507000,397000,3,9,48,113,0,173,57,116
7887,E02000932,2010,232,551000,448000,4,6,65,157,2,230,72,160
7888,E02000932,2011,238,521000,422000,3,8,45,182,1,237,55,183
7889,E02000932,2012,230,507000,442000,1,2,36,191,34,196,38,192
7890,E02000932,2013,452,589000,500000,3,6,56,387,177,275,62,390
7891,E02000932,2014,109,648000,565000,1,0,8,100,21,88,8,101
7892,E02000933,2009,108,562000,324000,12,7,25,64,0,108,45,63
7893,E02000933,2010,151,651000,420000,10,19,26,96,0,151,52,99
7894,E02000933,2011,169,649000,415000,13,18,26,112,0,169,56,113
7895,E02000933,2012,162,661000,435000,8,26,29,99,3,159,65,97
7896,E02000933,2013,174,746000,482000,14,17,35,108,4,170,67,107
7897,E02000933,2014,66,827000,500000,5,6,13,42,0,66,24,42
7898,E02000934,2009,142,464000,372000,3,6,53,80,10,132,62,80
7899,E02000934,2010,233,476000,380000,3,5,72,153,39,194,76,157
7900,E02000934,2011,211,504000,405000,3,9,58,141,20,191,63,148
7901,E02000934,2012,218,547000,471000,1,8,66,143,5,213,72,146
7902,E02000934,2013,226,569000,462000,1,9,62,154,2,224,68,158
7903,E02000934,2014,54,616000,598000,1,4,9,40,0,54,11,43
7904,E02000935,2009,26,760000,200000,6,0,1,19,0,26,7,19
7905,E02000935,2010,23,432000,230000,2,0,6,15,0,23,8,15
7906,E02000935,2011,27,470000,222000,3,0,3,21,0,27,7,20
7907,E02000935,2012,21,812000,250000,4,0,5,12,0,21,9,12
7908,E02000935,2013,41,388000,220000,1,1,6,33,1,40,7,34
7909,E02000935,2014,6,1273000,258000,1,0,0,5,1,5,1,5
7910,E02000936,2009,93,409000,318000,3,4,7,79,2,91,15,78
7911,E02000936,2010,145,443000,332000,5,7,11,122,0,145,22,123
7912,E02000936,2011,253,463000,380000,9,3,16,225,99,154,24,229
7913,E02000936,2012,143,533000,400000,6,4,7,126,7,136,17,126
7914,E02000936,2013,186,524000,415000,5,4,15,162,8,178,23,163
7915,E02000936,2014,70,469000,439000,2,0,4,64,2,68,5,65
7916,E02000937,2009,149,784000,690000,5,20,66,58,0,149,93,56
7917,E02000937,2010,164,778000,545000,8,22,57,77,0,164,86,78
7918,E02000937,2011,140,746000,535000,8,12,48,72,0,140,68,72
7919,E02000937,2012,149,908000,595000,6,18,47,78,2,147,72,77
7920,E02000937,2013,172,837000,604000,2,15,51,104,1,171,66,106
7921,E02000937,2014,42,1221000,818000,0,7,21,14,0,42,27,15
7922,E02000938,2009,142,380000,370000,2,4,47,89,58,84,47,95
7923,E02000938,2010,160,417000,355000,4,7,57,92,41,119,68,92
7924,E02000938,2011,169,426000,357000,5,9,47,108,42,127,59,110
7925,E02000938,2012,145,503000,431000,4,4,63,74,51,94,72,73
7926,E02000938,2013,230,608000,440000,8,5,80,137,92,138,93,137
7927,E02000938,2014,87,611000,440000,1,6,17,63,29,58,24,63
7928,E02000939,2009,147,816000,742000,3,12,94,38,0,147,109,38
7929,E02000939,2010,133,898000,870000,2,10,85,36,0,133,94,39
7930,E02000939,2011,123,975000,954000,4,12,73,34,0,123,88,35
7931,E02000939,2012,117,1069000,1000000,3,15,73,26,0,117,87,30
7932,E02000939,2013,127,1052000,945000,3,12,64,48,0,127,77,50
7933,E02000939,2014,38,1405000,1400000,1,7,23,7,0,38,31,7
7934,E02000940,2009,198,282000,283000,1,2,18,177,123,75,21,177
7935,E02000940,2010,107,328000,291000,1,1,21,84,13,94,22,85
7936,E02000940,2011,124,321000,285000,0,3,30,91,7,117,31,93
7937,E02000940,2012,149,331000,309000,1,1,24,123,14,135,23,126
7938,E02000940,2013,280,364000,335000,0,1,21,258,99,181,20,260
7939,E02000940,2014,100,418000,401000,0,0,8,92,42,58,8,92
7940,E02000941,2009,205,559000,450000,1,7,105,92,1,204,114,91
7941,E02000941,2010,203,583000,435000,0,6,100,97,1,202,101,102
7942,E02000941,2011,224,617000,475000,3,13,111,97,0,224,122,102
7943,E02000941,2012,206,591000,436000,0,8,88,110,0,206,91,115
7944,E02000941,2013,253,676000,495000,1,7,108,137,4,249,113,140
7945,E02000941,2014,79,652000,542000,0,5,19,55,2,77,23,56
7946,E02000942,2009,119,480000,425000,4,15,41,59,1,118,61,58
7947,E02000942,2010,174,530000,494000,6,19,66,83,0,174,92,82
7948,E02000942,2011,179,570000,560000,8,25,70,76,1,178,101,78
7949,E02000942,2012,168,551000,500000,4,27,54,83,3,165,84,84
7950,E02000942,2013,215,663000,555000,9,23,75,108,8,207,105,110
7951,E02000942,2014,68,815000,802000,2,9,28,29,0,68,38,30
7952,E02000943,2009,151,516000,430000,4,6,60,81,2,149,69,82
7953,E02000943,2010,180,529000,406000,3,6,52,119,2,178,60,120
7954,E02000943,2011,153,619000,490000,4,5,61,83,7,146,71,82
7955,E02000943,2012,156,625000,500000,2,5,53,96,14,142,59,97
7956,E02000943,2013,239,611000,500000,3,4,67,165,46,193,71,168
7957,E02000943,2014,64,671000,578000,0,1,17,46,0,64,17,47
7958,E02000944,2009,39,235000,190000,0,1,1,37,0,39,2,37
7959,E02000944,2010,67,349000,247000,0,5,8,54,0,67,13,54
7960,E02000944,2011,70,325000,250000,2,4,5,59,0,70,12,58
7961,E02000944,2012,81,317000,250000,1,5,3,72,0,81,9,72
7962,E02000944,2013,130,376000,326000,1,4,15,110,20,110,20,110
7963,E02000944,2014,37,373000,337000,0,2,3,32,3,34,5,32
7964,E02000945,2009,33,252000,193000,2,1,7,23,0,33,10,23
7965,E02000945,2010,53,318000,248000,3,2,11,37,9,44,17,36
7966,E02000945,2011,43,281000,230000,2,2,14,25,4,39,18,25
7967,E02000945,2012,48,335000,222000,4,2,12,30,0,48,18,30
7968,E02000945,2013,59,348000,220000,4,1,12,42,1,58,16,43
7969,E02000945,2014,23,291000,270000,0,0,8,15,0,23,8,15
7970,E02000946,2009,105,359000,330000,1,2,40,62,2,103,42,63
7971,E02000946,2010,169,364000,320000,1,6,40,122,20,149,48,121
7972,E02000946,2011,161,415000,360000,2,16,40,103,5,156,54,107
7973,E02000946,2012,137,422000,370000,2,6,40,89,6,131,44,93
7974,E02000946,2013,138,528000,457000,1,8,39,90,0,138,45,93
7975,E02000946,2014,58,649000,546000,1,3,17,37,0,58,21,37
7976,E02000947,2009,178,397000,355000,0,5,85,88,1,177,93,85
7977,E02000947,2010,223,435000,400000,0,4,103,116,0,223,104,119
7978,E02000947,2011,204,451000,419000,2,11,92,99,0,204,101,103
7979,E02000947,2012,213,504000,474000,1,4,107,101,0,213,108,105
7980,E02000947,2013,212,553000,500000,1,6,93,112,10,202,94,118
7981,E02000947,2014,74,632000,534000,0,0,33,41,1,73,31,43
7982,E02000948,2009,187,362000,320000,2,10,37,138,22,165,51,136
7983,E02000948,2010,215,417000,348000,1,13,47,154,5,210,58,157
7984,E02000948,2011,202,411000,373000,3,9,56,134,1,201,62,140
7985,E02000948,2012,206,454000,389000,0,11,56,139,1,205,65,141
7986,E02000948,2013,239,502000,436000,1,5,54,179,1,238,53,186
7987,E02000948,2014,69,615000,520000,0,2,21,46,0,69,23,46
7988,E02000949,2009,178,556000,392000,1,29,55,93,0,178,83,95
7989,E02000949,2010,218,657000,438000,9,33,71,105,0,218,105,113
7990,E02000949,2011,190,643000,420000,4,30,66,90,0,190,97,93
7991,E02000949,2012,173,662000,520000,1,20,56,96,0,173,76,97
7992,E02000949,2013,197,791000,565000,4,21,80,92,10,187,105,92
7993,E02000949,2014,76,777000,644000,0,6,34,36,7,69,40,36
7994,E02000950,2009,96,382000,268000,4,4,18,70,0,96,26,70
7995,E02000950,2010,122,382000,282000,5,3,21,93,0,122,26,96
7996,E02000950,2011,116,463000,288000,9,3,14,90,0,116,25,91
7997,E02000950,2012,111,434000,295000,5,3,16,87,0,111,23,88
7998,E02000950,2013,139,444000,341000,3,8,24,104,0,139,34,105
7999,E02000950,2014,54,512000,369000,3,1,4,46,1,53,6,48
8000,E02000951,2009,89,425000,310000,0,8,16,65,2,87,26,63
8001,E02000951,2010,124,465000,351000,0,9,34,81,4,120,43,81
8002,E02000951,2011,127,401000,291000,2,5,24,96,0,127,27,100
8003,E02000951,2012,113,534000,390000,0,7,30,76,2,111,37,76
8004,E02000951,2013,121,558000,400000,2,8,26,85,1,120,33,88
8005,E02000951,2014,33,720000,512000,1,3,7,22,0,33,11,22
8006,E02000952,2009,66,461000,340000,1,1,19,45,4,62,21,45
8007,E02000952,2010,94,646000,436000,1,3,40,50,0,94,41,53
8008,E02000952,2011,81,532000,375000,1,9,22,49,0,81,30,51
8009,E02000952,2012,58,587000,405000,1,4,18,35,0,58,22,36
8010,E02000952,2013,112,630000,482000,1,1,36,74,1,111,35,77
8011,E02000952,2014,48,710000,480000,1,0,13,34,0,48,14,34
8012,E02000953,2009,138,332000,308000,0,2,55,81,29,109,54,84
8013,E02000953,2010,182,364000,342000,2,2,63,115,34,148,67,115
8014,E02000953,2011,170,387000,370000,0,8,71,91,4,166,74,96
8015,E02000953,2012,143,436000,430000,0,1,60,82,0,143,54,89
8016,E02000953,2013,176,502000,480000,1,5,71,99,3,173,71,105
8017,E02000953,2014,51,617000,552000,0,0,28,23,0,51,24,27
8018,E02000954,2009,68,343000,312000,0,5,42,21,0,68,46,22
8019,E02000954,2010,70,375000,355000,0,2,40,28,0,70,43,27
8020,E02000954,2011,90,373000,344000,0,1,60,29,0,90,56,34
8021,E02000954,2012,88,439000,416000,0,2,60,26,0,88,60,28
8022,E02000954,2013,87,494000,470000,0,2,47,38,1,86,47,40
8023,E02000954,2014,24,491000,458000,1,0,13,10,0,24,13,11
8024,E02000955,2009,50,284000,255000,0,3,41,6,0,50,47,3
8025,E02000955,2010,62,325000,310000,1,7,47,7,0,62,57,5
8026,E02000955,2011,73,319000,290000,0,3,47,23,0,73,51,22
8027,E02000955,2012,80,352000,348000,0,3,65,12,0,80,68,12
8028,E02000955,2013,129,353000,320000,1,3,66,59,42,87,69,60
8029,E02000955,2014,45,423000,425000,0,1,28,16,5,40,29,16
8030,E02000956,2009,54,244000,232000,0,2,19,33,1,53,20,34
8031,E02000956,2010,119,255000,250000,0,1,26,92,41,78,29,90
8032,E02000956,2011,102,294000,270000,0,1,43,58,23,79,42,60
8033,E02000956,2012,77,283000,278000,0,3,31,43,0,77,31,46
8034,E02000956,2013,76,326000,297000,0,3,30,43,0,76,31,45
8035,E02000956,2014,40,386000,370000,0,2,13,25,0,40,15,25
8036,E02000957,2009,111,260000,250000,0,1,42,68,0,111,44,67
8037,E02000957,2010,143,306000,270000,0,4,48,91,2,141,52,91
8038,E02000957,2011,148,282000,250000,0,1,53,94,0,148,47,101
8039,E02000957,2012,171,305000,295000,0,4,61,106,3,168,63,108
8040,E02000957,2013,177,365000,350000,2,3,52,120,0,177,51,126
8041,E02000957,2014,55,394000,380000,0,1,17,37,0,55,17,38
8042,E02000958,2009,62,315000,292000,0,9,31,22,0,62,43,19
8043,E02000958,2010,87,341000,306000,2,9,38,38,0,87,50,37
8044,E02000958,2011,81,364000,315000,1,11,39,30,0,81,49,32
8045,E02000958,2012,78,398000,348000,1,12,35,30,0,78,46,32
8046,E02000958,2013,94,435000,365000,4,10,35,45,1,93,49,45
8047,E02000958,2014,28,506000,448000,1,5,10,12,0,28,16,12
8048,E02000959,2009,68,230000,218000,0,0,29,39,2,66,27,41
8049,E02000959,2010,65,253000,230000,0,4,24,37,3,62,25,40
8050,E02000959,2011,77,253000,232000,0,4,30,43,1,76,32,45
8051,E02000959,2012,107,271000,249000,0,3,39,65,6,101,42,65
8052,E02000959,2013,118,304000,270000,0,6,36,76,2,116,40,78
8053,E02000959,2014,46,354000,295000,1,2,21,22,0,46,20,26
8054,E02000960,2009,88,988000,782000,0,4,15,69,1,87,16,72
8055,E02000960,2010,109,1137000,560000,1,4,12,92,0,109,16,93
8056,E02000960,2011,97,1222000,700000,1,2,10,84,0,97,14,83
8057,E02000960,2012,85,1261000,750000,1,1,12,71,0,85,14,71
8058,E02000960,2013,112,1831000,1005000,1,7,13,91,10,102,21,91
8059,E02000960,2014,44,1914000,1222000,0,2,2,40,3,41,4,40
8060,E02000961,2009,115,843000,430000,3,9,13,90,7,108,24,91
8061,E02000961,2010,147,966000,500000,3,13,17,114,12,135,32,115
8062,E02000961,2011,142,1271000,638000,9,11,14,108,9,133,33,109
8063,E02000961,2012,129,1208000,485000,5,5,14,105,7,122,24,105
8064,E02000961,2013,157,1584000,795000,11,11,28,107,4,153,50,107
8065,E02000961,2014,61,870000,575000,1,2,5,53,5,56,8,53
8066,E02000962,2009,146,605000,479000,0,0,0,146,1,145,0,146
8067,E02000962,2010,132,693000,472000,1,2,1,128,4,128,4,128
8068,E02000962,2011,128,786000,462000,2,2,2,122,2,126,6,122
8069,E02000962,2012,104,787000,500000,0,1,4,99,0,104,5,99
8070,E02000962,2013,156,1045000,618000,2,4,4,146,0,156,11,145
8071,E02000962,2014,49,938000,685000,0,0,0,49,2,47,0,49
8072,E02000963,2009,58,353000,372000,0,1,30,27,1,57,35,23
8073,E02000963,2010,88,390000,400000,0,1,52,35,0,88,55,33
8074,E02000963,2011,66,420000,429000,0,3,26,37,1,65,31,35
8075,E02000963,2012,81,454000,442000,0,0,46,35,0,81,46,35
8076,E02000963,2013,91,501000,509000,0,0,45,46,2,89,45,46
8077,E02000963,2014,38,621000,580000,0,0,17,21,6,32,17,21
8078,E02000964,2009,77,346000,310000,0,2,15,60,0,77,17,60
8079,E02000964,2010,108,360000,320000,0,0,9,99,1,107,10,98
8080,E02000964,2011,140,368000,340000,0,1,7,132,3,137,6,134
8081,E02000964,2012,151,350000,318000,0,0,11,140,8,143,7,144
8082,E02000964,2013,151,446000,410000,0,1,17,133,4,147,15,136
8083,E02000964,2014,61,529000,490000,2,0,9,50,1,60,8,53
8084,E02000965,2009,144,511000,460000,0,1,5,138,0,144,7,137
8085,E02000965,2010,178,563000,491000,0,3,7,168,0,178,10,168
8086,E02000965,2011,145,547000,520000,1,0,5,139,2,143,5,140
8087,E02000965,2012,173,603000,520000,0,2,6,165,0,173,5,168
8088,E02000965,2013,180,687000,621000,0,4,6,170,1,179,8,172
8089,E02000965,2014,49,738000,675000,0,0,1,48,0,49,0,49
8090,E02000966,2009,147,666000,530000,0,3,10,134,0,147,15,132
8091,E02000966,2010,206,848000,680000,0,3,18,185,1,205,21,185
8092,E02000966,2011,219,847000,650000,1,1,22,195,0,219,24,195
8093,E02000966,2012,173,1016000,735000,1,5,16,151,1,172,20,153
8094,E02000966,2013,191,1205000,785000,1,4,14,172,1,190,16,175
8095,E02000966,2014,45,1107000,880000,0,1,2,42,0,45,3,42
8096,E02000967,2009,127,693000,625000,0,2,7,118,0,127,3,124
8097,E02000967,2010,179,781000,690000,0,0,15,164,10,169,13,166
8098,E02000967,2011,135,827000,650000,0,0,5,130,10,125,4,131
8099,E02000967,2012,139,1035000,755000,0,0,11,128,6,133,7,132
8100,E02000967,2013,118,1142000,818000,0,0,10,108,0,118,10,108
8101,E02000967,2014,49,1087000,850000,0,0,2,47,0,49,2,47
8102,E02000968,2009,72,318000,266000,0,0,3,69,0,72,3,69
8103,E02000968,2010,61,377000,305000,0,1,0,60,0,61,1,60
8104,E02000968,2011,56,416000,356000,0,0,4,52,0,56,4,52
8105,E02000968,2012,77,434000,370000,0,0,1,76,9,68,1,76
8106,E02000968,2013,84,500000,387000,0,1,7,76,1,83,9,75
8107,E02000968,2014,29,499000,440000,0,0,1,28,0,29,1,28
8108,E02000969,2009,55,316000,283000,0,0,1,54,0,55,0,55
8109,E02000969,2010,69,399000,340000,0,1,0,68,0,69,1,68
8110,E02000969,2011,60,424000,382000,0,0,2,58,0,60,0,60
8111,E02000969,2012,51,397000,360000,0,0,0,51,0,51,0,51
8112,E02000969,2013,87,426000,365000,0,1,0,86,1,86,1,86
8113,E02000969,2014,26,433000,390000,0,0,1,25,1,25,1,25
8114,E02000970,2009,154,1066000,710000,0,0,11,143,2,152,5,149
8115,E02000970,2010,160,1171000,858000,1,0,13,146,0,160,8,152
8116,E02000970,2011,161,1358000,745000,0,1,7,153,3,158,6,155
8117,E02000970,2012,136,1697000,963000,0,0,8,128,4,132,8,128
8118,E02000970,2013,184,2032000,1275000,0,0,12,172,3,181,10,174
8119,E02000970,2014,41,2019000,1275000,0,0,6,35,1,40,4,37
8120,E02000971,2009,143,658000,500000,0,0,7,136,0,143,10,133
8121,E02000971,2010,140,823000,665000,0,1,13,126,1,139,16,124
8122,E02000971,2011,144,867000,725000,1,0,13,130,0,144,14,130
8123,E02000971,2012,191,916000,635000,0,0,10,181,1,190,11,180
8124,E02000971,2013,176,1160000,812000,0,0,18,158,1,175,18,158
8125,E02000971,2014,62,1378000,1138000,0,0,3,59,7,55,3,59
8126,E02000972,2009,100,617000,456000,0,0,1,99,4,96,1,99
8127,E02000972,2010,160,770000,645000,0,0,2,158,19,141,3,157
8128,E02000972,2011,122,1054000,670000,1,0,1,120,6,116,4,118
8129,E02000972,2012,119,1182000,710000,0,0,3,116,12,107,3,116
8130,E02000972,2013,155,1442000,1091000,0,0,5,150,27,128,6,149
8131,E02000972,2014,42,1067000,760000,0,0,1,41,1,41,1,41
8132,E02000973,2009,178,716000,480000,0,3,22,153,1,177,26,152
8133,E02000973,2010,214,880000,540000,0,4,27,183,1,213,29,185
8134,E02000973,2011,205,979000,600000,2,3,31,169,2,203,32,173
8135,E02000973,2012,176,1034000,606000,1,6,27,142,0,176,30,146
8136,E02000973,2013,181,1139000,675000,0,2,23,156,2,179,21,160
8137,E02000973,2014,71,1253000,820000,0,2,10,59,0,71,10,61
8138,E02000974,2009,195,759000,585000,0,1,17,177,0,195,15,180
8139,E02000974,2010,234,826000,678000,0,0,20,214,62,172,15,219
8140,E02000974,2011,184,891000,630000,0,0,15,169,1,183,7,177
8141,E02000974,2012,183,892000,580000,0,0,23,160,1,182,16,167
8142,E02000974,2013,220,1064000,700000,1,0,24,195,14,206,20,200
8143,E02000974,2014,75,978000,620000,0,0,5,70,0,75,4,71
8144,E02000975,2009,141,657000,520000,0,0,6,135,1,140,7,134
8145,E02000975,2010,165,694000,571000,0,0,11,154,0,165,10,155
8146,E02000975,2011,156,955000,718000,0,0,13,143,10,146,14,142
8147,E02000975,2012,134,1205000,736000,0,0,9,125,8,126,9,125
8148,E02000975,2013,148,1209000,690000,0,0,10,138,1,147,11,137
8149,E02000975,2014,61,1310000,820000,0,0,5,56,1,60,4,57
8150,E02000976,2009,120,562000,450000,0,0,4,116,0,120,4,116
8151,E02000976,2010,180,675000,545000,0,1,8,171,8,172,10,170
8152,E02000976,2011,158,699000,553000,1,1,6,150,0,158,9,149
8153,E02000976,2012,139,1020000,610000,1,0,8,130,1,138,7,132
8154,E02000976,2013,154,970000,691000,0,1,12,141,0,154,10,144
8155,E02000976,2014,39,1156000,780000,0,1,2,36,0,39,3,36
8156,E02000977,2009,107,950000,625000,0,1,1,105,2,105,2,105
8157,E02000977,2010,122,1104000,760000,0,1,5,116,0,122,6,116
8158,E02000977,2011,124,1233000,750000,0,0,5,119,0,124,5,119
8159,E02000977,2012,117,1610000,887000,0,0,6,111,19,98,6,111
8160,E02000977,2013,191,1766000,1140000,0,0,2,189,64,127,2,189
8161,E02000977,2014,37,2123000,1425000,0,0,4,33,3,34,4,33
8162,E02000978,2009,148,2002000,1533000,0,2,50,96,2,146,45,103
8163,E02000978,2010,164,1995000,1425000,0,1,39,124,7,157,35,129
8164,E02000978,2011,149,2455000,1750000,2,1,40,106,1,148,33,116
8165,E02000978,2012,157,4537000,2910000,0,0,53,104,10,147,46,111
8166,E02000978,2013,181,4718000,3450000,0,1,62,118,6,175,56,125
8167,E02000978,2014,58,4006000,3350000,0,0,29,29,0,58,25,33
8168,E02000979,2009,112,641000,505000,0,0,2,110,11,101,2,110
8169,E02000979,2010,157,721000,650000,0,0,2,155,24,133,2,155
8170,E02000979,2011,140,950000,722000,2,1,11,126,12,128,15,125
8171,E02000979,2012,166,1118000,878000,0,0,6,160,45,121,6,160
8172,E02000979,2013,121,1064000,793000,0,2,4,115,0,121,5,116
8173,E02000979,2014,43,1068000,955000,0,0,2,41,0,43,2,41
8174,E02000980,2009,119,529000,435000,0,1,5,113,1,118,6,113
8175,E02000980,2010,158,547000,493000,0,0,0,158,2,156,0,158
8176,E02000980,2011,141,636000,555000,0,0,6,135,0,141,6,135
8177,E02000980,2012,121,691000,556000,0,0,4,117,0,121,4,117
8178,E02000980,2013,143,791000,630000,0,0,9,134,0,143,9,134
8179,E02000980,2014,41,875000,747000,0,0,2,39,0,41,2,39
8180,E02000981,2009,142,638000,482000,0,2,18,122,0,142,22,120
8181,E02000981,2010,176,617000,480000,0,0,17,159,0,176,13,163
8182,E02000981,2011,170,816000,550000,2,0,28,140,0,170,29,141
8183,E02000981,2012,162,818000,592000,0,0,24,138,3,159,20,142
8184,E02000981,2013,186,869000,632000,0,0,24,162,4,182,24,162
8185,E02000981,2014,49,1179000,877000,0,0,8,41,0,49,9,40
8186,E02000982,2009,102,701000,540000,1,1,16,84,28,74,15,87
8187,E02000982,2010,137,754000,655000,0,0,15,122,59,78,12,125
8188,E02000982,2011,139,831000,654000,0,0,18,121,26,113,16,123
8189,E02000982,2012,121,1070000,680000,0,0,12,109,43,78,12,109
8190,E02000982,2013,153,1203000,935000,0,1,18,134,3,150,17,136
8191,E02000982,2014,36,1272000,1012000,0,0,4,32,0,36,3,33
8192,E02000983,2009,65,563000,430000,0,0,6,59,0,65,6,59
8193,E02000983,2010,119,638000,565000,0,0,6,113,24,95,4,115
8194,E02000983,2011,76,701000,499000,0,0,11,65,0,76,12,64
8195,E02000983,2012,85,700000,535000,0,0,9,76,0,85,8,77
8196,E02000983,2013,100,624000,485000,0,0,4,96,0,100,2,98
8197,E02000983,2014,37,818000,579000,0,0,3,34,1,36,2,35
8198,E02003258,2009,112,190000,175000,38,35,34,5,0,112,109,3
8199,E02003258,2010,116,207000,200000,50,24,26,16,0,116,100,16
8200,E02003258,2011,129,190000,180000,47,38,34,10,0,129,117,12
8201,E02003258,2012,114,205000,199000,49,27,28,10,7,107,100,14
8202,E02003258,2013,140,203000,200000,65,32,36,7,0,140,131,9
8203,E02003258,2014,46,213000,224000,19,10,15,2,0,46,42,4
8204,E02003259,2009,49,149000,152000,2,36,8,3,0,49,46,3
8205,E02003259,2010,57,153000,150000,0,43,8,6,0,57,52,5
8206,E02003259,2011,52,147000,144000,1,41,10,0,0,52,52,0
8207,E02003259,2012,57,141000,135000,0,41,9,7,0,57,50,7
8208,E02003259,2013,86,155000,157000,1,71,8,6,0,86,79,7
8209,E02003259,2014,36,157000,165000,1,26,4,5,0,36,31,5
8210,E02003260,2009,35,110000,112000,1,10,16,8,0,35,27,8
8211,E02003260,2010,45,116000,124000,0,14,20,11,0,45,34,11
8212,E02003260,2011,48,114000,120000,0,10,28,10,0,48,38,10
8213,E02003260,2012,68,114000,118000,0,10,44,14,0,68,54,14
8214,E02003260,2013,53,121000,125000,2,12,34,5,0,53,46,7
8215,E02003260,2014,19,118000,128000,0,0,13,6,0,19,13,6
8216,E02003261,2009,71,181000,170000,21,42,6,2,0,71,68,3
8217,E02003261,2010,65,194000,170000,17,38,6,4,0,65,61,4
8218,E02003261,2011,70,199000,170000,26,26,15,3,0,70,66,4
8219,E02003261,2012,52,197000,164000,16,25,8,3,0,52,49,3
8220,E02003261,2013,87,213000,186000,27,45,11,4,0,87,83,4
8221,E02003261,2014,17,208000,203000,4,10,2,1,0,17,16,1
8222,E02003262,2009,70,145000,145000,7,43,13,7,0,70,63,7
8223,E02003262,2010,58,156000,146000,8,26,20,4,0,58,54,4
8224,E02003262,2011,74,151000,149000,17,41,10,6,0,74,69,5
8225,E02003262,2012,70,143000,144000,6,41,17,6,1,69,63,7
8226,E02003262,2013,78,142000,140000,13,35,20,10,0,78,68,10
8227,E02003262,2014,42,159000,152000,4,17,13,8,0,42,33,9
8228,E02003263,2009,96,144000,150000,4,53,27,12,0,96,83,13
8229,E02003263,2010,117,152000,152000,8,61,37,11,0,117,103,14
8230,E02003263,2011,94,152000,150000,7,40,39,8,0,94,86,8
8231,E02003263,2012,90,148000,151000,7,35,33,15,1,89,76,14
8232,E02003263,2013,124,163000,162000,13,59,39,13,0,124,112,12
8233,E02003263,2014,54,157000,155000,4,21,24,5,10,44,49,5
8234,E02003264,2009,115,208000,205000,29,58,26,2,0,115,113,2
8235,E02003264,2010,134,220000,215000,37,63,32,2,0,134,132,2
8236,E02003264,2011,114,227000,220000,35,45,28,6,0,114,108,6
8237,E02003264,2012,127,237000,228000,34,57,33,3,0,127,124,3
8238,E02003264,2013,124,238000,225000,42,52,25,5,1,123,119,5
8239,E02003264,2014,58,243000,230000,12,32,12,2,0,58,56,2
8240,E02003265,2009,90,149000,145000,5,42,32,11,0,90,79,11
8241,E02003265,2010,90,161000,151000,10,36,28,16,0,90,71,19
8242,E02003265,2011,113,165000,155000,13,47,32,21,8,105,92,21
8243,E02003265,2012,101,171000,164000,8,46,32,15,7,94,86,15
8244,E02003265,2013,120,170000,161000,10,44,57,9,0,120,111,9
8245,E02003265,2014,47,175000,166000,4,18,17,8,0,47,39,8
8246,E02003266,2009,58,129000,130000,2,34,21,1,0,58,55,3
8247,E02003266,2010,59,138000,138000,3,29,23,4,0,59,54,5
8248,E02003266,2011,64,132000,129000,4,28,30,2,0,64,62,2
8249,E02003266,2012,59,133000,130000,2,25,29,3,0,59,56,3
8250,E02003266,2013,73,142000,140000,4,33,33,3,0,73,70,3
8251,E02003266,2014,37,145000,142000,3,14,16,4,0,37,34,3
8252,E02003267,2009,62,161000,166000,7,32,18,5,0,62,58,4
8253,E02003267,2010,81,171000,170000,6,38,33,4,1,80,79,2
8254,E02003267,2011,82,173000,171000,4,46,26,6,8,74,75,7
8255,E02003267,2012,72,171000,166000,4,39,26,3,4,68,69,3
8256,E02003267,2013,88,170000,163000,9,36,35,8,3,85,80,8
8257,E02003267,2014,30,148000,140000,0,12,15,3,0,30,26,4
8258,E02003268,2009,72,145000,145000,7,34,24,7,0,72,63,9
8259,E02003268,2010,88,153000,150000,4,42,37,5,0,88,82,6
8260,E02003268,2011,81,154000,150000,3,28,42,8,18,63,73,8
8261,E02003268,2012,82,149000,148000,7,28,37,10,4,78,72,10
8262,E02003268,2013,110,171000,165000,18,49,38,5,11,99,103,7
8263,E02003268,2014,45,172000,167000,6,19,19,1,2,43,44,1
8264,E02003269,2009,101,159000,158000,12,63,18,8,0,101,93,8
8265,E02003269,2010,106,174000,164000,17,65,12,12,0,106,92,14
8266,E02003269,2011,106,173000,165000,20,53,23,10,1,105,93,13
8267,E02003269,2012,104,179000,168000,17,58,22,7,0,104,96,8
8268,E02003269,2013,152,177000,173000,27,75,26,24,11,141,128,24
8269,E02003269,2014,67,172000,174000,4,33,18,12,8,59,54,13
8270,E02003270,2009,85,138000,140000,6,59,16,4,0,85,81,4
8271,E02003270,2010,77,153000,157000,5,55,12,5,0,77,72,5
8272,E02003270,2011,82,153000,154000,10,59,8,5,0,82,78,4
8273,E02003270,2012,85,162000,155000,7,64,11,3,0,85,82,3
8274,E02003270,2013,108,160000,160000,7,71,22,8,1,107,100,8
8275,E02003270,2014,35,164000,161000,4,20,10,1,0,35,34,1
8276,E02003271,2009,133,166000,156000,22,72,32,7,0,133,128,5
8277,E02003271,2010,118,168000,160000,20,60,31,7,0,118,109,9
8278,E02003271,2011,132,172000,158000,28,69,28,7,0,132,126,6
8279,E02003271,2012,119,160000,150000,21,48,36,14,3,116,105,14
8280,E02003271,2013,131,176000,165000,21,65,39,6,3,128,124,7
8281,E02003271,2014,66,183000,166000,10,30,22,4,2,64,62,4
8282,E02003272,2009,39,140000,145000,3,18,15,3,1,38,36,3
8283,E02003272,2010,51,145000,145000,2,25,21,3,0,51,48,3
8284,E02003272,2011,36,151000,148000,4,15,15,2,0,36,34,2
8285,E02003272,2012,35,142000,148000,2,15,16,2,0,35,33,2
8286,E02003272,2013,47,149000,140000,4,15,26,2,0,47,45,2
8287,E02003272,2014,26,163000,156000,3,14,9,0,0,26,26,0
8288,E02003273,2009,95,141000,141000,5,65,21,4,1,94,90,5
8289,E02003273,2010,104,156000,154000,9,69,22,4,0,104,100,4
8290,E02003273,2011,78,150000,150000,3,52,19,4,0,78,74,4
8291,E02003273,2012,153,154000,155000,4,79,62,8,55,98,91,62
8292,E02003273,2013,123,164000,164000,10,83,24,6,0,123,116,7
8293,E02003273,2014,49,165000,164000,6,23,17,3,0,49,46,3
8294,E02003274,2009,61,137000,115000,3,13,33,12,0,61,47,14
8295,E02003274,2010,50,134000,122000,2,13,26,9,0,50,40,10
8296,E02003274,2011,46,156000,122000,5,17,19,5,0,46,41,5
8297,E02003274,2012,41,141000,133000,0,12,23,6,0,41,35,6
8298,E02003274,2013,37,136000,125000,3,7,25,2,0,37,35,2
8299,E02003274,2014,26,132000,122000,1,7,13,5,0,26,21,5
8300,E02003275,2009,99,110000,105000,2,14,26,57,4,95,37,62
8301,E02003275,2010,128,119000,117000,2,14,38,74,19,109,53,75
8302,E02003275,2011,112,111000,111000,5,11,27,69,12,100,40,72
8303,E02003275,2012,103,113000,108000,1,6,31,65,2,101,38,65
8304,E02003275,2013,139,113000,118000,5,7,50,77,4,135,58,81
8305,E02003275,2014,47,133000,125000,1,4,21,21,0,47,25,22
8306,E02003276,2009,39,122000,123000,1,9,26,3,0,39,36,3
8307,E02003276,2010,49,126000,125000,3,10,32,4,0,49,45,4
8308,E02003276,2011,51,125000,126000,0,13,34,4,0,51,48,3
8309,E02003276,2012,44,123000,125000,1,7,33,3,0,44,41,3
8310,E02003276,2013,57,131000,131000,0,14,38,5,0,57,52,5
8311,E02003276,2014,22,131000,138000,0,4,17,1,0,22,21,1
8312,E02003277,2009,66,141000,140000,0,41,21,4,0,66,62,4
8313,E02003277,2010,81,136000,142000,1,38,30,12,0,81,70,11
8314,E02003277,2011,77,132000,132000,3,26,29,19,2,75,59,18
8315,E02003277,2012,74,138000,143000,1,33,27,13,2,72,61,13
8316,E02003277,2013,73,140000,147000,1,33,28,11,0,73,62,11
8317,E02003277,2014,39,143000,150000,0,16,17,6,0,39,33,6
8318,E02003278,2009,84,164000,126000,10,20,35,19,3,81,64,20
8319,E02003278,2010,113,145000,120000,10,18,47,38,13,100,77,36
8320,E02003278,2011,97,161000,135000,11,27,38,21,1,96,77,20
8321,E02003278,2012,102,162000,127000,12,19,41,30,1,101,72,30
8322,E02003278,2013,117,144000,125000,8,22,58,29,1,116,88,29
8323,E02003278,2014,50,156000,125000,4,9,19,18,0,50,32,18
8324,E02003279,2009,115,198000,178000,29,67,9,10,0,115,105,10
8325,E02003279,2010,116,200000,190000,29,66,16,5,0,116,110,6
8326,E02003279,2011,145,190000,185000,37,82,13,13,2,143,131,14
8327,E02003279,2012,116,201000,201000,36,58,12,10,9,107,106,10
8328,E02003279,2013,164,204000,200000,47,84,15,18,2,162,146,18
8329,E02003279,2014,62,216000,195000,19,34,4,5,1,61,57,5
8330,E02003280,2009,132,164000,168000,19,80,22,11,0,132,122,10
8331,E02003280,2010,125,178000,175000,20,65,26,14,0,125,111,14
8332,E02003280,2011,115,178000,175000,19,64,23,9,0,115,109,6
8333,E02003280,2012,119,179000,176000,23,66,23,7,0,119,111,8
8334,E02003280,2013,128,191000,185000,23,75,24,6,0,128,122,6
8335,E02003280,2014,49,214000,205000,11,30,8,0,0,49,49,0
8336,E02003281,2009,138,209000,186000,36,62,18,22,5,133,113,25
8337,E02003281,2010,135,225000,212000,32,71,18,14,0,135,118,17
8338,E02003281,2011,146,227000,220000,34,82,18,12,0,146,134,12
8339,E02003281,2012,141,239000,214000,37,71,17,16,1,140,124,17
8340,E02003281,2013,186,228000,225000,38,87,28,33,10,176,150,36
8341,E02003281,2014,63,226000,208000,12,27,14,10,0,63,51,12
8342,E02003282,2009,120,198000,180000,27,62,12,19,0,120,100,20
8343,E02003282,2010,110,192000,185000,21,47,15,27,0,110,82,28
8344,E02003282,2011,127,198000,185000,29,52,19,27,14,113,100,27
8345,E02003282,2012,129,199000,192000,22,63,18,26,1,128,102,27
8346,E02003282,2013,137,218000,210000,28,75,17,17,0,137,120,17
8347,E02003282,2014,66,220000,205000,10,36,11,9,0,66,56,10
8348,E02003283,2009,113,189000,178000,25,42,30,16,0,113,98,15
8349,E02003283,2010,125,212000,205000,21,60,29,15,0,125,110,15
8350,E02003283,2011,158,211000,194000,42,56,40,20,0,158,139,19
8351,E02003283,2012,147,209000,197000,31,60,35,21,6,141,126,21
8352,E02003283,2013,166,211000,190000,33,50,42,41,17,149,126,40
8353,E02003283,2014,49,234000,225000,11,20,11,7,2,47,42,7
8354,E02003284,2009,133,151000,155000,8,62,48,15,2,131,117,16
8355,E02003284,2010,140,159000,160000,17,50,53,20,0,140,117,23
8356,E02003284,2011,136,149000,157000,10,48,53,25,0,136,107,29
8357,E02003284,2012,144,158000,162000,14,44,58,28,2,142,115,29
8358,E02003284,2013,181,161000,165000,13,62,67,39,0,181,140,41
8359,E02003284,2014,64,172000,175000,3,30,22,9,0,64,55,9
8360,E02003285,2009,129,146000,140000,8,18,67,36,1,128,90,39
8361,E02003285,2010,165,146000,143000,4,19,65,77,0,165,86,79
8362,E02003285,2011,162,139000,138000,5,22,70,65,0,162,90,72
8363,E02003285,2012,166,148000,150000,4,24,78,60,1,165,102,64
8364,E02003285,2013,187,155000,152000,14,13,82,78,1,186,103,84
8365,E02003285,2014,65,165000,170000,3,8,29,25,0,65,38,27
8366,E02003286,2009,166,261000,249000,48,76,11,31,0,166,133,33
8367,E02003286,2010,150,307000,295000,36,71,8,35,4,146,112,38
8368,E02003286,2011,151,314000,300000,34,73,15,29,2,149,118,33
8369,E02003286,2012,168,324000,322000,41,84,6,37,1,167,131,37
8370,E02003286,2013,183,333000,335000,46,84,13,40,1,182,142,41
8371,E02003286,2014,52,302000,285000,12,20,5,15,0,52,36,16
8372,E02003287,2009,145,210000,195000,43,34,31,37,41,104,107,38
8373,E02003287,2010,131,272000,250000,56,28,38,9,22,109,121,10
8374,E02003287,2011,131,255000,225000,45,36,40,10,17,114,121,10
8375,E02003287,2012,108,262000,244000,45,27,25,11,2,106,97,11
8376,E02003287,2013,147,262000,231000,54,42,29,22,0,147,125,22
8377,E02003287,2014,51,264000,248000,20,11,8,12,0,51,39,12
8378,E02003288,2009,156,129000,120000,4,22,47,83,25,131,68,88
8379,E02003288,2010,136,136000,136000,7,23,47,59,9,127,74,62
8380,E02003288,2011,109,135000,135000,6,30,36,37,0,109,72,37
8381,E02003288,2012,89,135000,138000,2,17,30,40,0,89,48,41
8382,E02003288,2013,120,136000,136000,4,11,54,51,0,120,68,52
8383,E02003288,2014,52,142000,144000,2,9,17,24,0,52,28,24
8384,E02003289,2009,179,201000,175000,15,34,44,86,1,178,85,94
8385,E02003289,2010,215,230000,220000,17,57,56,85,0,215,119,96
8386,E02003289,2011,195,244000,232000,18,37,61,79,7,188,107,88
8387,E02003289,2012,195,245000,242000,19,46,44,86,1,194,104,91
8388,E02003289,2013,242,252000,245000,24,42,67,109,1,241,121,121
8389,E02003289,2014,91,269000,270000,9,25,21,36,0,91,54,37
8390,E02003290,2009,141,256000,220000,38,27,10,66,1,140,72,69
8391,E02003290,2010,164,262000,179000,36,27,15,86,0,164,74,90
8392,E02003290,2011,186,240000,183000,33,25,12,116,21,165,68,118
8393,E02003290,2012,164,235000,171000,25,25,10,104,15,149,57,107
8394,E02003290,2013,223,228000,164000,31,31,8,153,18,205,65,158
8395,E02003290,2014,72,293000,247000,14,14,4,40,1,71,31,41
8396,E02003291,2009,167,180000,155000,24,40,61,42,34,133,120,47
8397,E02003291,2010,122,186000,163000,12,28,53,29,20,102,91,31
8398,E02003291,2011,180,189000,179000,22,41,74,43,60,120,134,46
8399,E02003291,2012,193,218000,175000,37,42,73,41,41,152,148,45
8400,E02003291,2013,168,209000,171000,26,42,62,38,18,150,124,44
8401,E02003291,2014,56,191000,172000,4,13,31,8,4,52,45,11
8402,E02003292,2009,110,142000,132000,3,26,35,46,2,108,60,50
8403,E02003292,2010,129,133000,122000,0,15,40,74,0,129,52,77
8404,E02003292,2011,125,142000,130000,3,23,42,57,0,125,60,65
8405,E02003292,2012,137,141000,125000,9,21,43,64,0,137,71,66
8406,E02003292,2013,134,143000,130000,3,17,41,73,2,132,60,74
8407,E02003292,2014,50,137000,125000,1,5,16,28,1,49,20,30
8408,E02003293,2009,165,166000,149000,5,22,39,99,4,161,61,104
8409,E02003293,2010,166,173000,147000,6,23,36,101,0,166,56,110
8410,E02003293,2011,174,171000,141000,7,15,34,118,2,172,50,124
8411,E02003293,2012,164,164000,134000,3,22,32,107,3,161,50,114
8412,E02003293,2013,197,186000,150000,8,20,38,131,4,193,59,138
8413,E02003293,2014,68,197000,162000,0,9,13,46,1,67,19,49
8414,E02003294,2009,150,243000,225000,43,55,10,42,2,148,95,55
8415,E02003294,2010,158,306000,250000,48,47,17,46,0,158,101,57
8416,E02003294,2011,163,290000,240000,51,43,19,50,0,163,96,67
8417,E02003294,2012,142,290000,250000,32,55,17,38,0,142,96,46
8418,E02003294,2013,174,269000,240000,41,54,24,55,0,174,104,70
8419,E02003294,2014,62,305000,268000,22,14,6,20,0,62,39,23
8420,E02003295,2009,106,211000,191000,33,48,17,8,0,106,93,13
8421,E02003295,2010,105,239000,200000,37,36,19,13,0,105,85,20
8422,E02003295,2011,122,215000,195000,32,51,17,22,0,122,91,31
8423,E02003295,2012,114,245000,234000,43,48,12,11,1,113,96,18
8424,E02003295,2013,127,242000,218000,39,52,20,16,0,127,103,24
8425,E02003295,2014,45,232000,200000,14,19,7,5,0,45,36,9
8426,E02003296,2009,51,218000,195000,16,23,12,0,0,51,51,0
8427,E02003296,2010,60,225000,205000,13,34,12,1,0,60,59,1
8428,E02003296,2011,59,205000,182000,9,27,21,2,0,59,56,3
8429,E02003296,2012,78,222000,204000,8,49,17,4,0,78,74,4
8430,E02003296,2013,105,221000,206000,15,50,38,2,0,105,103,2
8431,E02003296,2014,39,250000,220000,7,18,13,1,0,39,38,1
8432,E02003297,2009,59,171000,168000,2,26,20,11,0,59,49,10
8433,E02003297,2010,54,181000,171000,4,21,24,5,0,54,49,5
8434,E02003297,2011,69,179000,170000,5,26,31,7,0,69,62,7
8435,E02003297,2012,57,178000,167000,4,20,23,10,0,57,47,10
8436,E02003297,2013,75,196000,175000,8,32,25,10,2,73,65,10
8437,E02003297,2014,33,209000,180000,3,13,10,7,1,32,26,7
8438,E02003298,2009,56,168000,163000,3,29,23,1,0,56,55,1
8439,E02003298,2010,70,181000,174000,8,32,23,7,4,66,63,7
8440,E02003298,2011,61,173000,175000,3,27,23,8,8,53,53,8
8441,E02003298,2012,67,182000,170000,5,26,35,1,0,67,66,1
8442,E02003298,2013,75,199000,187000,6,46,20,3,0,75,72,3
8443,E02003298,2014,40,201000,195000,2,25,12,1,0,40,39,1
8444,E02003299,2009,66,293000,242000,21,22,15,8,9,57,58,8
8445,E02003299,2010,50,266000,237000,18,11,14,7,0,50,43,7
8446,E02003299,2011,70,290000,250000,31,23,14,2,0,70,68,2
8447,E02003299,2012,59,288000,250000,18,19,19,3,1,58,56,3
8448,E02003299,2013,74,346000,282000,33,24,17,0,3,71,74,0
8449,E02003299,2014,31,360000,320000,16,4,8,3,2,29,28,3
8450,E02003300,2009,64,163000,155000,5,27,19,13,0,64,51,13
8451,E02003300,2010,101,181000,175000,15,35,35,16,0,101,84,17
8452,E02003300,2011,87,190000,175000,17,32,29,9,10,77,76,11
8453,E02003300,2012,78,179000,175000,11,27,28,12,0,78,66,12
8454,E02003300,2013,133,194000,180000,16,53,44,20,0,133,111,22
8455,E02003300,2014,42,193000,184000,5,13,17,7,0,42,35,7
8456,E02003301,2009,86,168000,164000,13,24,36,13,0,86,74,12
8457,E02003301,2010,85,175000,166000,12,15,47,11,2,83,74,11
8458,E02003301,2011,116,168000,156000,12,28,56,20,20,96,96,20
8459,E02003301,2012,132,174000,150000,15,18,64,35,28,104,98,34
8460,E02003301,2013,167,196000,200000,33,47,60,27,59,108,140,27
8461,E02003301,2014,38,199000,180000,9,10,15,4,5,33,34,4
8462,E02003302,2009,67,140000,140000,2,16,39,10,0,67,56,11
8463,E02003302,2010,80,151000,156000,1,22,40,17,0,80,63,17
8464,E02003302,2011,90,150000,154000,1,18,56,15,0,90,73,17
8465,E02003302,2012,79,152000,155000,3,17,44,15,0,79,64,15
8466,E02003302,2013,92,158000,164000,2,18,55,17,0,92,75,17
8467,E02003302,2014,51,166000,173000,2,9,30,10,1,50,41,10
8468,E02003303,2009,55,166000,156000,5,15,29,6,0,55,49,6
8469,E02003303,2010,79,179000,170000,6,31,31,11,0,79,66,13
8470,E02003303,2011,77,172000,168000,5,38,29,5,0,77,70,7
8471,E02003303,2012,62,168000,170000,1,22,35,4,0,62,58,4
8472,E02003303,2013,93,171000,168000,4,29,48,12,1,92,81,12
8473,E02003303,2014,42,169000,177000,1,12,20,9,1,41,31,11
8474,E02003304,2009,70,186000,174000,6,29,25,10,1,69,60,10
8475,E02003304,2010,66,201000,195000,6,33,21,6,0,66,60,6
8476,E02003304,2011,78,210000,190000,11,42,22,3,0,78,75,3
8477,E02003304,2012,90,202000,186000,10,40,34,6,0,90,84,6
8478,E02003304,2013,100,219000,215000,9,68,18,5,1,99,95,5
8479,E02003304,2014,52,217000,218000,4,23,20,5,4,48,47,5
8480,E02003305,2009,65,216000,210000,11,41,12,1,0,65,64,1
8481,E02003305,2010,69,239000,233000,16,41,9,3,3,66,66,3
8482,E02003305,2011,73,235000,228000,12,48,13,0,0,73,73,0
8483,E02003305,2012,62,233000,228000,14,42,6,0,0,62,62,0
8484,E02003305,2013,124,236000,235000,19,76,29,0,34,90,124,0
8485,E02003305,2014,29,242000,242000,5,18,5,1,8,21,28,1
8486,E02003307,2009,59,157000,152000,5,23,29,2,0,59,57,2
8487,E02003307,2010,69,170000,163000,2,26,40,1,0,69,68,1
8488,E02003307,2011,63,166000,162000,4,19,37,3,0,63,61,2
8489,E02003307,2012,56,175000,170000,5,21,30,0,0,56,56,0
8490,E02003307,2013,87,180000,175000,4,27,55,1,0,87,86,1
8491,E02003307,2014,27,204000,180000,2,11,13,1,0,27,26,1
8492,E02003308,2009,52,148000,156000,1,20,19,12,1,51,39,13
8493,E02003308,2010,74,171000,172000,6,32,16,20,0,74,54,20
8494,E02003308,2011,56,152000,164000,2,26,12,16,0,56,40,16
8495,E02003308,2012,67,161000,158000,7,31,17,12,0,67,53,14
8496,E02003308,2013,55,165000,158000,1,13,28,13,0,55,42,13
8497,E02003308,2014,29,177000,182000,3,8,10,8,0,29,21,8
8498,E02003309,2009,83,172000,168000,7,27,35,14,0,83,68,15
8499,E02003309,2010,102,187000,178000,14,40,28,20,0,102,81,21
8500,E02003309,2011,84,181000,175000,8,28,35,13,0,84,70,14
8501,E02003309,2012,87,194000,175000,10,32,31,14,0,87,73,14
8502,E02003309,2013,85,191000,178000,3,32,39,11,0,85,74,11
8503,E02003309,2014,48,212000,204000,8,16,18,6,0,48,42,6
8504,E02003310,2009,85,130000,128000,0,15,45,25,15,70,59,26
8505,E02003310,2010,167,148000,138000,11,8,81,67,72,95,99,68
8506,E02003310,2011,225,161000,144000,5,25,105,90,123,102,135,90
8507,E02003310,2012,256,154000,140000,7,14,111,124,148,108,132,124
8508,E02003310,2013,245,141000,135000,3,19,90,133,81,164,110,135
8509,E02003310,2014,68,149000,136000,4,8,25,31,1,67,35,33
8510,E02003311,2009,74,151000,142000,10,9,42,13,0,74,59,15
8511,E02003311,2010,86,172000,153000,11,14,45,16,0,86,72,14
8512,E02003311,2011,107,157000,140000,12,16,65,14,0,107,93,14
8513,E02003311,2012,101,161000,138000,8,15,58,20,0,101,81,20
8514,E02003311,2013,119,160000,146000,10,12,73,24,1,118,95,24
8515,E02003311,2014,41,165000,148000,4,3,25,9,0,41,32,9
8516,E02003312,2009,60,127000,125000,2,1,28,29,0,60,32,28
8517,E02003312,2010,89,123000,119000,1,4,28,56,0,89,33,56
8518,E02003312,2011,70,136000,128000,3,6,25,36,2,68,34,36
8519,E02003312,2012,110,144000,142000,2,4,42,62,31,79,52,58
8520,E02003312,2013,132,146000,144000,7,5,35,85,43,89,47,85
8521,E02003312,2014,45,122000,121000,1,0,14,30,0,45,15,30
8522,E02003313,2009,55,133000,130000,2,16,22,15,9,46,41,14
8523,E02003313,2010,77,124000,130000,1,16,44,16,13,64,60,17
8524,E02003313,2011,71,128000,126000,3,14,45,9,0,71,61,10
8525,E02003313,2012,75,131000,130000,2,16,50,7,0,75,68,7
8526,E02003313,2013,99,141000,141000,2,18,70,9,1,98,89,10
8527,E02003313,2014,60,147000,150000,2,13,40,5,0,60,55,5
8528,E02003314,2009,77,177000,160000,18,35,22,2,27,50,74,3
8529,E02003314,2010,52,185000,151000,7,23,18,4,2,50,47,5
8530,E02003314,2011,63,154000,142000,10,28,23,2,0,63,59,4
8531,E02003314,2012,60,157000,142000,9,19,27,5,2,58,55,5
8532,E02003314,2013,73,183000,155000,20,30,18,5,0,73,68,5
8533,E02003314,2014,23,174000,145000,5,7,10,1,0,23,22,1
8534,E02003315,2009,41,209000,187000,12,20,9,0,0,41,40,1
8535,E02003315,2010,83,242000,200000,35,28,20,0,10,73,83,0
8536,E02003315,2011,51,223000,180000,16,23,11,1,2,49,50,1
8537,E02003315,2012,62,220000,200000,21,21,20,0,2,60,61,1
8538,E02003315,2013,90,210000,196000,25,39,24,2,1,89,87,3
8539,E02003315,2014,25,228000,215000,8,8,7,2,0,25,23,2
8540,E02003316,2009,170,177000,165000,32,58,52,28,74,96,135,35
8541,E02003316,2010,160,213000,198000,44,58,49,9,64,96,150,10
8542,E02003316,2011,211,205000,188000,54,77,65,15,72,139,198,13
8543,E02003316,2012,206,204000,192000,54,87,54,11,57,149,193,13
8544,E02003316,2013,177,193000,185000,31,74,52,20,16,161,156,21
8545,E02003316,2014,62,219000,204000,15,25,20,2,6,56,60,2
8546,E02003317,2009,87,200000,181000,15,34,31,7,24,63,79,8
8547,E02003317,2010,80,217000,191000,20,34,20,6,26,54,75,5
8548,E02003317,2011,82,196000,182000,15,21,40,6,24,58,79,3
8549,E02003317,2012,98,199000,179000,19,32,31,16,46,52,84,14
8550,E02003317,2013,132,214000,200000,27,52,35,18,46,86,120,12
8551,E02003317,2014,36,232000,202000,8,16,9,3,7,29,34,2
8552,E02003318,2009,57,183000,175000,11,32,13,1,0,57,56,1
8553,E02003318,2010,67,203000,188000,19,30,18,0,0,67,67,0
8554,E02003318,2011,62,199000,190000,16,30,16,0,0,62,62,0
8555,E02003318,2012,66,221000,208000,20,33,13,0,1,65,66,0
8556,E02003318,2013,77,238000,220000,35,27,15,0,3,74,77,0
8557,E02003318,2014,27,254000,235000,10,9,8,0,0,27,27,0
8558,E02003319,2009,84,122000,119000,4,17,51,12,4,80,72,12
8559,E02003319,2010,96,133000,121000,4,16,66,10,1,95,84,12
8560,E02003319,2011,94,137000,120000,10,7,70,7,5,89,87,7
8561,E02003319,2012,103,127000,122000,6,8,85,4,3,100,99,4
8562,E02003319,2013,140,139000,126000,7,21,92,20,11,129,120,20
8563,E02003319,2014,73,133000,125000,4,1,35,33,29,44,40,33
8564,E02003320,2009,124,182000,169000,9,22,31,62,55,69,59,65
8565,E02003320,2010,118,182000,168000,20,13,29,56,42,76,57,61
8566,E02003320,2011,180,185000,176000,29,19,61,71,60,120,103,77
8567,E02003320,2012,96,222000,202000,14,11,36,35,21,75,58,38
8568,E02003320,2013,152,208000,176000,29,8,35,80,58,94,67,85
8569,E02003320,2014,53,176000,155000,7,4,16,26,11,42,26,27
8570,E02003321,2009,39,148000,140000,6,16,14,3,0,39,36,3
8571,E02003321,2010,46,158000,140000,4,22,13,7,0,46,39,7
8572,E02003321,2011,46,156000,138000,6,22,14,4,0,46,42,4
8573,E02003321,2012,63,152000,144000,7,28,21,7,0,63,55,8
8574,E02003321,2013,71,161000,152000,4,30,31,6,0,71,65,6
8575,E02003321,2014,22,185000,166000,3,7,9,3,0,22,19,3
8576,E02003322,2009,53,109000,112000,0,9,42,2,0,53,51,2
8577,E02003322,2010,79,118000,111000,0,4,69,6,2,77,73,6
8578,E02003322,2011,113,125000,123000,0,8,53,52,49,64,61,52
8579,E02003322,2012,91,127000,120000,0,7,63,21,21,70,70,21
8580,E02003322,2013,130,143000,132000,2,9,55,64,52,78,66,64
8581,E02003322,2014,50,142000,135000,0,4,28,18,15,35,32,18
8582,E02003323,2009,68,135000,120000,8,9,39,12,18,50,53,15
8583,E02003323,2010,72,155000,150000,7,11,48,6,21,51,66,6
8584,E02003323,2011,93,137000,125000,6,17,62,8,22,71,83,10
8585,E02003323,2012,77,151000,146000,8,15,48,6,20,57,71,6
8586,E02003323,2013,77,140000,134000,7,5,57,8,0,77,68,9
8587,E02003323,2014,45,150000,139000,4,8,25,8,0,45,35,10
8588,E02003324,2009,176,144000,139000,3,43,106,24,88,88,142,34
8589,E02003324,2010,141,146000,130000,2,24,69,46,76,65,94,47
8590,E02003324,2011,139,138000,130000,3,39,64,33,42,97,106,33
8591,E02003324,2012,92,132000,126000,0,26,51,15,9,83,76,16
8592,E02003324,2013,115,146000,140000,1,38,66,10,0,115,104,11
8593,E02003324,2014,44,156000,150000,0,13,28,3,0,44,40,4
8594,E02003325,2009,68,100000,95000,3,4,54,7,1,67,59,9
8595,E02003325,2010,72,110000,108000,1,9,53,9,1,71,64,8
8596,E02003325,2011,71,109000,105000,1,4,55,11,0,71,60,11
8597,E02003325,2012,76,109000,108000,2,4,62,8,0,76,69,7
8598,E02003325,2013,94,110000,110000,2,1,77,14,1,93,81,13
8599,E02003325,2014,25,123000,122000,0,1,20,4,0,25,21,4
8600,E02003326,2009,88,125000,120000,4,21,54,9,0,88,79,9
8601,E02003326,2010,53,145000,135000,1,14,36,2,0,53,51,2
8602,E02003326,2011,65,136000,130000,5,7,50,3,0,65,62,3
8603,E02003326,2012,78,146000,130000,8,10,58,2,0,78,76,2
8604,E02003326,2013,82,145000,138000,4,10,65,3,0,82,79,3
8605,E02003326,2014,39,144000,135000,2,5,29,3,0,39,37,2
8606,E02003327,2009,81,200000,169000,10,11,30,30,2,79,50,31
8607,E02003327,2010,87,245000,223000,10,19,33,25,0,87,60,27
8608,E02003327,2011,130,205000,174000,12,13,57,48,4,126,81,49
8609,E02003327,2012,107,194000,160000,4,10,42,51,15,92,56,51
8610,E02003327,2013,119,220000,185000,7,11,61,40,16,103,80,39
8611,E02003327,2014,63,233000,175000,9,6,13,35,9,54,28,35
8612,E02003328,2009,87,115000,112000,1,8,29,49,18,69,38,49
8613,E02003328,2010,79,119000,118000,2,10,39,28,7,72,50,29
8614,E02003328,2011,83,127000,111000,2,8,49,24,2,81,56,27
8615,E02003328,2012,97,149000,115000,2,11,43,41,25,72,61,36
8616,E02003328,2013,115,153000,122000,8,7,58,42,22,93,73,42
8617,E02003328,2014,38,131000,118000,1,2,21,14,0,38,26,12
8618,E02003329,2009,65,121000,116000,1,10,54,0,0,65,65,0
8619,E02003329,2010,74,122000,120000,1,14,57,2,1,73,72,2
8620,E02003329,2011,61,121000,120000,3,8,45,5,1,60,56,5
8621,E02003329,2012,57,120000,120000,0,5,51,1,0,57,56,1
8622,E02003329,2013,86,134000,130000,3,4,78,1,1,85,85,1
8623,E02003329,2014,48,135000,130000,0,2,45,1,0,48,47,1
8624,E02003330,2009,82,131000,125000,4,18,54,6,11,71,71,11
8625,E02003330,2010,90,152000,134000,2,25,60,3,3,87,88,2
8626,E02003330,2011,89,150000,132000,3,17,68,1,0,89,88,1
8627,E02003330,2012,86,150000,139000,2,19,64,1,0,86,85,1
8628,E02003330,2013,106,160000,148000,3,15,85,3,0,106,100,6
8629,E02003330,2014,41,157000,148000,0,9,29,3,1,40,38,3
8630,E02003331,2009,79,135000,136000,0,38,39,2,0,79,74,5
8631,E02003331,2010,69,148000,140000,5,21,40,3,0,69,66,3
8632,E02003331,2011,75,139000,136000,2,29,38,6,0,75,70,5
8633,E02003331,2012,71,144000,136000,3,28,39,1,0,71,70,1
8634,E02003331,2013,92,159000,147000,5,39,45,3,0,92,89,3
8635,E02003331,2014,30,157000,164000,1,12,17,0,0,30,30,0
8636,E02003332,2009,52,179000,174000,6,31,15,0,0,52,52,0
8637,E02003332,2010,48,199000,196000,11,16,20,1,1,47,46,2
8638,E02003332,2011,62,209000,205000,12,25,25,0,0,62,62,0
8639,E02003332,2012,58,189000,178000,10,24,23,1,0,58,55,3
8640,E02003332,2013,65,188000,195000,12,21,32,0,1,64,63,2
8641,E02003332,2014,22,185000,189000,2,8,12,0,0,22,22,0
8642,E02003333,2009,50,97000,93000,1,4,42,3,0,50,46,4
8643,E02003333,2010,64,97000,94000,2,3,49,10,0,64,53,11
8644,E02003333,2011,97,108000,105000,4,6,64,23,24,73,74,23
8645,E02003333,2012,83,126000,110000,12,7,52,12,11,72,70,13
8646,E02003333,2013,108,111000,106000,5,4,91,8,0,108,100,8
8647,E02003333,2014,32,121000,120000,3,2,23,4,0,32,28,4
8648,E02003334,2009,61,129000,125000,1,10,45,5,1,60,56,5
8649,E02003334,2010,61,144000,125000,4,6,42,9,7,54,53,8
8650,E02003334,2011,57,139000,126000,3,8,44,2,0,57,55,2
8651,E02003334,2012,64,146000,136000,3,8,50,3,2,62,61,3
8652,E02003334,2013,68,142000,140000,4,5,52,7,0,68,61,7
8653,E02003334,2014,24,147000,143000,2,0,19,3,0,24,21,3
8654,E02003335,2009,67,103000,103000,1,10,55,1,0,67,65,2
8655,E02003335,2010,60,110000,108000,0,6,54,0,1,59,60,0
8656,E02003335,2011,84,105000,100000,0,9,71,4,0,84,78,6
8657,E02003335,2012,83,108000,106000,0,18,64,1,0,83,82,1
8658,E02003335,2013,78,110000,106000,1,4,66,7,1,77,71,7
8659,E02003335,2014,34,126000,122000,0,5,28,1,0,34,33,1
8660,E02003336,2009,58,181000,176000,7,39,12,0,0,58,58,0
8661,E02003336,2010,63,198000,180000,6,41,15,1,0,63,62,1
8662,E02003336,2011,71,187000,175000,13,43,15,0,0,71,71,0
8663,E02003336,2012,100,219000,199000,25,51,23,1,31,69,99,1
8664,E02003336,2013,113,235000,210000,31,66,16,0,18,95,113,0
8665,E02003336,2014,24,212000,212000,2,14,8,0,0,24,24,0
8666,E02003337,2009,57,160000,150000,7,30,15,5,0,57,52,5
8667,E02003337,2010,48,166000,147000,5,23,19,1,0,48,47,1
8668,E02003337,2011,66,196000,154000,12,34,17,3,5,61,62,4
8669,E02003337,2012,87,208000,161000,17,31,31,8,13,74,80,7
8670,E02003337,2013,80,188000,160000,16,36,22,6,1,79,73,7
8671,E02003337,2014,36,182000,165000,2,14,19,1,0,36,35,1
8672,E02003338,2009,86,149000,141000,11,19,43,13,1,85,73,13
8673,E02003338,2010,86,148000,142000,6,21,46,13,0,86,72,14
8674,E02003338,2011,79,157000,140000,8,23,38,10,0,79,68,11
8675,E02003338,2012,104,155000,149000,9,27,54,14,4,100,90,14
8676,E02003338,2013,101,153000,150000,10,10,61,20,1,100,81,20
8677,E02003338,2014,38,166000,162000,3,10,19,6,0,38,32,6
8678,E02003339,2009,65,174000,164000,13,19,31,2,0,65,63,2
8679,E02003339,2010,64,187000,182000,11,21,31,1,0,64,63,1
8680,E02003339,2011,67,205000,195000,17,21,26,3,0,67,63,4
8681,E02003339,2012,60,200000,178000,17,15,26,2,0,60,58,2
8682,E02003339,2013,75,206000,185000,19,19,33,4,0,75,70,5
8683,E02003339,2014,32,207000,193000,5,9,13,5,0,32,27,5
8684,E02003340,2009,79,155000,132000,3,57,19,0,1,78,79,0
8685,E02003340,2010,61,145000,136000,1,34,25,1,1,60,57,4
8686,E02003340,2011,65,144000,135000,5,31,26,3,0,65,63,2
8687,E02003340,2012,70,154000,142000,2,42,24,2,0,70,68,2
8688,E02003340,2013,80,149000,140000,4,46,29,1,0,80,77,3
8689,E02003340,2014,30,163000,163000,1,18,11,0,0,30,30,0
8690,E02003341,2009,60,192000,177000,15,26,19,0,1,59,60,0
8691,E02003341,2010,68,220000,186000,20,25,22,1,3,65,64,4
8692,E02003341,2011,75,189000,175000,11,36,28,0,0,75,75,0
8693,E02003341,2012,76,204000,176000,16,24,33,3,6,70,73,3
8694,E02003341,2013,83,221000,208000,19,34,28,2,3,80,80,3
8695,E02003341,2014,39,212000,195000,9,14,13,3,5,34,35,4
8696,E02003342,2009,62,177000,170000,11,33,18,0,0,62,62,0
8697,E02003342,2010,73,203000,200000,15,34,22,2,3,70,72,1
8698,E02003342,2011,68,212000,196000,21,35,11,1,0,68,67,1
8699,E02003342,2012,91,207000,195000,23,50,17,1,2,89,90,1
8700,E02003342,2013,93,207000,194000,21,41,25,6,0,93,87,6
8701,E02003342,2014,32,211000,190000,10,12,8,2,0,32,30,2
8702,E02003343,2009,46,244000,232000,24,14,7,1,1,45,43,3
8703,E02003343,2010,78,243000,226000,31,30,13,4,0,78,72,6
8704,E02003343,2011,66,237000,231000,28,28,7,3,0,66,63,3
8705,E02003343,2012,84,240000,235000,39,34,5,6,6,78,76,8
8706,E02003343,2013,76,263000,245000,31,35,10,0,0,76,75,1
8707,E02003343,2014,35,274000,270000,20,12,2,1,0,35,33,2
8708,E02003344,2009,64,151000,135000,5,22,32,5,2,62,59,5
8709,E02003344,2010,45,176000,154000,11,12,21,1,0,45,44,1
8710,E02003344,2011,52,151000,132000,9,12,27,4,0,52,48,4
8711,E02003344,2012,62,162000,142000,16,8,31,7,0,62,54,8
8712,E02003344,2013,88,165000,149000,17,16,51,4,0,88,84,4
8713,E02003344,2014,27,173000,162000,8,5,12,2,0,27,25,2
8714,E02003345,2009,63,173000,154000,7,19,35,2,0,63,61,2
8715,E02003345,2010,64,176000,167000,7,15,38,4,0,64,59,5
8716,E02003345,2011,79,166000,158000,7,23,44,5,0,79,74,5
8717,E02003345,2012,72,182000,163000,14,18,39,1,0,72,71,1
8718,E02003345,2013,74,173000,160000,8,16,44,6,0,74,68,6
8719,E02003345,2014,30,187000,174000,3,5,19,3,0,30,27,3
8720,E02003346,2009,49,167000,152000,10,25,12,2,0,49,46,3
8721,E02003346,2010,61,194000,155000,18,24,16,3,0,61,58,3
8722,E02003346,2011,61,166000,145000,14,30,15,2,1,60,59,2
8723,E02003346,2012,83,178000,153000,14,41,27,1,7,76,81,2
8724,E02003346,2013,124,221000,191000,42,49,25,8,36,88,117,7
8725,E02003346,2014,30,214000,165000,8,12,10,0,1,29,30,0
8726,E02003347,2009,77,142000,140000,10,25,37,5,0,77,73,4
8727,E02003347,2010,71,154000,149000,10,20,40,1,0,71,70,1
8728,E02003347,2011,78,150000,136000,15,13,46,4,0,78,74,4
8729,E02003347,2012,105,149000,138000,15,22,62,6,0,105,99,6
8730,E02003347,2013,105,151000,140000,13,25,66,1,0,105,104,1
8731,E02003347,2014,47,154000,155000,4,12,29,2,0,47,43,4
8732,E02003348,2009,95,230000,213000,37,41,14,3,1,94,92,3
8733,E02003348,2010,101,269000,241000,49,30,18,4,7,94,96,5
8734,E02003348,2011,83,253000,230000,33,33,15,2,7,76,79,4
8735,E02003348,2012,105,250000,225000,46,40,15,4,1,104,98,7
8736,E02003348,2013,115,261000,240000,51,37,25,2,1,114,113,2
8737,E02003348,2014,46,247000,246000,16,17,12,1,0,46,45,1
8738,E02003349,2009,74,155000,145000,9,16,49,0,0,74,73,1
8739,E02003349,2010,86,164000,151000,8,21,48,9,1,85,74,12
8740,E02003349,2011,87,159000,154000,13,19,49,6,0,87,79,8
8741,E02003349,2012,94,163000,154000,14,14,58,8,0,94,86,8
8742,E02003349,2013,98,176000,165000,20,23,52,3,0,98,95,3
8743,E02003349,2014,41,173000,170000,5,11,21,4,0,41,37,4
8744,E02003350,2009,67,171000,164000,16,23,24,4,0,67,62,5
8745,E02003350,2010,70,184000,168000,15,27,22,6,0,70,64,6
8746,E02003350,2011,57,183000,174000,14,28,10,5,0,57,52,5
8747,E02003350,2012,72,189000,172000,22,26,15,9,0,72,64,8
8748,E02003350,2013,84,196000,201000,30,22,21,11,0,84,73,11
8749,E02003350,2014,28,185000,184000,3,9,13,3,0,28,26,2
8750,E02003351,2009,79,137000,135000,6,24,40,9,0,79,67,12
8751,E02003351,2010,76,158000,147000,7,27,34,8,0,76,67,9
8752,E02003351,2011,103,149000,140000,9,28,54,12,0,103,91,12
8753,E02003351,2012,104,153000,146000,14,29,46,15,0,104,88,16
8754,E02003351,2013,117,170000,155000,17,35,47,18,0,117,99,18
8755,E02003351,2014,43,171000,156000,5,10,17,11,0,43,32,11
8756,E02003352,2009,64,458000,390000,34,12,8,10,9,55,54,10
8757,E02003352,2010,59,514000,400000,36,7,11,5,1,58,54,5
8758,E02003352,2011,76,500000,417000,53,16,6,1,0,76,74,2
8759,E02003352,2012,58,485000,368000,38,8,8,4,3,55,54,4
8760,E02003352,2013,62,548000,445000,39,10,7,6,2,60,56,6
8761,E02003352,2014,16,511000,448000,9,4,2,1,0,16,15,1
8762,E02003353,2009,160,287000,250000,65,46,32,17,24,136,140,20
8763,E02003353,2010,162,308000,268000,60,50,37,15,46,116,148,14
8764,E02003353,2011,150,320000,285000,73,24,36,17,39,111,132,18
8765,E02003353,2012,153,307000,270000,57,20,58,18,18,135,134,19
8766,E02003353,2013,142,330000,284000,53,27,39,23,1,141,119,23
8767,E02003353,2014,65,294000,283000,18,12,27,8,0,65,57,8
8768,E02003354,2009,148,268000,244000,67,33,39,9,0,148,137,11
8769,E02003354,2010,158,290000,268000,73,29,42,14,0,158,144,14
8770,E02003354,2011,134,277000,249000,55,31,42,6,0,134,128,6
8771,E02003354,2012,179,320000,292000,88,19,64,8,0,179,171,8
8772,E02003354,2013,175,310000,285000,80,21,59,15,0,175,160,15
8773,E02003354,2014,58,310000,262000,19,6,24,9,0,58,50,8
8774,E02003355,2009,52,185000,175000,1,17,29,5,0,52,47,5
8775,E02003355,2010,54,195000,196000,0,15,32,7,0,54,48,6
8776,E02003355,2011,68,191000,190000,4,12,38,14,5,63,54,14
8777,E02003355,2012,49,212000,205000,2,13,25,9,0,49,38,11
8778,E02003355,2013,83,219000,207000,6,19,48,10,1,82,71,12
8779,E02003355,2014,32,216000,220000,1,5,14,12,0,32,20,12
8780,E02003356,2009,79,316000,280000,29,27,10,13,0,79,66,13
8781,E02003356,2010,104,396000,291000,34,40,18,12,0,104,89,15
8782,E02003356,2011,90,361000,336000,31,36,14,9,7,83,81,9
8783,E02003356,2012,95,334000,290000,25,33,16,21,0,95,74,21
8784,E02003356,2013,126,432000,309000,38,49,19,20,2,124,105,21
8785,E02003356,2014,45,418000,318000,15,14,8,8,0,45,37,8
8786,E02003357,2009,138,198000,184000,19,19,61,39,48,90,99,39
8787,E02003357,2010,88,211000,192000,8,12,48,20,1,87,68,20
8788,E02003357,2011,95,206000,195000,13,23,35,24,6,89,71,24
8789,E02003357,2012,109,215000,195000,11,19,51,28,19,90,80,29
8790,E02003357,2013,161,238000,210000,21,26,69,45,29,132,115,46
8791,E02003357,2014,55,224000,220000,5,7,26,17,1,54,38,17
8792,E02003358,2009,123,196000,175000,15,31,30,47,39,84,73,50
8793,E02003358,2010,106,215000,210000,12,29,30,35,29,77,69,37
8794,E02003358,2011,129,227000,190000,24,33,33,39,33,96,90,39
8795,E02003358,2012,139,238000,220000,23,45,40,31,34,105,109,30
8796,E02003358,2013,154,254000,247000,34,37,40,43,45,109,109,45
8797,E02003358,2014,46,250000,234000,9,4,21,12,2,44,34,12
8798,E02003359,2009,100,182000,178000,10,28,53,9,0,100,90,10
8799,E02003359,2010,102,212000,202000,11,32,54,5,0,102,93,9
8800,E02003359,2011,99,185000,181000,6,14,63,16,0,99,82,17
8801,E02003359,2012,108,190000,188000,7,11,80,10,0,108,97,11
8802,E02003359,2013,149,209000,204000,12,19,101,17,0,149,131,18
8803,E02003359,2014,54,232000,227000,7,6,36,5,0,54,48,6
8804,E02003360,2009,187,238000,245000,48,50,63,26,119,68,162,25
8805,E02003360,2010,172,268000,275000,57,51,54,10,104,68,161,11
8806,E02003360,2011,170,242000,245000,39,36,71,24,84,86,145,25
8807,E02003360,2012,258,267000,252000,87,37,102,32,145,113,233,25
8808,E02003360,2013,268,275000,271000,89,69,85,25,116,152,241,27
8809,E02003360,2014,84,267000,242000,23,17,28,16,21,63,69,15
8810,E02003361,2009,87,179000,175000,7,19,51,10,0,87,76,11
8811,E02003361,2010,90,196000,190000,8,11,57,14,0,90,76,14
8812,E02003361,2011,92,191000,188000,5,20,51,16,0,92,73,19
8813,E02003361,2012,108,206000,195000,14,16,63,15,0,108,92,16
8814,E02003361,2013,96,207000,204000,9,15,60,12,0,96,82,14
8815,E02003361,2014,40,214000,214000,2,3,25,10,0,40,31,9
8816,E02003362,2009,72,179000,170000,11,12,35,14,0,72,54,18
8817,E02003362,2010,91,192000,185000,11,18,45,17,0,91,73,18
8818,E02003362,2011,78,192000,185000,9,15,41,13,0,78,64,14
8819,E02003362,2012,73,194000,187000,8,13,39,13,0,73,55,18
8820,E02003362,2013,108,187000,195000,4,17,54,33,0,108,75,33
8821,E02003362,2014,34,214000,216000,2,7,19,6,0,34,26,8
8822,E02003363,2009,104,267000,220000,29,19,13,43,12,92,60,44
8823,E02003363,2010,98,327000,278000,43,19,4,32,1,97,65,33
8824,E02003363,2011,90,297000,250000,26,23,6,35,0,90,52,38
8825,E02003363,2012,92,278000,241000,23,25,7,37,0,92,55,37
8826,E02003363,2013,120,328000,307000,42,24,14,40,11,109,79,41
8827,E02003363,2014,33,301000,235000,8,3,3,19,1,32,14,19
8828,E02003364,2009,83,244000,225000,31,25,23,4,0,83,79,4
8829,E02003364,2010,100,250000,234000,30,32,31,7,0,100,92,8
8830,E02003364,2011,84,248000,232000,27,25,28,4,0,84,78,6
8831,E02003364,2012,111,248000,226000,33,20,51,7,0,111,104,7
8832,E02003364,2013,118,245000,225000,27,32,42,17,6,112,101,17
8833,E02003364,2014,31,274000,270000,13,5,8,5,2,29,26,5
8834,E02003365,2009,72,251000,244000,28,20,17,7,0,72,64,8
8835,E02003365,2010,93,300000,275000,43,26,18,6,2,91,87,6
8836,E02003365,2011,72,288000,246000,21,27,19,5,0,72,66,6
8837,E02003365,2012,107,294000,280000,43,29,31,4,0,107,103,4
8838,E02003365,2013,118,327000,300000,56,28,25,9,0,118,109,9
8839,E02003365,2014,43,336000,310000,19,12,7,5,0,43,38,5
8840,E02003366,2009,64,217000,202000,17,16,21,10,0,64,54,10
8841,E02003366,2010,93,240000,220000,24,27,31,11,0,93,80,13
8842,E02003366,2011,92,249000,239000,32,21,28,11,0,92,80,12
8843,E02003366,2012,94,255000,241000,30,25,24,15,1,93,78,16
8844,E02003366,2013,103,256000,248000,33,27,31,12,6,97,90,13
8845,E02003366,2014,35,280000,250000,15,5,7,8,1,34,27,8
8846,E02003367,2009,74,348000,332000,42,22,9,1,18,56,68,6
8847,E02003367,2010,50,384000,332000,27,17,6,0,2,48,50,0
8848,E02003367,2011,67,421000,345000,38,17,10,2,4,63,64,3
8849,E02003367,2012,67,419000,360000,33,20,13,1,1,66,64,3
8850,E02003367,2013,87,446000,375000,50,24,8,5,3,84,82,5
8851,E02003367,2014,19,442000,385000,11,4,4,0,1,18,19,0
8852,E02003368,2009,62,296000,246000,31,17,10,4,0,62,57,5
8853,E02003368,2010,86,334000,268000,40,22,19,5,1,85,81,5
8854,E02003368,2011,69,318000,250000,32,17,16,4,0,69,64,5
8855,E02003368,2012,61,282000,250000,27,12,18,4,0,61,57,4
8856,E02003368,2013,79,295000,235000,30,17,27,5,13,66,73,6
8857,E02003368,2014,21,295000,250000,8,5,8,0,2,19,20,1
8858,E02003369,2009,100,456000,402000,49,25,13,13,4,96,87,13
8859,E02003369,2010,113,565000,450000,48,34,14,17,13,100,94,19
8860,E02003369,2011,97,463000,400000,41,25,13,18,5,92,78,19
8861,E02003369,2012,101,524000,445000,42,26,16,17,3,98,83,18
8862,E02003369,2013,89,501000,430000,37,20,24,8,3,86,81,8
8863,E02003369,2014,23,395000,285000,6,6,4,7,2,21,16,7
8864,E02003370,2009,95,288000,277000,50,18,14,13,4,91,81,14
8865,E02003370,2010,100,301000,268000,46,24,16,14,2,98,83,17
8866,E02003370,2011,74,342000,286000,35,28,4,7,0,74,65,9
8867,E02003370,2012,85,297000,278000,39,19,14,13,1,84,72,13
8868,E02003370,2013,126,316000,281000,58,31,23,14,1,125,111,15
8869,E02003370,2014,38,340000,333000,23,4,5,6,0,38,32,6
8870,E02003371,2009,71,241000,220000,20,42,9,0,0,71,71,0
8871,E02003371,2010,61,271000,250000,25,29,6,1,0,61,60,1
8872,E02003371,2011,52,266000,244000,15,31,5,1,0,52,50,2
8873,E02003371,2012,67,286000,265000,25,30,11,1,0,67,66,1
8874,E02003371,2013,81,272000,250000,26,39,15,1,0,81,80,1
8875,E02003371,2014,26,270000,274000,6,12,7,1,0,26,25,1
8876,E02003372,2009,88,268000,215000,24,47,10,7,4,84,82,6
8877,E02003372,2010,92,254000,230000,25,39,15,13,1,91,78,14
8878,E02003372,2011,100,251000,232000,23,51,10,16,6,94,82,18
8879,E02003372,2012,113,258000,227000,28,45,29,11,6,107,102,11
8880,E02003372,2013,104,268000,237000,30,46,20,8,2,102,96,8
8881,E02003372,2014,32,272000,250000,9,9,9,5,0,32,27,5
8882,E02003373,2009,92,401000,385000,63,21,7,1,2,90,90,2
8883,E02003373,2010,96,462000,392000,64,13,13,6,1,95,90,6
8884,E02003373,2011,85,449000,403000,54,16,11,4,0,85,80,5
8885,E02003373,2012,79,451000,395000,49,17,12,1,3,76,78,1
8886,E02003373,2013,111,442000,390000,81,16,9,5,15,96,106,5
8887,E02003373,2014,40,366000,308000,20,10,9,1,6,34,38,2
8888,E02003374,2009,84,208000,196000,25,30,24,5,0,84,78,6
8889,E02003374,2010,79,198000,190000,11,32,29,7,0,79,72,7
8890,E02003374,2011,80,220000,205000,22,28,26,4,0,80,76,4
8891,E02003374,2012,86,214000,200000,19,28,31,8,8,78,77,9
8892,E02003374,2013,104,225000,220000,17,35,44,8,20,84,96,8
8893,E02003374,2014,30,243000,233000,7,8,12,3,0,30,27,3
8894,E02003375,2009,57,255000,205000,18,18,14,7,1,56,47,10
8895,E02003375,2010,73,268000,235000,22,24,21,6,1,72,66,7
8896,E02003375,2011,79,242000,212000,17,24,26,12,3,76,65,14
8897,E02003375,2012,54,276000,229000,15,21,15,3,0,54,51,3
8898,E02003375,2013,89,265000,212000,18,19,26,26,13,76,63,26
8899,E02003375,2014,29,277000,245000,6,10,9,4,1,28,25,4
8900,E02003376,2009,88,247000,219000,18,28,28,14,0,88,71,17
8901,E02003376,2010,88,259000,243000,22,35,15,16,1,87,68,20
8902,E02003376,2011,104,291000,248000,32,34,24,14,0,104,89,15
8903,E02003376,2012,81,235000,218000,15,23,25,18,0,81,61,20
8904,E02003376,2013,116,292000,246000,24,36,44,12,15,101,102,14
8905,E02003376,2014,44,247000,230000,6,15,14,9,1,43,33,11
8906,E02003377,2009,134,327000,250000,52,41,24,17,17,117,112,22
8907,E02003377,2010,117,369000,295000,59,23,25,10,2,115,102,15
8908,E02003377,2011,131,442000,390000,59,33,28,11,2,129,119,12
8909,E02003377,2012,116,363000,266000,51,25,29,11,1,115,104,12
8910,E02003377,2013,149,375000,310000,70,36,28,15,19,130,132,17
8911,E02003377,2014,41,440000,322000,22,10,8,1,0,41,40,1
8912,E02003378,2009,133,266000,216000,31,31,16,55,27,106,77,56
8913,E02003378,2010,123,299000,235000,27,38,22,36,11,112,85,38
8914,E02003378,2011,104,250000,223000,20,27,22,35,9,95,69,35
8915,E02003378,2012,103,302000,239000,25,31,16,31,6,97,72,31
8916,E02003378,2013,127,270000,250000,30,35,25,37,2,125,90,37
8917,E02003378,2014,49,366000,250000,14,8,10,17,0,49,32,17
8918,E02003379,2009,94,218000,201000,32,28,20,14,8,86,80,14
8919,E02003379,2010,96,203000,198000,23,31,23,19,5,91,76,20
8920,E02003379,2011,97,220000,195000,24,36,26,11,2,95,85,12
8921,E02003379,2012,90,219000,205000,27,24,26,13,0,90,77,13
8922,E02003379,2013,123,218000,210000,21,39,45,18,1,122,105,18
8923,E02003379,2014,35,215000,215000,8,13,7,7,0,35,27,8
8924,E02003380,2009,77,187000,182000,13,32,24,8,4,73,67,10
8925,E02003380,2010,100,207000,195000,23,44,24,9,0,100,92,8
8926,E02003380,2011,107,200000,188000,17,58,25,7,0,107,99,8
8927,E02003380,2012,125,207000,198000,29,44,44,8,3,122,115,10
8928,E02003380,2013,145,217000,220000,28,47,47,23,17,128,121,24
8929,E02003380,2014,55,225000,222000,7,20,20,8,0,55,47,8
8930,E02003381,2009,56,293000,250000,25,22,9,0,1,55,56,0
8931,E02003381,2010,74,304000,276000,43,15,13,3,0,74,71,3
8932,E02003381,2011,87,344000,283000,46,22,14,5,11,76,83,4
8933,E02003381,2012,71,335000,320000,42,17,11,1,3,68,70,1
8934,E02003381,2013,93,339000,315000,52,21,15,5,1,92,88,5
8935,E02003381,2014,23,369000,333000,10,7,6,0,0,23,23,0
8936,E02003382,2009,99,197000,175000,26,30,28,15,1,98,83,16
8937,E02003382,2010,74,196000,179000,14,24,23,13,0,74,61,13
8938,E02003382,2011,67,212000,190000,22,19,18,8,0,67,59,8
8939,E02003382,2012,92,229000,210000,32,23,24,13,2,90,80,12
8940,E02003382,2013,104,216000,200000,26,29,30,19,0,104,84,20
8941,E02003382,2014,48,213000,190000,9,6,20,13,0,48,35,13
8942,E02003383,2009,94,229000,222000,35,40,18,1,13,81,92,2
8943,E02003383,2010,66,240000,224000,18,26,20,2,4,62,64,2
8944,E02003383,2011,120,249000,238000,44,50,23,3,12,108,116,4
8945,E02003383,2012,98,241000,225000,34,30,28,6,0,98,90,8
8946,E02003383,2013,127,249000,235000,47,39,27,14,7,120,114,13
8947,E02003383,2014,47,258000,238000,17,14,10,6,4,43,41,6
8948,E02003384,2009,62,459000,370000,35,17,10,0,0,62,62,0
8949,E02003384,2010,70,469000,380000,41,13,15,1,0,70,69,1
8950,E02003384,2011,65,507000,432000,39,10,15,1,0,65,63,2
8951,E02003384,2012,68,472000,395000,29,19,14,6,0,68,61,7
8952,E02003384,2013,73,528000,390000,35,19,14,5,0,73,68,5
8953,E02003384,2014,33,517000,450000,19,4,4,6,3,30,27,6
8954,E02003385,2009,159,182000,148000,27,20,24,88,6,153,67,92
8955,E02003385,2010,130,229000,211000,26,25,33,46,5,125,84,46
8956,E02003385,2011,180,250000,235000,40,29,64,47,46,134,133,47
8957,E02003385,2012,132,232000,185000,18,19,36,59,10,122,72,60
8958,E02003385,2013,273,241000,220000,42,25,61,145,81,192,126,147
8959,E02003385,2014,101,228000,225000,7,7,19,68,35,66,33,68
8960,E02003386,2009,100,228000,210000,22,29,40,9,0,100,90,10
8961,E02003386,2010,139,220000,200000,28,34,37,40,24,115,99,40
8962,E02003386,2011,106,243000,213000,21,37,23,25,8,98,81,25
8963,E02003386,2012,111,282000,265000,20,35,42,14,19,92,98,13
8964,E02003386,2013,146,264000,230000,24,40,47,35,13,133,111,35
8965,E02003386,2014,54,269000,243000,10,15,14,15,6,48,39,15
8966,E02003387,2009,117,292000,250000,45,36,29,7,7,110,109,8
8967,E02003387,2010,129,326000,295000,52,47,24,6,3,126,122,7
8968,E02003387,2011,128,331000,296000,51,44,24,9,0,128,113,15
8969,E02003387,2012,157,327000,275000,56,39,31,31,21,136,125,32
8970,E02003387,2013,165,317000,275000,60,48,32,25,10,155,138,27
8971,E02003387,2014,30,297000,276000,11,6,10,3,0,30,26,4
8972,E02003388,2009,81,355000,280000,42,25,11,3,13,68,77,4
8973,E02003388,2010,76,334000,280000,29,26,13,8,2,74,68,8
8974,E02003388,2011,71,326000,315000,29,25,13,4,9,62,65,6
8975,E02003388,2012,75,391000,338000,38,22,11,4,8,67,70,5
8976,E02003388,2013,87,367000,320000,30,33,12,12,3,84,75,12
8977,E02003388,2014,25,341000,300000,7,7,7,4,2,23,21,4
8978,E02003389,2009,120,300000,280000,58,41,13,8,10,110,112,8
8979,E02003389,2010,108,311000,292000,47,36,15,10,9,99,99,9
8980,E02003389,2011,126,311000,280000,41,54,12,19,6,120,107,19
8981,E02003389,2012,108,321000,275000,48,32,20,8,3,105,100,8
8982,E02003389,2013,123,322000,290000,48,47,16,12,2,121,110,13
8983,E02003389,2014,42,347000,338000,18,13,5,6,0,42,34,8
8984,E02003390,2009,111,379000,335000,60,30,3,18,23,88,93,18
8985,E02003390,2010,112,425000,384000,68,36,2,6,1,111,106,6
8986,E02003390,2011,109,442000,405000,61,35,6,7,0,109,99,10
8987,E02003390,2012,115,490000,426000,70,32,8,5,0,115,109,6
8988,E02003390,2013,121,470000,430000,74,41,2,4,0,121,117,4
8989,E02003390,2014,42,517000,483000,24,13,0,5,0,42,37,5
8990,E02003391,2009,154,277000,246000,35,49,24,46,33,121,107,47
8991,E02003391,2010,136,315000,285000,21,69,18,28,5,131,108,28
8992,E02003391,2011,145,298000,267000,24,69,23,29,14,131,116,29
8993,E02003391,2012,136,331000,278000,31,35,50,20,11,125,116,20
8994,E02003391,2013,170,307000,269000,27,57,41,45,12,158,123,47
8995,E02003391,2014,66,333000,318000,13,23,15,15,3,63,51,15
8996,E02003392,2009,146,225000,200000,10,30,86,20,3,143,126,20
8997,E02003392,2010,146,222000,215000,7,27,77,35,0,146,111,35
8998,E02003392,2011,139,213000,209000,3,21,82,33,0,139,105,34
8999,E02003392,2012,181,238000,225000,8,30,108,35,5,176,143,38
9000,E02003392,2013,184,234000,229000,9,18,107,50,9,175,131,53
9001,E02003392,2014,64,255000,250000,1,6,39,18,3,61,46,18
9002,E02003393,2009,128,232000,211000,28,45,42,13,6,122,113,15
9003,E02003393,2010,113,248000,225000,34,40,19,20,7,106,93,20
9004,E02003393,2011,98,252000,226000,24,40,21,13,2,96,84,14
9005,E02003393,2012,123,245000,230000,25,43,42,13,1,122,108,15
9006,E02003393,2013,143,265000,235000,42,38,47,16,4,139,127,16
9007,E02003393,2014,56,237000,228000,7,13,22,14,5,51,42,14
9008,E02003394,2009,71,162000,160000,2,38,21,10,6,65,59,12
9009,E02003394,2010,58,175000,172000,1,30,19,8,1,57,50,8
9010,E02003394,2011,104,174000,173000,4,41,39,20,16,88,81,23
9011,E02003394,2012,105,182000,180000,2,34,57,12,25,80,91,14
9012,E02003394,2013,181,188000,180000,6,51,89,35,65,116,145,36
9013,E02003394,2014,30,193000,184000,1,9,15,5,4,26,24,6
9014,E02003395,2009,154,180000,173000,2,11,132,9,26,128,144,10
9015,E02003395,2010,159,185000,176000,1,11,115,32,37,122,126,33
9016,E02003395,2011,130,174000,165000,1,10,96,23,11,119,106,24
9017,E02003395,2012,149,188000,180000,1,4,96,48,45,104,91,58
9018,E02003395,2013,253,185000,177000,0,5,137,111,95,158,131,122
9019,E02003395,2014,52,204000,190000,0,1,43,8,0,52,43,9
9020,E02003396,2009,118,174000,172000,2,49,45,22,0,118,96,22
9021,E02003396,2010,128,186000,173000,11,33,46,38,2,126,88,40
9022,E02003396,2011,132,182000,180000,7,45,46,34,3,129,99,33
9023,E02003396,2012,131,189000,177000,11,34,56,30,0,131,101,30
9024,E02003396,2013,152,198000,180000,10,33,77,32,1,151,118,34
9025,E02003396,2014,76,208000,205000,5,13,37,21,4,72,55,21
9026,E02003397,2009,81,196000,180000,9,36,33,3,1,80,79,2
9027,E02003397,2010,79,229000,207000,10,38,30,1,2,77,78,1
9028,E02003397,2011,67,221000,200000,8,32,26,1,3,64,66,1
9029,E02003397,2012,84,217000,206000,12,28,42,2,10,74,82,2
9030,E02003397,2013,86,239000,230000,8,40,37,1,1,85,85,1
9031,E02003397,2014,39,258000,238000,7,14,17,1,0,39,38,1
9032,E02003398,2009,116,167000,165000,1,9,59,47,32,84,67,49
9033,E02003398,2010,148,182000,180000,1,9,94,44,18,130,102,46
9034,E02003398,2011,107,181000,173000,2,6,61,38,10,97,68,39
9035,E02003398,2012,98,185000,175000,1,3,59,35,1,97,63,35
9036,E02003398,2013,154,197000,180000,1,7,106,40,1,153,112,42
9037,E02003398,2014,50,213000,190000,1,1,34,14,0,50,36,14
9038,E02003399,2009,275,174000,170000,4,10,38,223,156,119,49,226
9039,E02003399,2010,206,187000,173000,7,10,38,151,59,147,53,153
9040,E02003399,2011,170,185000,175000,2,10,38,120,14,156,48,122
9041,E02003399,2012,170,192000,179000,0,4,36,130,2,168,40,130
9042,E02003399,2013,229,194000,190000,3,5,47,174,32,197,51,178
9043,E02003399,2014,93,195000,185000,1,1,16,75,4,89,19,74
9044,E02003400,2009,149,197000,172000,12,22,74,41,42,107,107,42
9045,E02003400,2010,146,230000,204000,12,36,65,33,31,115,114,32
9046,E02003400,2011,95,232000,197000,6,23,46,20,0,95,75,20
9047,E02003400,2012,101,215000,183000,8,10,58,25,0,101,76,25
9048,E02003400,2013,117,243000,200000,6,33,51,27,3,114,90,27
9049,E02003400,2014,31,252000,205000,3,4,14,10,0,31,21,10
9050,E02003401,2009,110,188000,170000,11,16,22,61,18,92,47,63
9051,E02003401,2010,96,209000,188000,12,16,18,50,0,96,45,51
9052,E02003401,2011,94,199000,178000,8,15,27,44,0,94,47,47
9053,E02003401,2012,111,200000,172000,12,15,27,57,1,110,50,61
9054,E02003401,2013,139,206000,180000,6,26,33,74,1,138,62,77
9055,E02003401,2014,48,217000,184000,2,11,7,28,0,48,18,30
9056,E02003402,2009,124,186000,165000,7,12,62,43,14,110,78,46
9057,E02003402,2010,123,207000,183000,7,12,71,33,13,110,88,35
9058,E02003402,2011,147,195000,180000,3,13,88,43,6,141,103,44
9059,E02003402,2012,117,210000,181000,6,9,70,32,0,117,85,32
9060,E02003402,2013,208,236000,199000,21,21,127,39,37,171,168,40
9061,E02003402,2014,48,194000,188000,2,1,27,18,8,40,29,19
9062,E02003403,2009,77,206000,188000,8,32,25,12,1,76,64,13
9063,E02003403,2010,81,206000,190000,9,40,17,15,0,81,63,18
9064,E02003403,2011,87,207000,192000,9,34,27,17,0,87,69,18
9065,E02003403,2012,118,217000,197000,13,40,21,44,29,89,74,44
9066,E02003403,2013,129,235000,222000,16,50,31,32,9,120,98,31
9067,E02003403,2014,27,248000,230000,2,11,9,5,0,27,22,5
9068,E02003404,2009,61,266000,190000,18,25,3,15,7,54,46,15
9069,E02003404,2010,54,244000,200000,11,21,6,16,4,50,37,17
9070,E02003404,2011,51,236000,207000,8,29,7,7,0,51,42,9
9071,E02003404,2012,58,218000,180000,8,21,15,14,0,58,44,14
9072,E02003404,2013,69,229000,200000,11,27,18,13,0,69,56,13
9073,E02003404,2014,24,257000,204000,4,6,4,10,3,21,14,10
9074,E02003405,2009,107,184000,177000,1,38,50,18,42,65,87,20
9075,E02003405,2010,92,174000,170000,1,44,30,17,4,88,73,19
9076,E02003405,2011,151,163000,160000,1,26,30,94,21,130,57,94
9077,E02003405,2012,128,188000,175000,0,36,56,36,9,119,92,36
9078,E02003405,2013,194,196000,185000,0,53,68,73,58,136,120,74
9079,E02003405,2014,44,191000,197000,0,17,12,15,2,42,28,16
9080,E02003406,2009,88,163000,165000,5,49,22,12,15,73,74,14
9081,E02003406,2010,56,175000,180000,2,40,7,7,2,54,47,9
9082,E02003406,2011,67,181000,174000,5,40,19,3,0,67,63,4
9083,E02003406,2012,49,176000,171000,2,30,13,4,0,49,44,5
9084,E02003406,2013,69,194000,188000,2,41,21,5,0,69,61,8
9085,E02003406,2014,29,220000,220000,2,20,5,2,1,28,27,2
9086,E02003407,2009,56,165000,169000,0,15,35,6,0,56,50,6
9087,E02003407,2010,78,173000,172000,4,24,41,9,0,78,69,9
9088,E02003407,2011,57,177000,172000,1,15,38,3,0,57,53,4
9089,E02003407,2012,69,188000,174000,6,6,55,2,0,69,67,2
9090,E02003407,2013,73,198000,190000,2,14,51,6,0,73,67,6
9091,E02003407,2014,32,206000,208000,1,2,26,3,0,32,29,3
9092,E02003408,2009,56,153000,150000,0,20,11,25,0,56,25,31
9093,E02003408,2010,63,166000,156000,1,24,11,27,0,63,29,34
9094,E02003408,2011,69,172000,175000,1,24,22,22,0,69,35,34
9095,E02003408,2012,71,171000,179000,1,30,11,29,0,71,36,35
9096,E02003408,2013,80,184000,179000,2,30,18,30,0,80,43,37
9097,E02003408,2014,26,194000,178000,3,6,6,11,0,26,14,12
9098,E02003409,2009,96,195000,178000,21,18,23,34,1,95,60,36
9099,E02003409,2010,119,186000,160000,12,26,23,58,0,119,60,59
9100,E02003409,2011,93,205000,198000,13,25,21,34,0,93,58,35
9101,E02003409,2012,106,209000,196000,20,23,20,43,0,106,63,43
9102,E02003409,2013,132,217000,210000,20,24,35,53,0,132,77,55
9103,E02003409,2014,51,237000,220000,9,11,9,22,0,51,28,23
9104,E02003410,2009,50,163000,166000,0,17,20,13,7,43,37,13
9105,E02003410,2010,58,183000,176000,0,22,27,9,0,58,47,11
9106,E02003410,2011,66,171000,169000,2,16,31,17,0,66,49,17
9107,E02003410,2012,37,182000,180000,0,15,14,8,0,37,29,8
9108,E02003410,2013,62,207000,200000,0,28,30,4,0,62,58,4
9109,E02003410,2014,22,212000,220000,0,10,10,2,0,22,18,4
9110,E02003411,2009,97,202000,202000,6,23,48,20,35,62,76,21
9111,E02003411,2010,58,188000,200000,2,15,23,18,2,56,41,17
9112,E02003411,2011,60,190000,196000,1,15,31,13,0,60,46,14
9113,E02003411,2012,59,208000,210000,3,8,39,9,1,58,50,9
9114,E02003411,2013,89,227000,232000,1,13,63,12,18,71,77,12
9115,E02003411,2014,27,250000,245000,1,8,15,3,0,27,24,3
9116,E02003412,2009,97,188000,180000,5,46,23,23,13,84,74,23
9117,E02003412,2010,115,219000,210000,14,54,31,16,22,93,98,17
9118,E02003412,2011,123,215000,215000,12,44,44,23,35,88,99,24
9119,E02003412,2012,99,220000,215000,10,39,34,16,10,89,82,17
9120,E02003412,2013,100,226000,220000,8,50,28,14,2,98,84,16
9121,E02003412,2014,34,217000,209000,1,12,5,16,0,34,18,16
9122,E02003413,2009,66,181000,174000,5,24,23,14,2,64,52,14
9123,E02003413,2010,71,182000,178000,7,19,22,23,15,56,47,24
9124,E02003413,2011,132,184000,177000,3,25,23,81,67,65,51,81
9125,E02003413,2012,75,205000,188000,12,13,15,35,27,48,39,36
9126,E02003413,2013,74,200000,200000,3,19,30,22,5,69,51,23
9127,E02003413,2014,74,213000,209000,4,8,10,52,23,51,22,52
9128,E02003414,2009,164,190000,190000,13,45,85,21,46,118,134,30
9129,E02003414,2010,152,200000,195000,8,40,81,23,34,118,125,27
9130,E02003414,2011,158,208000,200000,7,36,92,23,32,126,131,27
9131,E02003414,2012,203,218000,220000,8,52,115,28,64,139,176,27
9132,E02003414,2013,183,224000,215000,17,41,94,31,28,155,150,33
9133,E02003414,2014,68,217000,233000,3,11,36,18,11,57,48,20
9134,E02003415,2009,114,155000,151000,1,13,17,83,16,98,31,83
9135,E02003415,2010,59,153000,147000,1,12,13,33,2,57,24,35
9136,E02003415,2011,71,166000,160000,3,19,21,28,0,71,40,31
9137,E02003415,2012,56,153000,158000,0,14,12,30,0,56,25,31
9138,E02003415,2013,93,164000,155000,7,12,22,52,0,93,41,52
9139,E02003415,2014,47,177000,165000,1,11,11,24,1,46,23,24
9140,E02003416,2009,77,237000,205000,12,24,19,22,2,75,53,24
9141,E02003416,2010,122,252000,236000,25,31,34,32,13,109,88,34
9142,E02003416,2011,84,244000,239000,12,32,15,25,0,84,60,24
9143,E02003416,2012,86,259000,235000,16,23,19,28,5,81,58,28
9144,E02003416,2013,153,273000,268000,27,33,47,46,38,115,105,48
9145,E02003416,2014,75,257000,230000,6,16,20,33,26,49,42,33
9146,E02003417,2009,67,206000,160000,6,21,8,32,1,66,33,34
9147,E02003417,2010,90,245000,208000,16,22,5,47,6,84,42,48
9148,E02003417,2011,75,211000,171000,10,11,10,44,2,73,30,45
9149,E02003417,2012,78,252000,198000,15,17,7,39,2,76,39,39
9150,E02003417,2013,97,250000,207000,18,19,11,49,4,93,47,50
9151,E02003417,2014,48,230000,176000,7,5,4,32,5,43,16,32
9152,E02003418,2009,82,207000,190000,9,22,31,20,10,72,61,21
9153,E02003418,2010,100,240000,210000,12,34,35,19,1,99,81,19
9154,E02003418,2011,77,230000,209000,6,30,31,10,0,77,66,11
9155,E02003418,2012,78,260000,230000,8,21,41,8,0,78,70,8
9156,E02003418,2013,87,234000,230000,3,22,48,14,0,87,72,15
9157,E02003418,2014,27,244000,225000,2,3,17,5,0,27,22,5
9158,E02003419,2009,62,206000,211000,5,19,20,18,0,62,43,19
9159,E02003419,2010,86,220000,205000,9,21,29,27,0,86,59,27
9160,E02003419,2011,48,243000,245000,6,15,19,8,0,48,40,8
9161,E02003419,2012,59,214000,210000,3,12,22,22,0,59,36,23
9162,E02003419,2013,84,256000,246000,16,17,32,19,0,84,65,19
9163,E02003419,2014,27,244000,235000,4,5,10,8,0,27,18,9
9164,E02003420,2009,51,168000,175000,1,9,21,20,0,51,32,19
9165,E02003420,2010,65,199000,190000,2,20,22,21,0,65,44,21
9166,E02003420,2011,51,189000,180000,4,8,22,17,0,51,33,18
9167,E02003420,2012,45,196000,192000,2,7,25,11,4,41,34,11
9168,E02003420,2013,82,200000,194000,2,18,37,25,1,81,58,24
9169,E02003420,2014,24,226000,234000,1,4,15,4,0,24,19,5
9170,E02003421,2009,63,338000,320000,28,25,9,1,2,61,60,3
9171,E02003421,2010,94,407000,300000,44,33,13,4,4,90,89,5
9172,E02003421,2011,56,382000,269000,17,22,12,5,0,56,51,5
9173,E02003421,2012,59,408000,306000,25,19,11,4,0,59,55,4
9174,E02003421,2013,83,433000,333000,34,23,20,6,0,83,77,6
9175,E02003421,2014,29,404000,375000,12,10,4,3,0,29,26,3
9176,E02003422,2009,119,544000,425000,60,30,25,4,1,118,113,6
9177,E02003422,2010,149,577000,430000,67,38,34,10,2,147,138,11
9178,E02003422,2011,142,665000,543000,68,34,29,11,3,139,133,9
9179,E02003422,2012,134,654000,456000,55,45,26,8,10,124,126,8
9180,E02003422,2013,165,580000,470000,57,49,43,16,1,164,149,16
9181,E02003422,2014,41,659000,430000,14,17,7,3,1,40,37,4
9182,E02003423,2009,48,265000,232000,11,22,9,6,6,42,42,6
9183,E02003423,2010,69,277000,245000,13,33,18,5,2,67,60,9
9184,E02003423,2011,59,289000,245000,12,22,18,7,3,56,52,7
9185,E02003423,2012,52,307000,258000,13,19,11,9,4,48,43,9
9186,E02003423,2013,69,360000,295000,18,23,20,8,15,54,52,17
9187,E02003423,2014,34,343000,314000,7,9,11,7,5,29,27,7
9188,E02003424,2009,157,383000,320000,67,13,11,66,22,135,88,69
9189,E02003424,2010,140,430000,355000,54,18,16,52,12,128,87,53
9190,E02003424,2011,153,446000,430000,53,16,27,57,35,118,97,56
9191,E02003424,2012,141,414000,367000,48,9,17,67,22,119,74,67
9192,E02003424,2013,262,399000,305000,56,13,51,142,68,194,121,141
9193,E02003424,2014,79,462000,342000,22,5,14,38,17,62,41,38
9194,E02003425,2009,169,248000,213000,28,40,35,66,36,133,98,71
9195,E02003425,2010,158,262000,240000,24,33,42,59,17,141,97,61
9196,E02003425,2011,150,248000,229000,21,24,32,73,21,129,75,75
9197,E02003425,2012,153,272000,237000,24,20,39,70,24,129,83,70
9198,E02003425,2013,242,298000,250000,27,52,52,111,47,195,129,113
9199,E02003425,2014,90,322000,276000,13,13,24,40,19,71,49,41
9200,E02003426,2009,135,342000,295000,50,46,16,23,13,122,110,25
9201,E02003426,2010,175,374000,327000,55,73,28,19,9,166,154,21
9202,E02003426,2011,124,364000,323000,48,37,15,24,4,120,100,24
9203,E02003426,2012,116,376000,341000,43,42,17,14,0,116,102,14
9204,E02003426,2013,137,401000,338000,49,39,28,21,0,137,114,23
9205,E02003426,2014,44,451000,409000,17,15,6,6,0,44,38,6
9206,E02003427,2009,57,237000,220000,7,28,11,11,0,57,45,12
9207,E02003427,2010,115,257000,232000,15,45,35,20,0,115,91,24
9208,E02003427,2011,66,258000,235000,10,27,18,11,0,66,52,14
9209,E02003427,2012,83,271000,249000,7,28,32,16,0,83,64,19
9210,E02003427,2013,102,288000,250000,14,30,34,24,3,99,75,27
9211,E02003427,2014,23,288000,250000,3,6,6,8,1,22,15,8
9212,E02003428,2009,96,287000,260000,27,51,16,2,1,95,94,2
9213,E02003428,2010,105,296000,285000,38,47,12,8,0,105,96,9
9214,E02003428,2011,109,296000,285000,30,46,26,7,0,109,101,8
9215,E02003428,2012,109,301000,295000,27,52,19,11,3,106,98,11
9216,E02003428,2013,111,340000,320000,43,42,23,3,4,107,108,3
9217,E02003428,2014,34,334000,328000,10,16,7,1,0,34,33,1
9218,E02003429,2009,108,415000,362000,52,26,21,9,30,78,98,10
9219,E02003429,2010,113,442000,385000,57,34,14,8,5,108,103,10
9220,E02003429,2011,81,471000,400000,38,22,14,7,0,81,73,8
9221,E02003429,2012,91,428000,385000,42,21,24,4,1,90,87,4
9222,E02003429,2013,98,472000,371000,49,15,23,11,1,97,86,12
9223,E02003429,2014,33,455000,440000,15,6,8,4,2,31,29,4
9224,E02003430,2009,66,354000,250000,12,16,25,13,0,66,51,15
9225,E02003430,2010,87,348000,276000,11,11,30,35,6,81,52,35
9226,E02003430,2011,63,372000,285000,2,11,28,22,1,62,41,22
9227,E02003430,2012,67,551000,350000,2,12,27,26,12,55,37,30
9228,E02003430,2013,104,439000,324000,7,9,47,41,19,85,61,43
9229,E02003430,2014,25,447000,335000,1,5,10,9,3,22,16,9
9230,E02003431,2009,67,340000,270000,19,16,24,8,2,65,58,9
9231,E02003431,2010,86,345000,308000,33,30,11,12,0,86,74,12
9232,E02003431,2011,89,385000,325000,38,21,13,17,0,89,73,16
9233,E02003431,2012,77,339000,270000,22,17,23,15,0,77,62,15
9234,E02003431,2013,113,351000,295000,28,30,31,24,0,113,87,26
9235,E02003431,2014,40,339000,296000,8,8,7,17,0,40,22,18
9236,E02003432,2009,114,336000,294000,10,30,41,33,3,111,81,33
9237,E02003432,2010,136,348000,309000,5,30,55,46,19,117,88,48
9238,E02003432,2011,157,406000,312000,10,36,58,53,21,136,104,53
9239,E02003432,2012,134,405000,336000,8,22,67,37,5,129,97,37
9240,E02003432,2013,147,382000,342000,3,25,75,44,1,146,102,45
9241,E02003432,2014,39,363000,358000,1,3,24,11,0,39,28,11
9242,E02003433,2009,48,252000,247000,5,19,18,6,0,48,42,6
9243,E02003433,2010,62,306000,292000,8,31,21,2,0,62,60,2
9244,E02003433,2011,59,300000,280000,4,29,21,5,0,59,54,5
9245,E02003433,2012,62,334000,285000,5,19,32,6,0,62,56,6
9246,E02003433,2013,59,344000,295000,6,15,28,10,0,59,48,11
9247,E02003433,2014,22,323000,332000,2,5,13,2,0,22,20,2
9248,E02003434,2009,107,325000,285000,30,41,22,14,5,102,88,19
9249,E02003434,2010,103,324000,298000,19,37,13,34,0,103,67,36
9250,E02003434,2011,106,350000,322000,22,32,20,32,0,106,74,32
9251,E02003434,2012,110,320000,279000,13,30,16,51,17,93,59,51
9252,E02003434,2013,127,344000,320000,25,39,22,41,6,121,85,42
9253,E02003434,2014,28,345000,298000,5,6,10,7,1,27,21,7
9254,E02003435,2009,84,428000,355000,28,12,30,14,4,80,68,16
9255,E02003435,2010,105,501000,390000,21,21,33,30,3,102,70,35
9256,E02003435,2011,98,508000,432000,29,19,26,24,0,98,73,25
9257,E02003435,2012,114,476000,388000,26,10,44,34,7,107,78,36
9258,E02003435,2013,145,546000,468000,28,19,61,37,27,118,106,39
9259,E02003435,2014,44,455000,403000,6,7,26,5,0,44,37,7
9260,E02003436,2009,85,359000,308000,34,26,10,15,7,78,70,15
9261,E02003436,2010,108,422000,373000,52,25,24,7,4,104,99,9
9262,E02003436,2011,82,420000,346000,38,26,11,7,0,82,76,6
9263,E02003436,2012,85,433000,360000,45,27,8,5,0,85,79,6
9264,E02003436,2013,135,470000,380000,68,33,20,14,3,132,120,15
9265,E02003436,2014,29,395000,370000,11,10,3,5,0,29,23,6
9266,E02003437,2009,102,462000,366000,38,13,15,36,31,71,64,38
9267,E02003437,2010,126,552000,378000,39,33,21,33,11,115,93,33
9268,E02003437,2011,99,548000,428000,40,27,16,16,9,90,83,16
9269,E02003437,2012,88,595000,402000,27,21,19,21,8,80,66,22
9270,E02003437,2013,109,565000,440000,45,15,28,21,8,101,84,25
9271,E02003437,2014,28,616000,512000,9,10,4,5,1,27,22,6
9272,E02003438,2009,158,751000,542000,92,30,12,24,1,157,131,27
9273,E02003438,2010,189,775000,539000,84,30,15,60,25,164,125,64
9274,E02003438,2011,165,614000,435000,58,32,12,63,20,145,101,64
9275,E02003438,2012,181,747000,542000,75,30,14,62,26,155,117,64
9276,E02003438,2013,195,775000,515000,63,47,27,58,25,170,134,61
9277,E02003438,2014,90,759000,568000,32,20,16,22,13,77,63,27
9278,E02003439,2009,56,440000,387000,26,13,10,7,0,56,49,7
9279,E02003439,2010,67,534000,415000,31,11,13,12,12,55,53,14
9280,E02003439,2011,89,638000,435000,49,16,12,12,6,83,76,13
9281,E02003439,2012,73,528000,440000,33,18,13,9,0,73,65,8
9282,E02003439,2013,88,555000,455000,31,23,22,12,8,80,75,13
9283,E02003439,2014,31,656000,401000,15,4,5,7,0,31,25,6
9284,E02003440,2009,143,302000,262000,54,43,34,12,15,128,131,12
9285,E02003440,2010,141,325000,295000,60,35,37,9,0,141,131,10
9286,E02003440,2011,149,358000,329000,61,42,24,22,7,142,127,22
9287,E02003440,2012,144,340000,306000,49,40,42,13,1,143,130,14
9288,E02003440,2013,152,374000,332000,64,37,26,25,1,151,127,25
9289,E02003440,2014,50,370000,324000,20,9,13,8,1,49,41,9
9290,E02003441,2009,111,301000,250000,37,47,20,7,1,110,105,6
9291,E02003441,2010,93,354000,310000,33,45,10,5,1,92,88,5
9292,E02003441,2011,97,376000,315000,41,36,17,3,7,90,93,4
9293,E02003441,2012,102,361000,290000,43,27,25,7,5,97,95,7
9294,E02003441,2013,99,359000,290000,32,39,19,9,2,97,90,9
9295,E02003441,2014,30,351000,315000,5,17,6,2,3,27,28,2
9296,E02003442,2009,104,262000,240000,41,31,18,14,0,104,90,14
9297,E02003442,2010,111,272000,245000,38,35,25,13,0,111,96,15
9298,E02003442,2011,121,297000,260000,45,39,29,8,0,121,110,11
9299,E02003442,2012,98,285000,250000,41,18,20,19,0,98,79,19
9300,E02003442,2013,130,299000,263000,52,32,27,19,0,130,112,18
9301,E02003442,2014,43,315000,305000,19,8,7,9,0,43,34,9
9302,E02003443,2009,63,217000,205000,13,15,9,26,2,61,37,26
9303,E02003443,2010,78,250000,240000,23,21,13,21,4,74,58,20
9304,E02003443,2011,101,219000,210000,18,28,19,36,25,76,64,37
9305,E02003443,2012,59,238000,238000,13,20,14,12,2,57,47,12
9306,E02003443,2013,109,279000,278000,36,26,33,14,32,77,96,13
9307,E02003443,2014,27,281000,270000,4,11,9,3,3,24,24,3
9308,E02003444,2009,117,262000,250000,34,56,16,11,30,87,106,11
9309,E02003444,2010,106,279000,275000,20,63,7,16,9,97,89,17
9310,E02003444,2011,89,279000,261000,20,56,4,9,2,87,80,9
9311,E02003444,2012,124,281000,266000,30,65,12,17,12,112,107,17
9312,E02003444,2013,114,299000,276000,36,52,13,13,5,109,101,13
9313,E02003444,2014,39,347000,328000,14,19,4,2,0,39,37,2
9314,E02003445,2009,93,225000,225000,10,61,13,9,2,91,83,10
9315,E02003445,2010,93,235000,239000,13,56,13,11,0,93,82,11
9316,E02003445,2011,87,233000,230000,9,56,15,7,0,87,80,7
9317,E02003445,2012,89,244000,243000,19,50,11,9,0,89,76,13
9318,E02003445,2013,109,256000,250000,19,65,11,14,0,109,92,17
9319,E02003445,2014,32,247000,255000,2,13,9,8,0,32,24,8
9320,E02003446,2009,83,275000,264000,33,32,14,4,0,83,79,4
9321,E02003446,2010,80,301000,290000,34,34,9,3,0,80,76,4
9322,E02003446,2011,104,315000,303000,58,36,8,2,0,104,101,3
9323,E02003446,2012,91,296000,278000,44,26,17,4,0,91,87,4
9324,E02003446,2013,142,292000,285000,61,40,23,18,11,131,125,17
9325,E02003446,2014,43,279000,273000,18,9,5,11,11,32,32,11
9326,E02003447,2009,114,284000,262000,44,30,34,6,6,108,108,6
9327,E02003447,2010,115,308000,288000,55,24,32,4,2,113,110,5
9328,E02003447,2011,118,296000,278000,50,30,28,10,9,109,102,16
9329,E02003447,2012,150,321000,298000,64,33,46,7,29,121,140,10
9330,E02003447,2013,160,302000,282000,62,23,50,25,6,154,133,27
9331,E02003447,2014,47,321000,310000,20,7,14,6,2,45,39,8
9332,E02003448,2009,104,318000,277000,41,35,17,11,23,81,92,12
9333,E02003448,2010,114,332000,292000,50,29,17,18,27,87,96,18
9334,E02003448,2011,83,387000,290000,32,30,10,11,2,81,72,11
9335,E02003448,2012,83,341000,307000,37,26,11,9,1,82,74,9
9336,E02003448,2013,101,396000,322000,45,30,9,17,4,97,84,17
9337,E02003448,2014,40,336000,326000,13,13,8,6,2,38,34,6
9338,E02003449,2009,134,205000,200000,35,37,49,13,0,134,117,17
9339,E02003449,2010,161,217000,215000,34,42,59,26,0,161,137,24
9340,E02003449,2011,161,215000,210000,39,37,67,18,0,161,142,19
9341,E02003449,2012,132,227000,222000,42,19,49,22,0,132,112,20
9342,E02003449,2013,159,231000,222000,40,28,70,21,1,158,140,19
9343,E02003449,2014,62,242000,225000,14,8,31,9,0,62,52,10
9344,E02003450,2009,159,260000,235000,55,58,33,13,28,131,143,16
9345,E02003450,2010,165,264000,245000,50,64,31,20,4,161,142,23
9346,E02003450,2011,147,280000,250000,52,43,40,12,6,141,132,15
9347,E02003450,2012,135,271000,250000,50,38,30,17,0,135,117,18
9348,E02003450,2013,185,283000,265000,66,58,39,22,0,185,162,23
9349,E02003450,2014,60,263000,250000,14,18,12,16,0,60,44,16
9350,E02003451,2009,159,253000,235000,27,36,37,59,37,122,97,62
9351,E02003451,2010,129,268000,250000,19,25,34,51,16,113,79,50
9352,E02003451,2011,131,261000,250000,23,29,39,40,0,131,88,43
9353,E02003451,2012,139,267000,247000,25,24,34,56,24,115,82,57
9354,E02003451,2013,256,276000,250000,24,33,83,116,87,169,140,116
9355,E02003451,2014,69,300000,290000,7,8,17,37,20,49,31,38
9356,E02003452,2009,112,314000,260000,50,23,23,16,17,95,95,17
9357,E02003452,2010,90,312000,286000,29,22,26,13,4,86,76,14
9358,E02003452,2011,144,332000,284000,57,48,31,8,47,97,132,12
9359,E02003452,2012,122,326000,302000,51,20,25,26,47,75,95,27
9360,E02003452,2013,93,368000,312000,40,17,19,17,0,93,76,17
9361,E02003452,2014,38,415000,359000,19,6,11,2,0,38,36,2
9362,E02003453,2009,86,339000,306000,49,16,16,5,12,74,81,5
9363,E02003453,2010,103,366000,338000,67,24,7,5,4,99,98,5
9364,E02003453,2011,102,414000,370000,65,21,10,6,2,100,96,6
9365,E02003453,2012,69,404000,385000,46,11,9,3,3,66,66,3
9366,E02003453,2013,92,394000,380000,63,14,12,3,0,92,89,3
9367,E02003453,2014,28,374000,308000,11,8,8,1,2,26,27,1
9368,E02003454,2009,112,303000,250000,48,26,23,15,9,103,95,17
9369,E02003454,2010,133,326000,250000,48,36,28,21,25,108,110,23
9370,E02003454,2011,111,336000,270000,48,32,21,10,1,110,97,14
9371,E02003454,2012,184,279000,233000,49,35,33,67,69,115,114,70
9372,E02003454,2013,163,284000,240000,42,34,30,57,38,125,102,61
9373,E02003454,2014,78,265000,225000,14,11,11,42,26,52,36,42
9374,E02003455,2009,86,337000,305000,49,23,11,3,18,68,82,4
9375,E02003455,2010,94,319000,290000,32,35,16,11,5,89,81,13
9376,E02003455,2011,79,329000,290000,34,21,18,6,1,78,71,8
9377,E02003455,2012,87,339000,300000,33,25,23,6,8,79,78,9
9378,E02003455,2013,170,366000,312000,75,45,45,5,63,107,165,5
9379,E02003455,2014,73,348000,280000,24,16,29,4,28,45,66,7
9380,E02003456,2009,72,321000,250000,32,24,14,2,0,72,70,2
9381,E02003456,2010,71,316000,263000,34,17,16,4,0,71,67,4
9382,E02003456,2011,76,321000,246000,29,24,22,1,2,74,73,3
9383,E02003456,2012,84,312000,240000,23,24,34,3,5,79,81,3
9384,E02003456,2013,87,320000,267000,31,17,33,6,5,82,81,6
9385,E02003456,2014,38,323000,290000,14,8,10,6,2,36,32,6
9386,E02003457,2009,126,417000,348000,86,21,19,0,12,114,126,0
9387,E02003457,2010,130,416000,362000,82,29,19,0,1,129,129,1
9388,E02003457,2011,138,388000,374000,89,23,23,3,1,137,136,2
9389,E02003457,2012,122,469000,376000,84,19,18,1,4,118,121,1
9390,E02003457,2013,169,454000,390000,110,24,32,3,3,166,166,3
9391,E02003457,2014,59,486000,425000,39,6,13,1,1,58,58,1
9392,E02003458,2009,121,328000,312000,63,39,9,10,6,115,111,10
9393,E02003458,2010,115,381000,380000,76,22,6,11,0,115,104,11
9394,E02003458,2011,119,367000,335000,63,38,10,8,4,115,110,9
9395,E02003458,2012,117,389000,365000,76,18,13,10,5,112,107,10
9396,E02003458,2013,120,373000,353000,62,29,23,6,0,120,113,7
9397,E02003458,2014,45,421000,410000,24,11,4,6,0,45,39,6
9398,E02003459,2009,124,267000,235000,50,40,28,6,2,122,118,6
9399,E02003459,2010,145,278000,247000,60,42,37,6,4,141,140,5
9400,E02003459,2011,136,252000,235000,51,37,34,14,1,135,121,15
9401,E02003459,2012,105,277000,250000,41,19,38,7,0,105,98,7
9402,E02003459,2013,137,245000,225000,40,21,68,8,0,137,129,8
9403,E02003459,2014,48,304000,250000,17,10,18,3,0,48,45,3
9404,E02003460,2009,141,246000,210000,50,45,33,13,55,86,127,14
9405,E02003460,2010,222,279000,245000,98,61,40,23,126,96,197,25
9406,E02003460,2011,242,257000,225000,98,71,36,37,140,102,201,41
9407,E02003460,2012,259,264000,230000,106,78,58,17,151,108,242,17
9408,E02003460,2013,286,264000,230000,105,91,80,10,123,163,275,11
9409,E02003460,2014,86,277000,250000,31,21,32,2,20,66,81,5
9410,E02003461,2009,78,185000,166000,22,32,21,3,1,77,76,2
9411,E02003461,2010,107,200000,193000,29,47,18,13,31,76,94,13
9412,E02003461,2011,149,187000,180000,31,58,27,33,39,110,114,35
9413,E02003461,2012,103,196000,180000,26,39,35,3,3,100,99,4
9414,E02003461,2013,114,208000,198000,29,47,32,6,3,111,106,8
9415,E02003461,2014,43,216000,200000,8,16,13,6,4,39,37,6
9416,E02003462,2009,116,171000,160000,20,43,38,15,7,109,99,17
9417,E02003462,2010,130,188000,172000,27,50,41,12,0,130,117,13
9418,E02003462,2011,124,176000,165000,25,31,52,16,0,124,109,15
9419,E02003462,2012,133,180000,162000,24,38,60,11,1,132,120,13
9420,E02003462,2013,158,185000,175000,28,34,70,26,0,158,132,26
9421,E02003462,2014,52,195000,180000,9,13,19,11,2,50,41,11
9422,E02003463,2009,74,194000,160000,28,18,26,2,0,74,69,5
9423,E02003463,2010,72,207000,177000,29,13,20,10,1,71,54,18
9424,E02003463,2011,70,206000,160000,29,15,21,5,0,70,62,8
9425,E02003463,2012,78,195000,168000,25,22,27,4,2,76,68,10
9426,E02003463,2013,90,242000,204000,44,14,28,4,6,84,82,8
9427,E02003463,2014,36,201000,167000,12,3,16,5,0,36,30,6
9428,E02003464,2009,47,133000,140000,9,17,19,2,0,47,43,4
9429,E02003464,2010,53,152000,146000,10,23,17,3,0,53,48,5
9430,E02003464,2011,44,137000,134000,8,17,17,2,0,44,39,5
9431,E02003464,2012,61,150000,143000,15,17,26,3,0,61,58,3
9432,E02003464,2013,64,146000,139000,10,20,29,5,0,64,56,8
9433,E02003464,2014,28,174000,160000,6,9,11,2,0,28,26,2
9434,E02003465,2009,104,169000,156000,20,37,8,39,37,67,60,44
9435,E02003465,2010,123,190000,178000,32,33,18,40,48,75,76,47
9436,E02003465,2011,105,199000,175000,28,34,19,24,27,78,69,36
9437,E02003465,2012,131,235000,180000,48,36,19,28,49,82,92,39
9438,E02003465,2013,113,230000,180000,43,39,15,16,14,99,86,27
9439,E02003465,2014,35,215000,180000,14,7,9,5,0,35,27,8
9440,E02003466,2009,114,153000,150000,5,22,71,16,15,99,98,16
9441,E02003466,2010,126,162000,164000,4,17,67,38,39,87,88,38
9442,E02003466,2011,106,144000,138000,1,17,72,16,12,94,90,16
9443,E02003466,2012,88,155000,150000,0,15,70,3,4,84,85,3
9444,E02003466,2013,125,161000,155000,2,18,98,7,2,123,118,7
9445,E02003466,2014,30,187000,175000,0,3,26,1,1,29,29,1
9446,E02003467,2009,37,144000,130000,6,6,19,6,0,37,30,7
9447,E02003467,2010,41,155000,148000,9,8,24,0,1,40,38,3
9448,E02003467,2011,51,137000,140000,8,12,20,11,0,51,37,14
9449,E02003467,2012,50,163000,143000,15,3,22,10,0,50,38,12
9450,E02003467,2013,52,163000,146000,8,8,32,4,0,52,45,7
9451,E02003467,2014,27,182000,165000,4,8,13,2,0,27,25,2
9452,E02003468,2009,139,177000,163000,19,26,70,24,55,84,114,25
9453,E02003468,2010,96,195000,175000,18,38,32,8,14,82,87,9
9454,E02003468,2011,177,183000,170000,21,43,62,51,59,118,124,53
9455,E02003468,2012,190,193000,184000,30,58,68,34,80,110,156,34
9456,E02003468,2013,266,202000,195000,36,90,96,44,133,133,220,46
9457,E02003468,2014,61,215000,205000,8,18,28,7,18,43,53,8
9458,E02003469,2009,66,161000,152000,19,23,20,4,0,66,61,5
9459,E02003469,2010,57,186000,165000,21,17,16,3,0,57,53,4
9460,E02003469,2011,69,181000,172000,27,24,14,4,0,69,63,6
9461,E02003469,2012,74,196000,176000,37,19,17,1,0,74,68,6
9462,E02003469,2013,82,193000,180000,35,23,20,4,0,82,75,7
9463,E02003469,2014,29,207000,190000,11,7,8,3,0,29,27,2
9464,E02003470,2009,24,118000,119000,0,5,14,5,0,24,20,4
9465,E02003470,2010,33,113000,118000,0,7,18,8,0,33,22,11
9466,E02003470,2011,31,113000,112000,1,3,24,3,0,31,28,3
9467,E02003470,2012,32,124000,125000,3,7,18,4,0,32,25,7
9468,E02003470,2013,29,127000,130000,0,4,22,3,0,29,26,3
9469,E02003470,2014,14,134000,138000,1,1,11,1,0,14,12,2
9470,E02003471,2009,48,157000,144000,14,17,12,5,0,48,41,7
9471,E02003471,2010,56,157000,149000,15,7,23,11,0,56,40,16
9472,E02003471,2011,59,147000,127000,11,19,20,9,0,59,44,15
9473,E02003471,2012,51,163000,162000,20,15,14,2,0,51,43,8
9474,E02003471,2013,60,161000,145000,11,20,23,6,0,60,51,9
9475,E02003471,2014,28,151000,136000,6,4,13,5,0,28,20,8
9476,E02003472,2009,342,135000,139000,3,7,23,309,99,243,22,320
9477,E02003472,2010,147,145000,152000,2,5,22,118,34,113,24,123
9478,E02003472,2011,73,144000,140000,1,4,23,45,0,73,22,51
9479,E02003472,2012,83,140000,144000,1,1,18,63,0,83,16,67
9480,E02003472,2013,135,149000,147000,2,1,30,102,9,126,30,105
9481,E02003472,2014,62,150000,150000,2,1,16,43,8,54,17,45
9482,E02003473,2009,90,173000,162000,41,26,15,8,0,90,72,18
9483,E02003473,2010,78,189000,180000,37,17,17,7,0,78,66,12
9484,E02003473,2011,66,193000,194000,34,13,10,9,0,66,50,16
9485,E02003473,2012,73,208000,217000,45,11,9,8,0,73,61,12
9486,E02003473,2013,74,189000,190000,35,15,15,9,0,74,55,19
9487,E02003473,2014,21,188000,185000,7,6,4,4,0,21,14,7
9488,E02003474,2009,81,209000,188000,34,17,22,8,3,78,65,16
9489,E02003474,2010,87,216000,198000,38,19,21,9,0,87,72,15
9490,E02003474,2011,82,228000,216000,38,18,15,11,1,81,67,15
9491,E02003474,2012,92,256000,223000,46,14,17,15,1,91,74,18
9492,E02003474,2013,104,252000,221000,45,24,24,11,0,104,84,20
9493,E02003474,2014,34,246000,215000,16,7,3,8,0,34,23,11
9494,E02003475,2009,402,215000,212000,175,102,69,56,216,186,322,80
9495,E02003475,2010,501,240000,235000,247,112,79,63,324,177,425,76
9496,E02003475,2011,370,218000,213000,147,87,59,77,225,145,276,94
9497,E02003475,2012,321,223000,215000,98,91,70,62,172,149,249,72
9498,E02003475,2013,464,225000,225000,148,90,114,112,253,211,336,128
9499,E02003475,2014,123,256000,250000,52,18,30,23,44,79,98,25
9500,E02003476,2009,39,106000,107000,2,10,18,9,1,38,28,11
9501,E02003476,2010,45,116000,125000,2,14,28,1,0,45,41,4
9502,E02003476,2011,55,106000,115000,2,8,34,11,0,55,43,12
9503,E02003476,2012,50,123000,124000,3,12,33,2,0,50,47,3
9504,E02003476,2013,55,124000,124000,7,7,34,7,0,55,46,9
9505,E02003476,2014,29,152000,150000,4,6,18,1,0,29,27,2
9506,E02003477,2009,238,208000,198000,77,70,45,46,79,159,191,47
9507,E02003477,2010,158,231000,218000,52,43,32,31,43,115,121,37
9508,E02003477,2011,170,234000,202000,58,53,36,23,37,133,142,28
9509,E02003477,2012,190,244000,230000,64,51,46,29,75,115,160,30
9510,E02003477,2013,231,225000,223000,62,74,61,34,62,169,188,43
9511,E02003477,2014,64,246000,230000,24,14,14,12,5,59,51,13
9512,E02003478,2009,92,217000,170000,32,26,21,13,2,90,73,19
9513,E02003478,2010,97,251000,195000,46,30,9,12,1,96,74,23
9514,E02003478,2011,91,233000,180000,32,35,14,10,0,91,74,17
9515,E02003478,2012,85,259000,195000,44,27,9,5,0,85,73,12
9516,E02003478,2013,83,266000,200000,37,30,7,9,3,80,67,16
9517,E02003478,2014,30,319000,240000,21,6,2,1,0,30,28,2
9518,E02003479,2009,37,140000,146000,6,15,13,3,0,37,31,6
9519,E02003479,2010,53,153000,150000,13,11,21,8,0,53,40,13
9520,E02003479,2011,56,139000,135000,10,12,26,8,0,56,43,13
9521,E02003479,2012,55,145000,150000,15,11,21,8,0,55,41,14
9522,E02003479,2013,53,155000,151000,12,14,23,4,0,53,45,8
9523,E02003479,2014,22,147000,132000,8,6,5,3,0,22,14,8
9524,E02003480,2009,123,189000,172000,38,30,32,23,15,108,87,36
9525,E02003480,2010,106,176000,161000,31,29,26,20,6,100,73,33
9526,E02003480,2011,114,187000,165000,40,34,29,11,0,114,95,19
9527,E02003480,2012,89,231000,178000,32,31,16,10,0,89,73,16
9528,E02003480,2013,113,235000,218000,54,27,21,11,0,113,97,16
9529,E02003480,2014,49,259000,235000,26,11,8,4,0,49,44,5
9530,E02003481,2009,151,144000,122000,14,11,23,103,92,59,45,106
9531,E02003481,2010,74,158000,150000,7,10,12,45,33,41,28,46
9532,E02003481,2011,53,142000,138000,5,6,21,21,13,40,31,22
9533,E02003481,2012,81,152000,138000,3,9,25,44,46,35,37,44
9534,E02003481,2013,130,146000,137000,7,15,31,77,55,75,51,79
9535,E02003481,2014,28,154000,119000,3,0,14,11,1,27,17,11
9536,E02003482,2009,103,215000,217000,41,21,14,27,25,78,73,30
9537,E02003482,2010,85,285000,250000,43,20,16,6,30,55,79,6
9538,E02003482,2011,99,297000,250000,48,27,20,4,24,75,94,5
9539,E02003482,2012,119,285000,250000,59,32,17,11,31,88,106,13
9540,E02003482,2013,129,299000,245000,55,17,30,27,28,101,101,28
9541,E02003482,2014,53,303000,250000,19,13,7,14,17,36,39,14
9542,E02003483,2009,177,208000,208000,84,44,27,22,28,149,143,34
9543,E02003483,2010,148,219000,224000,66,33,26,23,8,140,117,31
9544,E02003483,2011,129,244000,234000,70,29,19,11,1,128,110,19
9545,E02003483,2012,122,288000,259000,71,19,22,10,8,114,112,10
9546,E02003483,2013,161,255000,245000,88,24,31,18,28,133,137,24
9547,E02003483,2014,67,296000,265000,36,10,11,10,15,52,56,11
9548,E02003484,2009,68,186000,170000,30,13,15,10,0,68,54,14
9549,E02003484,2010,85,183000,159000,27,22,20,16,0,85,63,22
9550,E02003484,2011,82,204000,183000,36,15,26,5,0,82,71,11
9551,E02003484,2012,80,190000,166000,26,16,30,8,0,80,60,20
9552,E02003484,2013,90,220000,200000,41,23,25,1,1,89,82,8
9553,E02003484,2014,37,193000,182000,16,6,12,3,0,37,28,9
9554,E02003485,2009,55,155000,145000,10,18,21,6,2,53,50,5
9555,E02003485,2010,74,192000,164000,31,20,20,3,0,74,71,3
9556,E02003485,2011,66,161000,145000,16,26,19,5,0,66,61,5
9557,E02003485,2012,75,178000,160000,30,17,27,1,0,75,74,1
9558,E02003485,2013,81,173000,161000,23,22,30,6,0,81,75,6
9559,E02003485,2014,34,172000,162000,5,12,15,2,0,34,31,3
9560,E02003486,2009,128,182000,182000,48,45,23,12,1,127,106,22
9561,E02003486,2010,138,206000,199000,52,37,31,18,5,133,109,29
9562,E02003486,2011,127,193000,187000,57,31,29,10,6,121,105,22
9563,E02003486,2012,130,232000,217000,70,28,25,7,11,119,120,10
9564,E02003486,2013,136,234000,218000,69,28,33,6,4,132,124,12
9565,E02003486,2014,56,229000,225000,27,13,12,4,0,56,50,6
9566,E02003487,2009,56,148000,144000,7,32,14,3,0,56,52,4
9567,E02003487,2010,60,176000,169000,17,22,19,2,0,60,58,2
9568,E02003487,2011,77,189000,158000,24,33,19,1,0,77,76,1
9569,E02003487,2012,63,187000,165000,20,20,22,1,0,63,60,3
9570,E02003487,2013,57,197000,166000,17,17,22,1,6,51,56,1
9571,E02003487,2014,25,222000,208000,11,6,8,0,1,24,25,0
9572,E02003488,2009,98,140000,135000,10,32,30,26,20,78,71,27
9573,E02003488,2010,75,149000,145000,9,33,26,7,0,75,68,7
9574,E02003488,2011,91,153000,145000,13,29,28,21,18,73,69,22
9575,E02003488,2012,130,142000,138000,7,39,33,51,32,98,79,51
9576,E02003488,2013,113,157000,152000,21,37,34,21,12,101,91,22
9577,E02003488,2014,48,164000,162000,1,12,24,11,10,38,37,11
9578,E02003489,2009,116,147000,140000,13,47,18,38,47,69,78,38
9579,E02003489,2010,82,177000,158000,14,41,12,15,13,69,62,20
9580,E02003489,2011,103,169000,159000,18,38,16,31,24,79,70,33
9581,E02003489,2012,141,167000,160000,14,44,31,52,61,80,85,56
9582,E02003489,2013,109,191000,178000,21,58,19,11,0,109,96,13
9583,E02003489,2014,42,183000,178000,5,22,9,6,0,42,34,8
9584,E02003490,2009,97,164000,174000,15,27,51,4,51,46,93,4
9585,E02003490,2010,84,177000,190000,21,30,30,3,45,39,82,2
9586,E02003490,2011,92,178000,185000,26,18,42,6,46,46,87,5
9587,E02003490,2012,91,186000,195000,25,17,37,12,60,31,81,10
9588,E02003490,2013,133,173000,159000,15,41,54,23,69,64,112,21
9589,E02003490,2014,46,188000,180000,14,15,16,1,23,23,43,3
9590,E02003491,2009,90,220000,221000,10,67,10,3,0,90,87,3
9591,E02003491,2010,97,253000,250000,12,69,11,5,0,97,91,6
9592,E02003491,2011,109,252000,245000,7,78,18,6,0,109,103,6
9593,E02003491,2012,102,263000,250000,9,81,9,3,0,102,99,3
9594,E02003491,2013,111,277000,270000,19,77,9,6,0,111,105,6
9595,E02003491,2014,33,274000,265000,1,24,5,3,0,33,30,3
9596,E02003492,2009,39,178000,175000,1,21,15,2,0,39,37,2
9597,E02003492,2010,42,191000,202000,4,23,11,4,0,42,39,3
9598,E02003492,2011,40,190000,194000,0,24,13,3,0,40,38,2
9599,E02003492,2012,35,207000,212000,1,20,13,1,0,35,34,1
9600,E02003492,2013,45,216000,230000,1,26,13,5,0,45,40,5
9601,E02003492,2014,17,237000,230000,0,6,11,0,1,16,17,0
9602,E02003493,2009,120,286000,270000,42,38,5,35,0,120,85,35
9603,E02003493,2010,120,332000,329000,45,37,4,34,0,120,87,33
9604,E02003493,2011,128,314000,299000,45,38,4,41,0,128,87,41
9605,E02003493,2012,115,330000,320000,53,30,6,26,0,115,89,26
9606,E02003493,2013,152,328000,306000,53,38,6,55,0,152,96,56
9607,E02003493,2014,66,376000,339000,27,15,2,22,1,65,44,22
9608,E02003494,2009,90,290000,231000,15,52,13,10,0,90,83,7
9609,E02003494,2010,89,339000,295000,21,33,18,17,0,89,71,18
9610,E02003494,2011,90,326000,260000,15,39,15,21,0,90,69,21
9611,E02003494,2012,110,373000,300000,28,57,16,9,0,110,99,11
9612,E02003494,2013,108,349000,266000,16,55,11,26,0,108,86,22
9613,E02003494,2014,39,412000,382000,11,13,6,9,0,39,33,6
9614,E02003495,2009,94,188000,184000,18,51,20,5,0,94,85,9
9615,E02003495,2010,83,206000,195000,12,46,24,1,0,83,76,7
9616,E02003495,2011,79,203000,195000,13,39,24,3,0,79,73,6
9617,E02003495,2012,79,204000,200000,8,41,24,6,5,74,71,8
9618,E02003495,2013,110,213000,209000,18,49,39,4,0,110,96,14
9619,E02003495,2014,25,222000,230000,5,14,6,0,0,25,24,1
9620,E02003496,2009,79,195000,190000,12,36,4,27,0,79,49,30
9621,E02003496,2010,67,244000,229000,16,30,6,15,0,67,48,19
9622,E02003496,2011,85,243000,249000,24,38,1,22,0,85,62,23
9623,E02003496,2012,73,239000,237000,14,33,5,21,0,73,51,22
9624,E02003496,2013,96,267000,275000,26,42,5,23,0,96,71,25
9625,E02003496,2014,25,283000,295000,6,12,1,6,0,25,19,6
9626,E02003497,2009,90,440000,320000,34,38,6,12,2,88,78,12
9627,E02003497,2010,90,499000,445000,53,28,1,8,2,88,82,8
9628,E02003497,2011,101,521000,425000,48,28,1,24,1,100,77,24
9629,E02003497,2012,110,493000,411000,44,45,1,20,2,108,90,20
9630,E02003497,2013,108,537000,429000,51,40,3,14,3,105,94,14
9631,E02003497,2014,45,509000,440000,17,16,1,11,0,45,34,11
9632,E02003498,2009,76,181000,182000,4,12,30,30,0,76,48,28
9633,E02003498,2010,58,207000,201000,1,8,35,14,0,58,44,14
9634,E02003498,2011,62,220000,216000,1,15,32,14,0,62,48,14
9635,E02003498,2012,66,221000,220000,1,16,35,14,0,66,52,14
9636,E02003498,2013,72,219000,221000,2,7,42,21,0,72,50,22
9637,E02003498,2014,21,264000,280000,1,4,10,6,0,21,15,6
9638,E02003499,2009,44,174000,175000,0,30,10,4,2,42,40,4
9639,E02003499,2010,55,193000,197000,4,34,14,3,0,55,51,4
9640,E02003499,2011,56,194000,199000,1,37,14,4,0,56,52,4
9641,E02003499,2012,43,205000,205000,2,32,9,0,0,43,41,2
9642,E02003499,2013,58,200000,214000,4,31,14,9,0,58,47,11
9643,E02003499,2014,29,223000,224000,0,21,6,2,0,29,27,2
9644,E02003500,2009,116,297000,280000,6,11,75,24,0,116,91,25
9645,E02003500,2010,137,330000,332000,8,8,91,30,0,137,105,32
9646,E02003500,2011,142,323000,306000,5,16,89,32,0,142,111,31
9647,E02003500,2012,106,337000,311000,6,11,68,21,1,105,83,23
9648,E02003500,2013,154,363000,360000,4,11,105,34,0,154,120,34
9649,E02003500,2014,43,352000,325000,0,5,29,9,0,43,33,10
9650,E02003501,2009,139,318000,240000,29,15,26,69,4,135,69,70
9651,E02003501,2010,159,358000,270000,30,12,44,73,2,157,84,75
9652,E02003501,2011,151,336000,266000,29,16,36,70,3,148,81,70
9653,E02003501,2012,136,369000,289000,35,7,32,62,1,135,70,66
9654,E02003501,2013,170,399000,336000,31,22,39,78,1,169,90,80
9655,E02003501,2014,57,394000,310000,12,3,13,29,0,57,28,29
9656,E02003502,2009,97,181000,175000,4,28,55,10,0,97,87,10
9657,E02003502,2010,79,190000,192000,2,20,41,16,1,78,61,18
9658,E02003502,2011,94,198000,197000,6,35,42,11,0,94,80,14
9659,E02003502,2012,91,199000,205000,3,32,44,12,0,91,77,14
9660,E02003502,2013,97,216000,215000,6,35,43,13,0,97,82,15
9661,E02003502,2014,45,218000,226000,3,12,21,9,0,45,36,9
9662,E02003503,2009,85,230000,232000,10,47,18,10,0,85,75,10
9663,E02003503,2010,93,266000,250000,10,53,17,13,0,93,81,12
9664,E02003503,2011,103,262000,250000,15,58,17,13,0,103,89,14
9665,E02003503,2012,111,269000,250000,20,64,17,10,0,111,101,10
9666,E02003503,2013,95,270000,267000,12,62,11,10,0,95,85,10
9667,E02003503,2014,39,305000,310000,3,27,5,4,0,39,35,4
9668,E02003504,2009,121,234000,183000,0,10,32,79,0,121,41,80
9669,E02003504,2010,158,286000,230000,3,10,50,95,0,158,60,98
9670,E02003504,2011,169,279000,222000,7,17,38,107,6,163,57,112
9671,E02003504,2012,166,277000,225000,1,11,48,106,1,165,58,108
9672,E02003504,2013,183,282000,215000,2,12,44,125,6,177,55,128
9673,E02003504,2014,78,339000,238000,2,12,14,50,2,76,27,51
9674,E02003505,2009,127,193000,175000,1,7,50,69,2,125,55,72
9675,E02003505,2010,150,220000,205000,0,1,71,78,3,147,70,80
9676,E02003505,2011,128,231000,210000,0,2,60,66,1,127,60,68
9677,E02003505,2012,134,227000,198000,0,3,51,80,0,134,52,82
9678,E02003505,2013,135,244000,215000,0,3,56,76,1,134,58,77
9679,E02003505,2014,47,268000,242000,1,0,18,28,0,47,20,27
9680,E02003506,2009,141,250000,250000,5,20,86,30,3,138,109,32
9681,E02003506,2010,122,284000,302000,3,14,79,26,1,121,97,25
9682,E02003506,2011,114,277000,292000,2,18,68,26,0,114,87,27
9683,E02003506,2012,143,298000,312000,2,11,105,25,0,143,115,28
9684,E02003506,2013,173,302000,321000,2,17,105,49,0,173,124,49
9685,E02003506,2014,43,319000,345000,0,1,31,11,0,43,32,11
9686,E02003507,2009,108,221000,211000,50,39,17,2,2,106,106,2
9687,E02003507,2010,111,246000,246000,48,34,25,4,0,111,106,5
9688,E02003507,2011,121,248000,248000,57,34,24,6,3,118,115,6
9689,E02003507,2012,108,247000,245000,48,34,23,3,2,106,105,3
9690,E02003507,2013,120,261000,250000,61,27,29,3,1,119,116,4
9691,E02003507,2014,49,273000,250000,19,17,13,0,0,49,49,0
9692,E02003508,2009,138,212000,206000,3,7,96,32,0,138,107,31
9693,E02003508,2010,146,247000,250000,1,4,113,28,9,137,115,31
9694,E02003508,2011,148,249000,246000,0,7,110,31,0,148,115,33
9695,E02003508,2012,139,243000,237000,1,7,87,44,10,129,93,46
9696,E02003508,2013,148,251000,247000,3,5,90,50,2,146,99,49
9697,E02003508,2014,57,254000,250000,0,1,39,17,0,57,40,17
9698,E02003509,2009,126,237000,212000,3,5,28,90,1,125,35,91
9699,E02003509,2010,164,259000,232000,3,12,32,117,4,160,44,120
9700,E02003509,2011,166,259000,214000,6,11,25,124,1,165,41,125
9701,E02003509,2012,172,269000,244000,4,6,37,125,3,169,44,128
9702,E02003509,2013,200,273000,224000,4,12,26,158,1,199,36,164
9703,E02003509,2014,80,326000,265000,3,2,16,59,2,78,20,60
9704,E02003510,2009,159,246000,190000,5,11,18,125,5,154,32,127
9705,E02003510,2010,176,281000,235000,3,15,23,135,2,174,38,138
9706,E02003510,2011,185,270000,210000,3,10,29,143,0,185,43,142
9707,E02003510,2012,171,281000,235000,2,9,19,141,0,171,28,143
9708,E02003510,2013,182,289000,244000,4,11,24,143,0,182,36,146
9709,E02003510,2014,73,292000,235000,3,1,6,63,0,73,11,62
9710,E02003511,2009,124,265000,210000,10,34,46,34,0,124,88,36
9711,E02003511,2010,114,301000,238000,7,28,41,38,1,113,75,39
9712,E02003511,2011,135,281000,250000,19,41,39,36,0,135,98,37
9713,E02003511,2012,127,331000,260000,6,48,40,33,1,126,92,35
9714,E02003511,2013,166,290000,250000,9,49,58,50,7,159,112,54
9715,E02003511,2014,41,303000,250000,1,15,9,16,0,41,23,18
9716,E02003512,2009,124,218000,228000,1,3,87,33,0,124,91,33
9717,E02003512,2010,149,262000,250000,1,3,100,45,0,149,104,45
9718,E02003512,2011,155,245000,250000,1,2,103,49,1,154,104,51
9719,E02003512,2012,126,283000,276000,0,1,89,36,0,126,90,36
9720,E02003512,2013,152,268000,270000,0,2,88,62,0,152,88,64
9721,E02003512,2014,48,278000,284000,0,1,31,16,0,48,30,18
9722,E02003513,2009,126,307000,250000,11,27,15,73,24,102,54,72
9723,E02003513,2010,104,340000,250000,10,25,16,53,4,100,48,56
9724,E02003513,2011,107,373000,295000,12,36,13,46,0,107,58,49
9725,E02003513,2012,100,362000,260000,10,32,5,53,0,100,46,54
9726,E02003513,2013,128,375000,286000,16,30,8,74,0,128,54,74
9727,E02003513,2014,42,422000,290000,2,15,2,23,0,42,19,23
9728,E02003514,2009,149,247000,190000,6,10,20,113,2,147,34,115
9729,E02003514,2010,185,248000,200000,0,7,29,149,0,185,32,153
9730,E02003514,2011,174,257000,210000,3,6,24,141,0,174,32,142
9731,E02003514,2012,172,248000,200000,2,4,20,146,1,171,23,149
9732,E02003514,2013,235,265000,222000,1,2,27,205,42,193,27,208
9733,E02003514,2014,88,294000,243000,1,3,10,74,12,76,14,74
9734,E02003515,2009,41,179000,174000,4,21,5,11,0,41,31,10
9735,E02003515,2010,39,202000,195000,2,14,14,9,7,32,30,9
9736,E02003515,2011,55,190000,190000,1,24,19,11,0,55,43,12
9737,E02003515,2012,36,197000,206000,1,17,10,8,0,36,29,7
9738,E02003515,2013,49,204000,211000,3,25,11,10,0,49,39,10
9739,E02003515,2014,10,231000,240000,0,5,4,1,0,10,9,1
9740,E02003516,2009,162,228000,199000,1,4,12,145,0,162,16,146
9741,E02003516,2010,221,244000,222000,5,2,6,208,0,221,12,209
9742,E02003516,2011,192,231000,208000,0,5,8,179,1,191,12,180
9743,E02003516,2012,197,236000,220000,0,1,7,189,3,194,7,190
9744,E02003516,2013,228,274000,240000,3,5,6,214,2,226,13,215
9745,E02003516,2014,79,286000,245000,1,1,5,72,1,78,9,70
9746,E02003517,2009,192,234000,200000,2,7,73,110,48,144,77,115
9747,E02003517,2010,237,269000,250000,1,6,87,143,69,168,92,145
9748,E02003517,2011,187,294000,250000,4,10,71,102,2,185,87,100
9749,E02003517,2012,140,293000,281000,3,3,71,63,1,139,79,61
9750,E02003517,2013,178,322000,286000,0,3,81,94,7,171,82,96
9751,E02003517,2014,65,313000,305000,0,3,28,34,1,64,31,34
9752,E02003518,2009,192,239000,201000,3,10,13,166,8,184,26,166
9753,E02003518,2010,174,310000,234000,6,16,5,147,6,168,25,149
9754,E02003518,2011,209,312000,231000,9,16,9,175,5,204,30,179
9755,E02003518,2012,216,314000,249000,4,19,10,183,13,203,31,185
9756,E02003518,2013,208,328000,248000,9,15,5,179,4,204,30,178
9757,E02003518,2014,84,331000,245000,1,9,2,72,0,84,11,73
9758,E02003519,2009,153,242000,213000,1,0,14,138,13,140,15,138
9759,E02003519,2010,156,260000,225000,1,2,25,128,0,156,25,131
9760,E02003519,2011,165,248000,215000,1,2,21,141,1,164,21,144
9761,E02003519,2012,188,243000,220000,0,1,17,170,1,187,20,168
9762,E02003519,2013,186,245000,214000,0,0,18,168,1,185,15,171
9763,E02003519,2014,80,279000,245000,0,2,6,72,0,80,8,72
9764,E02003520,2009,124,215000,176000,2,3,30,89,0,124,36,88
9765,E02003520,2010,153,257000,216000,3,6,47,97,5,148,55,98
9766,E02003520,2011,111,247000,196000,1,2,36,72,2,109,39,72
9767,E02003520,2012,138,246000,196000,1,6,33,98,1,137,37,101
9768,E02003520,2013,155,274000,225000,0,2,46,107,1,154,47,108
9769,E02003520,2014,56,239000,236000,0,1,13,42,0,56,14,42
9770,E02003521,2009,181,246000,220000,3,2,51,125,3,178,55,126
9771,E02003521,2010,178,270000,240000,1,4,52,121,0,178,56,122
9772,E02003521,2011,162,264000,219000,2,2,48,110,4,158,44,118
9773,E02003521,2012,173,287000,230000,0,3,54,116,4,169,54,119
9774,E02003521,2013,165,304000,250000,0,2,41,122,1,164,43,122
9775,E02003521,2014,61,351000,277000,0,0,19,42,1,60,18,43
9776,E02003522,2009,134,270000,222000,2,5,27,100,0,134,34,100
9777,E02003522,2010,175,300000,250000,9,15,33,118,2,173,57,118
9778,E02003522,2011,155,329000,250000,12,20,22,101,0,155,55,100
9779,E02003522,2012,144,312000,240000,7,9,30,98,0,144,43,101
9780,E02003522,2013,180,340000,280000,5,11,43,121,5,175,58,122
9781,E02003522,2014,65,371000,280000,3,7,12,43,0,65,22,43
9782,E02003523,2009,199,247000,225000,83,37,8,71,36,163,129,70
9783,E02003523,2010,207,322000,285000,105,39,12,51,24,183,156,51
9784,E02003523,2011,180,322000,280000,85,39,12,44,16,164,136,44
9785,E02003523,2012,197,322000,275000,101,39,7,50,7,190,148,49
9786,E02003523,2013,196,320000,275000,110,39,11,36,8,188,159,37
9787,E02003523,2014,81,305000,285000,39,10,3,29,0,81,52,29
9788,E02003524,2009,40,110000,116000,0,12,26,2,0,40,37,3
9789,E02003524,2010,45,115000,118000,0,11,32,2,0,45,43,2
9790,E02003524,2011,32,118000,118000,1,13,15,3,0,32,29,3
9791,E02003524,2012,68,118000,121000,2,32,34,0,0,68,67,1
9792,E02003524,2013,61,120000,122000,1,22,35,3,0,61,58,3
9793,E02003524,2014,17,130000,132000,0,4,13,0,0,17,17,0
9794,E02003525,2009,35,117000,120000,0,10,18,7,0,35,27,8
9795,E02003525,2010,28,117000,117000,0,12,9,7,0,28,21,7
9796,E02003525,2011,49,125000,127000,0,18,22,9,0,49,41,8
9797,E02003525,2012,39,126000,131000,0,13,12,14,7,32,25,14
9798,E02003525,2013,41,129000,125000,0,20,9,12,0,41,28,13
9799,E02003525,2014,23,144000,140000,1,9,7,6,2,21,17,6
9800,E02003526,2009,97,239000,220000,32,30,7,28,16,81,69,28
9801,E02003526,2010,92,255000,235000,32,30,11,19,11,81,73,19
9802,E02003526,2011,80,243000,224000,23,27,6,24,7,73,57,23
9803,E02003526,2012,66,271000,254000,28,17,7,14,0,66,52,14
9804,E02003526,2013,104,275000,250000,35,44,8,17,0,104,87,17
9805,E02003526,2014,36,261000,250000,9,16,4,7,1,35,29,7
9806,E02003527,2009,20,143000,142000,0,7,13,0,0,20,20,0
9807,E02003527,2010,16,165000,185000,0,3,12,1,7,9,15,1
9808,E02003527,2011,27,134000,130000,0,8,15,4,1,26,22,5
9809,E02003527,2012,18,175000,176000,0,5,13,0,6,12,18,0
9810,E02003527,2013,24,144000,148000,0,3,16,5,1,23,19,5
9811,E02003527,2014,10,157000,153000,0,2,5,3,0,10,7,3
9812,E02003529,2009,97,169000,172000,2,20,62,13,0,97,84,13
9813,E02003529,2010,113,178000,181000,2,23,68,20,9,104,93,20
9814,E02003529,2011,148,169000,170000,3,28,78,39,35,113,110,38
9815,E02003529,2012,119,168000,166000,1,17,64,37,27,92,83,36
9816,E02003529,2013,134,172000,177000,3,17,73,41,17,117,93,41
9817,E02003529,2014,34,168000,175000,0,7,17,10,0,34,23,11
9818,E02003530,2009,7,150000,138000,0,2,2,3,0,7,4,3
9819,E02003530,2010,21,145000,120000,0,6,4,11,0,21,10,11
9820,E02003530,2011,30,131000,124000,0,5,2,23,18,12,7,23
9821,E02003530,2012,58,149000,136000,1,17,14,26,28,30,32,26
9822,E02003530,2013,19,154000,154000,1,6,8,4,2,17,15,4
9823,E02003530,2014,5,174000,170000,0,3,1,1,0,5,4,1
9824,E02003531,2009,29,166000,161000,4,8,14,3,0,29,26,3
9825,E02003531,2010,32,185000,160000,7,3,17,5,0,32,27,5
9826,E02003531,2011,27,175000,152000,7,5,15,0,0,27,27,0
9827,E02003531,2012,37,186000,176000,8,6,22,1,0,37,36,1
9828,E02003531,2013,41,169000,158000,9,6,22,4,0,41,37,4
9829,E02003531,2014,13,172000,160000,2,0,9,2,0,13,11,2
9830,E02003599,2009,86,159000,152000,23,27,30,6,5,81,75,11
9831,E02003599,2010,81,177000,175000,20,23,37,1,0,81,78,3
9832,E02003599,2011,68,158000,152000,15,20,29,4,0,68,62,6
9833,E02003599,2012,59,180000,180000,19,17,22,1,0,59,57,2
9834,E02003599,2013,90,180000,172000,26,19,44,1,0,90,88,2
9835,E02003599,2014,34,203000,196000,15,8,10,1,0,34,32,2
9836,E02003600,2009,70,178000,150000,17,19,31,3,7,63,67,3
9837,E02003600,2010,83,192000,170000,25,27,23,8,1,82,75,8
9838,E02003600,2011,89,173000,150000,11,29,38,11,1,88,76,13
9839,E02003600,2012,79,156000,145000,10,27,29,13,0,79,65,14
9840,E02003600,2013,97,194000,170000,21,31,36,9,3,94,87,10
9841,E02003600,2014,44,173000,156000,8,11,18,7,0,44,37,7
9842,E02003601,2009,93,214000,185000,33,31,22,7,1,92,86,7
9843,E02003601,2010,101,222000,190000,30,30,30,11,0,101,89,12
9844,E02003601,2011,85,240000,202000,28,26,28,3,0,85,78,7
9845,E02003601,2012,87,220000,190000,25,33,25,4,10,77,82,5
9846,E02003601,2013,151,241000,227000,53,50,42,6,19,132,142,9
9847,E02003601,2014,59,238000,212000,22,19,14,4,1,58,56,3
9848,E02003602,2009,64,275000,230000,30,20,13,1,5,59,64,0
9849,E02003602,2010,54,288000,250000,30,17,3,4,1,53,51,3
9850,E02003602,2011,51,289000,250000,32,12,6,1,0,51,50,1
9851,E02003602,2012,54,254000,225000,25,15,13,1,1,53,53,1
9852,E02003602,2013,74,273000,242000,32,21,18,3,11,63,71,3
9853,E02003602,2014,29,330000,281000,14,7,7,1,6,23,28,1
9854,E02003603,2009,177,162000,156000,17,56,64,40,31,146,136,41
9855,E02003603,2010,185,168000,158000,18,49,67,51,21,164,133,52
9856,E02003603,2011,150,175000,161000,27,46,61,16,2,148,130,20
9857,E02003603,2012,169,168000,150000,21,40,85,23,6,163,144,25
9858,E02003603,2013,196,172000,162000,34,50,83,29,1,195,162,34
9859,E02003603,2014,65,190000,180000,11,16,30,8,1,64,58,7
9860,E02003604,2009,67,177000,164000,16,25,20,6,1,66,61,6
9861,E02003604,2010,105,224000,219000,38,39,24,4,41,64,104,1
9862,E02003604,2011,192,216000,201000,72,57,47,16,99,93,175,17
9863,E02003604,2012,233,218000,210000,68,86,65,14,143,90,224,9
9864,E02003604,2013,249,219000,215000,77,93,45,34,138,111,219,30
9865,E02003604,2014,47,230000,232000,21,16,4,6,16,31,42,5
9866,E02003605,2009,106,246000,188000,41,40,25,0,13,93,106,0
9867,E02003605,2010,95,317000,235000,36,33,23,3,6,89,93,2
9868,E02003605,2011,83,307000,215000,33,31,19,0,0,83,83,0
9869,E02003605,2012,85,346000,248000,40,25,17,3,1,84,83,2
9870,E02003605,2013,87,272000,218000,30,37,18,2,3,84,85,2
9871,E02003605,2014,33,318000,245000,14,11,7,1,0,33,32,1
9872,E02003606,2009,65,270000,235000,33,22,10,0,1,64,65,0
9873,E02003606,2010,102,274000,249000,48,30,23,1,19,83,100,2
9874,E02003606,2011,73,320000,235000,35,23,14,1,0,73,72,1
9875,E02003606,2012,100,301000,250000,55,17,27,1,1,99,99,1
9876,E02003606,2013,125,335000,310000,67,29,27,2,12,113,122,3
9877,E02003606,2014,29,336000,315000,12,12,5,0,4,25,29,0
9878,E02003607,2009,84,256000,184000,26,33,18,7,1,83,75,9
9879,E02003607,2010,114,244000,191000,40,38,27,9,0,114,102,12
9880,E02003607,2011,121,262000,198000,33,36,39,13,2,119,104,17
9881,E02003607,2012,139,238000,200000,36,33,55,15,21,118,126,13
9882,E02003607,2013,186,282000,220000,56,67,50,13,56,130,174,12
9883,E02003607,2014,70,258000,217000,22,18,22,8,18,52,62,8
9884,E02003608,2009,189,222000,205000,71,46,68,4,39,150,180,9
9885,E02003608,2010,190,213000,195000,52,53,73,12,32,158,174,16
9886,E02003608,2011,156,203000,178000,31,46,70,9,9,147,148,8
9887,E02003608,2012,127,206000,190000,29,39,50,9,3,124,118,9
9888,E02003608,2013,200,223000,200000,50,59,79,12,5,195,183,17
9889,E02003608,2014,69,227000,215000,19,15,26,9,0,69,59,10
9890,E02003609,2009,135,207000,187000,36,29,40,30,42,93,105,30
9891,E02003609,2010,95,230000,195000,30,26,28,11,6,89,84,11
9892,E02003609,2011,148,234000,208000,39,45,55,9,32,116,138,10
9893,E02003609,2012,127,247000,235000,38,41,43,5,36,91,123,4
9894,E02003609,2013,224,254000,235000,82,55,78,9,70,154,216,8
9895,E02003609,2014,83,288000,235000,34,13,28,8,24,59,75,8
9896,E02003610,2009,101,219000,195000,30,27,34,10,5,96,90,11
9897,E02003610,2010,138,269000,231000,40,36,45,17,7,131,119,19
9898,E02003610,2011,184,244000,227000,59,47,54,24,63,121,151,33
9899,E02003610,2012,150,262000,237000,61,21,48,20,48,102,126,24
9900,E02003610,2013,157,286000,243000,56,42,43,16,21,136,139,18
9901,E02003610,2014,74,282000,242000,23,20,26,5,7,67,69,5
9902,E02003611,2009,106,227000,195000,38,38,27,3,8,98,102,4
9903,E02003611,2010,94,255000,230000,41,30,22,1,1,93,92,2
9904,E02003611,2011,93,255000,240000,37,31,21,4,9,84,89,4
9905,E02003611,2012,106,269000,243000,51,27,27,1,8,98,102,4
9906,E02003611,2013,155,234000,215000,42,51,57,5,27,128,146,9
9907,E02003611,2014,54,251000,231000,18,15,21,0,3,51,53,1
9908,E02003612,2009,232,237000,220000,72,77,53,30,105,127,204,28
9909,E02003612,2010,259,259000,238000,81,75,60,43,128,131,218,41
9910,E02003612,2011,251,253000,237000,91,73,72,15,108,143,240,11
9911,E02003612,2012,222,259000,248000,86,59,59,18,88,134,203,19
9912,E02003612,2013,275,250000,242000,86,85,77,27,88,187,251,24
9913,E02003612,2014,84,270000,250000,26,24,22,12,13,71,71,13
9914,E02003613,2009,98,198000,181000,32,24,20,22,8,90,75,23
9915,E02003613,2010,71,222000,217000,20,29,21,1,4,67,70,1
9916,E02003613,2011,76,207000,199000,23,33,14,6,7,69,67,9
9917,E02003613,2012,93,205000,200000,30,29,20,14,9,84,77,16
9918,E02003613,2013,104,243000,242000,52,20,23,9,4,100,95,9
9919,E02003613,2014,22,226000,205000,5,8,5,4,0,22,18,4
9920,E02003614,2009,130,187000,165000,24,58,42,6,4,126,121,9
9921,E02003614,2010,117,205000,178000,28,39,45,5,2,115,112,5
9922,E02003614,2011,105,206000,176000,24,38,38,5,0,105,100,5
9923,E02003614,2012,108,191000,170000,26,36,45,1,0,108,106,2
9924,E02003614,2013,131,197000,182000,25,45,53,8,0,131,123,8
9925,E02003614,2014,43,207000,200000,13,17,11,2,1,42,41,2
9926,E02003615,2009,144,273000,230000,53,50,31,10,36,108,133,11
9927,E02003615,2010,141,316000,268000,73,40,19,9,29,112,132,9
9928,E02003615,2011,137,301000,249000,52,55,22,8,32,105,129,8
9929,E02003615,2012,139,295000,250000,64,31,38,6,29,110,132,7
9930,E02003615,2013,243,287000,250000,84,68,77,14,91,152,228,15
9931,E02003615,2014,85,322000,275000,39,21,22,3,35,50,81,4
9932,E02003616,2009,64,258000,211000,36,12,14,2,7,57,62,2
9933,E02003616,2010,75,295000,231000,46,15,14,0,2,73,74,1
9934,E02003616,2011,59,326000,278000,37,10,11,1,1,58,57,2
9935,E02003616,2012,60,278000,242000,29,19,12,0,2,58,60,0
9936,E02003616,2013,76,322000,250000,38,15,21,2,0,76,74,2
9937,E02003616,2014,32,282000,222000,16,7,5,4,1,31,28,4
9938,E02003617,2009,88,292000,246000,45,25,14,4,2,86,85,3
9939,E02003617,2010,132,312000,264000,74,43,10,5,2,130,125,7
9940,E02003617,2011,100,275000,225000,46,34,18,2,2,98,98,2
9941,E02003617,2012,94,292000,250000,43,32,19,0,0,94,93,1
9942,E02003617,2013,90,309000,273000,44,30,14,2,4,86,89,1
9943,E02003617,2014,43,327000,265000,22,13,4,4,1,42,39,4
9944,E02003618,2009,115,218000,172000,42,53,20,0,3,112,115,0
9945,E02003618,2010,94,247000,187000,33,40,20,1,5,89,93,1
9946,E02003618,2011,105,228000,194000,40,36,26,3,0,105,101,4
9947,E02003618,2012,109,220000,185000,34,51,24,0,0,109,107,2
9948,E02003618,2013,153,234000,185000,47,66,38,2,17,136,152,1
9949,E02003618,2014,45,241000,199000,18,14,13,0,6,39,45,0
9950,E02003619,2009,214,260000,244000,124,50,37,3,107,107,205,9
9951,E02003619,2010,189,271000,241000,97,49,38,5,101,88,180,9
9952,E02003619,2011,196,280000,234000,108,61,22,5,89,107,190,6
9953,E02003619,2012,195,255000,210000,86,74,34,1,82,113,194,1
9954,E02003619,2013,194,268000,225000,86,49,56,3,49,145,191,3
9955,E02003619,2014,69,281000,210000,26,22,20,1,21,48,69,0
9956,E02003620,2009,90,172000,161000,30,39,17,4,0,90,85,5
9957,E02003620,2010,99,209000,190000,39,36,18,6,0,99,93,6
9958,E02003620,2011,95,228000,203000,45,35,11,4,0,95,91,4
9959,E02003620,2012,96,209000,178000,37,33,21,5,0,96,91,5
9960,E02003620,2013,103,220000,200000,48,32,18,5,1,102,98,5
9961,E02003620,2014,38,250000,221000,19,15,3,1,0,38,37,1
9962,E02003621,2009,97,191000,175000,23,59,15,0,0,97,97,0
9963,E02003621,2010,97,239000,200000,43,40,13,1,1,96,96,1
9964,E02003621,2011,88,224000,208000,34,41,13,0,0,88,88,0
9965,E02003621,2012,85,246000,195000,30,48,7,0,2,83,85,0
9966,E02003621,2013,109,234000,208000,46,57,6,0,1,108,109,0
9967,E02003621,2014,30,242000,197000,11,13,6,0,0,30,30,0
9968,E02003622,2009,89,154000,145000,17,31,30,11,0,89,79,10
9969,E02003622,2010,85,159000,152000,17,26,33,9,0,85,77,8
9970,E02003622,2011,103,161000,155000,27,40,29,7,0,103,96,7
9971,E02003622,2012,86,172000,172000,18,36,28,4,0,86,82,4
9972,E02003622,2013,92,165000,158000,17,32,34,9,0,92,83,9
9973,E02003622,2014,28,173000,169000,5,11,6,6,0,28,22,6
9974,E02003623,2009,137,246000,200000,56,40,31,10,26,111,127,10
9975,E02003623,2010,206,268000,235000,75,52,57,22,91,115,186,20
9976,E02003623,2011,171,279000,224000,80,33,30,28,61,110,145,26
9977,E02003623,2012,169,308000,248000,83,48,34,4,52,117,166,3
9978,E02003623,2013,210,298000,246000,102,55,49,4,74,136,208,2
9979,E02003623,2014,61,319000,250000,30,17,9,5,12,49,54,7
9980,E02003624,2009,66,193000,156000,13,18,8,27,0,66,38,28
9981,E02003624,2010,70,234000,162000,11,24,8,27,0,70,43,27
9982,E02003624,2011,71,261000,205000,18,13,16,24,0,71,47,24
9983,E02003624,2012,70,247000,189000,17,24,6,23,2,68,47,23
9984,E02003624,2013,88,232000,213000,26,21,14,27,9,79,61,27
9985,E02003624,2014,31,263000,250000,7,11,3,10,1,30,21,10
9986,E02003625,2009,87,151000,135000,3,15,35,34,6,81,52,35
9987,E02003625,2010,104,205000,156000,18,19,26,41,14,90,64,40
9988,E02003625,2011,107,169000,140000,3,26,36,42,5,102,65,42
9989,E02003625,2012,79,174000,157000,14,14,23,28,2,77,51,28
9990,E02003625,2013,104,170000,160000,8,28,40,28,0,104,76,28
9991,E02003625,2014,43,145000,134000,5,5,12,21,0,43,22,21
9992,E02003626,2009,83,179000,170000,28,31,23,1,0,83,83,0
9993,E02003626,2010,76,198000,186000,24,28,23,1,0,76,75,1
9994,E02003626,2011,65,178000,170000,11,28,24,2,0,65,64,1
9995,E02003626,2012,82,192000,180000,21,33,27,1,0,82,81,1
9996,E02003626,2013,95,199000,188000,25,44,24,2,0,95,93,2
9997,E02003626,2014,32,201000,188000,8,8,15,1,1,31,32,0
9998,E02003627,2009,166,193000,175000,12,38,49,67,42,124,99,67
9999,E02003627,2010,124,223000,183000,15,33,47,29,5,119,94,30
10000,E02003627,2011,134,209000,191000,7,48,46,33,0,134,102,32
10001,E02003627,2012,109,192000,180000,3,29,48,29,0,109,79,30
10002,E02003627,2013,157,227000,185000,7,38,45,67,25,132,90,67
10003,E02003627,2014,78,180000,165000,2,10,18,48,31,47,29,49
10004,E02003628,2009,61,137000,130000,6,15,33,7,0,61,54,7
10005,E02003628,2010,57,143000,127000,4,17,29,7,0,57,50,7
10006,E02003628,2011,66,166000,133000,6,28,25,7,0,66,59,7
10007,E02003628,2012,47,146000,125000,4,20,17,6,0,47,41,6
10008,E02003628,2013,64,151000,130000,5,22,24,13,0,64,51,13
10009,E02003628,2014,28,140000,122000,4,7,13,4,0,28,24,4
10010,E02003629,2009,120,135000,132000,12,45,50,13,7,113,107,13
10011,E02003629,2010,109,130000,129000,7,30,49,23,0,109,84,25
10012,E02003629,2011,108,141000,133000,13,44,31,20,0,108,85,23
10013,E02003629,2012,89,147000,132000,5,32,34,18,0,89,67,22
10014,E02003629,2013,103,135000,131000,9,31,41,22,0,103,81,22
10015,E02003629,2014,45,143000,140000,4,19,14,8,0,45,37,8
10016,E02003630,2009,96,131000,130000,2,31,33,30,26,70,66,30
10017,E02003630,2010,88,133000,128000,1,18,27,42,26,62,47,41
10018,E02003630,2011,87,133000,132000,1,19,39,28,21,66,59,28
10019,E02003630,2012,89,135000,130000,5,20,39,25,18,71,64,25
10020,E02003630,2013,158,133000,129000,5,25,48,80,61,97,78,80
10021,E02003630,2014,45,142000,137000,0,15,19,11,5,40,34,11
10022,E02003631,2009,54,174000,168000,21,17,11,5,0,54,49,5
10023,E02003631,2010,57,172000,156000,17,17,16,7,5,52,50,7
10024,E02003631,2011,71,158000,142000,18,18,16,19,16,55,51,20
10025,E02003631,2012,63,172000,170000,16,13,11,23,20,43,40,23
10026,E02003631,2013,68,151000,140000,10,14,25,19,13,55,48,20
10027,E02003631,2014,22,160000,148000,2,6,12,2,2,20,20,2
10028,E02003632,2009,69,139000,138000,6,33,26,4,1,68,63,6
10029,E02003632,2010,82,151000,144000,15,28,36,3,0,82,79,3
10030,E02003632,2011,78,141000,140000,8,27,38,5,0,78,72,6
10031,E02003632,2012,71,162000,150000,21,23,26,1,0,71,70,1
10032,E02003632,2013,85,156000,144000,11,39,35,0,1,84,85,0
10033,E02003632,2014,29,162000,164000,5,12,11,1,0,29,27,2
10034,E02003633,2009,81,144000,138000,12,39,29,1,0,81,80,1
10035,E02003633,2010,97,174000,155000,19,53,21,4,23,74,93,4
10036,E02003633,2011,105,168000,149000,26,40,30,9,29,76,96,9
10037,E02003633,2012,169,188000,155000,39,69,45,16,91,78,157,12
10038,E02003633,2013,214,189000,180000,27,101,68,18,112,102,202,12
10039,E02003633,2014,66,201000,200000,17,33,15,1,30,36,65,1
10040,E02003634,2009,141,211000,205000,63,35,40,3,59,82,138,3
10041,E02003634,2010,204,209000,200000,82,65,52,5,97,107,195,9
10042,E02003634,2011,219,208000,193000,73,83,45,18,114,105,202,17
10043,E02003634,2012,211,204000,196000,55,37,88,31,125,86,183,28
10044,E02003634,2013,285,206000,205000,83,89,85,28,176,109,257,28
10045,E02003634,2014,83,211000,195000,21,33,21,8,40,43,76,7
10046,E02003635,2009,56,184000,175000,13,25,16,2,0,56,55,1
10047,E02003635,2010,65,212000,195000,32,19,13,1,0,65,64,1
10048,E02003635,2011,85,211000,204000,33,28,21,3,16,69,83,2
10049,E02003635,2012,75,222000,210000,38,22,15,0,16,59,75,0
10050,E02003635,2013,125,246000,240000,78,23,23,1,71,54,125,0
10051,E02003635,2014,31,250000,218000,16,6,7,2,4,27,29,2
10052,E02003636,2009,84,193000,175000,17,36,30,1,1,83,81,3
10053,E02003636,2010,106,218000,188000,26,52,27,1,0,106,103,3
10054,E02003636,2011,108,222000,195000,28,47,30,3,2,106,105,3
10055,E02003636,2012,93,228000,201000,27,37,29,0,0,93,92,1
10056,E02003636,2013,110,228000,201000,27,47,35,1,0,110,108,2
10057,E02003636,2014,34,230000,184000,8,9,17,0,0,34,34,0
10058,E02003637,2009,96,249000,222000,41,27,20,8,7,89,87,9
10059,E02003637,2010,154,278000,228000,66,54,31,3,22,132,150,4
10060,E02003637,2011,130,235000,196000,37,38,36,19,27,103,111,19
10061,E02003637,2012,128,267000,230000,54,37,35,2,8,120,125,3
10062,E02003637,2013,142,254000,228000,55,31,53,3,10,132,137,5
10063,E02003637,2014,51,290000,235000,22,16,11,2,13,38,49,2
10064,E02003638,2009,72,208000,157000,21,21,28,2,0,72,69,3
10065,E02003638,2010,107,240000,193000,30,42,33,2,2,105,104,3
10066,E02003638,2011,97,220000,188000,27,32,34,4,3,94,93,4
10067,E02003638,2012,99,232000,198000,27,24,48,0,24,75,99,0
10068,E02003638,2013,129,242000,205000,40,43,43,3,20,109,126,3
10069,E02003638,2014,34,249000,218000,14,6,10,4,0,34,30,4
10070,E02003639,2009,133,160000,142000,12,40,46,35,11,122,95,38
10071,E02003639,2010,214,164000,149000,34,47,58,75,87,127,134,80
10072,E02003639,2011,203,172000,151000,27,43,72,61,60,143,141,62
10073,E02003639,2012,173,161000,148000,13,32,70,58,40,133,115,58
10074,E02003639,2013,195,175000,162000,30,44,74,47,22,173,147,48
10075,E02003639,2014,66,183000,173000,10,12,20,24,0,66,42,24
10076,E02003640,2009,122,191000,160000,31,26,30,35,36,86,89,33
10077,E02003640,2010,112,196000,163000,22,32,20,38,27,85,74,38
10078,E02003640,2011,104,208000,163000,24,32,19,29,22,82,75,29
10079,E02003640,2012,96,212000,169000,17,33,28,18,5,91,79,17
10080,E02003640,2013,130,204000,175000,24,29,49,28,2,128,99,31
10081,E02003640,2014,47,221000,185000,9,9,18,11,0,47,36,11
10082,E02003641,2009,78,185000,183000,22,23,26,7,0,78,70,8
10083,E02003641,2010,73,215000,198000,22,22,21,8,0,73,67,6
10084,E02003641,2011,76,196000,185000,16,22,28,10,0,76,67,9
10085,E02003641,2012,76,204000,192000,20,17,27,12,0,76,66,10
10086,E02003641,2013,100,220000,215000,34,16,40,10,0,100,90,10
10087,E02003641,2014,24,218000,216000,5,7,12,0,0,24,24,0
10088,E02003642,2009,61,118000,122000,3,16,37,5,0,61,56,5
10089,E02003642,2010,55,123000,125000,2,16,34,3,0,55,51,4
10090,E02003642,2011,60,121000,123000,2,10,46,2,0,60,57,3
10091,E02003642,2012,68,124000,125000,1,11,54,2,0,68,64,4
10092,E02003642,2013,103,126000,128000,3,18,77,5,0,103,97,6
10093,E02003642,2014,40,132000,134000,0,4,32,4,0,40,36,4
10094,E02003643,2009,177,180000,170000,37,65,62,13,42,135,163,14
10095,E02003643,2010,228,197000,196000,50,83,72,23,84,144,199,29
10096,E02003643,2011,252,179000,175000,47,63,84,58,120,132,190,62
10097,E02003643,2012,269,195000,190000,63,79,90,37,114,155,236,33
10098,E02003643,2013,296,200000,199000,53,87,118,38,85,211,257,39
10099,E02003643,2014,125,214000,205000,24,36,53,12,21,104,113,12
10100,E02003644,2009,73,152000,150000,9,31,28,5,0,73,67,6
10101,E02003644,2010,92,157000,150000,19,32,37,4,4,88,84,8
10102,E02003644,2011,109,156000,154000,26,34,45,4,19,90,101,8
10103,E02003644,2012,117,159000,148000,24,29,39,25,31,86,90,27
10104,E02003644,2013,143,183000,170000,31,41,60,11,32,111,132,11
10105,E02003644,2014,75,183000,172000,18,22,32,3,9,66,71,4
10106,E02003645,2009,59,161000,165000,2,41,11,5,1,58,52,7
10107,E02003645,2010,60,175000,169000,9,37,9,5,0,60,52,8
10108,E02003645,2011,72,180000,178000,6,56,7,3,0,72,67,5
10109,E02003645,2012,66,181000,180000,2,49,9,6,0,66,60,6
10110,E02003645,2013,84,185000,186000,7,57,9,11,1,83,72,12
10111,E02003645,2014,26,177000,202000,0,19,2,5,0,26,20,6
10112,E02003646,2009,85,179000,155000,18,34,23,10,0,85,72,13
10113,E02003646,2010,101,175000,165000,10,54,30,7,2,99,89,12
10114,E02003646,2011,156,172000,143000,16,55,32,53,66,90,103,53
10115,E02003646,2012,157,194000,172000,31,58,45,23,30,127,134,23
10116,E02003646,2013,151,195000,175000,18,59,54,20,41,110,134,17
10117,E02003646,2014,57,213000,185000,8,17,20,12,12,45,44,13
10118,E02003647,2009,106,158000,150000,16,28,37,25,5,101,80,26
10119,E02003647,2010,100,176000,154000,17,23,35,25,4,96,72,28
10120,E02003647,2011,87,166000,155000,12,26,24,25,5,82,61,26
10121,E02003647,2012,132,170000,154000,16,35,52,29,3,129,103,29
10122,E02003647,2013,136,170000,156000,16,27,56,37,4,132,99,37
10123,E02003647,2014,62,176000,169000,11,14,24,13,5,57,48,14
10124,E02003648,2009,66,140000,128000,2,20,12,32,26,40,32,34
10125,E02003648,2010,49,153000,150000,1,23,14,11,5,44,38,11
10126,E02003648,2011,44,155000,152000,4,18,9,13,1,43,30,14
10127,E02003648,2012,55,171000,156000,7,24,13,11,2,53,42,13
10128,E02003648,2013,92,152000,142000,5,25,22,40,27,65,50,42
10129,E02003648,2014,24,185000,176000,4,9,5,6,0,24,18,6
10130,E02003649,2009,89,190000,188000,21,41,20,7,0,89,81,8
10131,E02003649,2010,81,207000,200000,18,39,12,12,1,80,68,13
10132,E02003649,2011,79,193000,200000,24,30,15,10,0,79,68,11
10133,E02003649,2012,82,197000,202000,15,40,17,10,0,82,73,9
10134,E02003649,2013,99,207000,205000,24,31,30,14,0,99,85,14
10135,E02003649,2014,35,223000,220000,11,14,5,5,0,35,30,5
10136,E02003650,2009,82,320000,269000,37,29,12,4,0,82,76,6
10137,E02003650,2010,81,344000,330000,40,23,15,3,1,80,78,3
10138,E02003650,2011,73,383000,330000,43,18,9,3,0,73,70,3
10139,E02003650,2012,92,383000,286000,55,15,18,4,2,90,88,4
10140,E02003650,2013,90,360000,335000,47,19,24,0,2,88,88,2
10141,E02003650,2014,52,322000,282000,23,12,13,4,3,49,48,4
10142,E02003651,2009,90,254000,222000,36,36,18,0,5,85,90,0
10143,E02003651,2010,83,243000,228000,26,29,27,1,0,83,83,0
10144,E02003651,2011,87,272000,245000,33,33,19,2,0,87,85,2
10145,E02003651,2012,72,255000,240000,23,30,17,2,3,69,71,1
10146,E02003651,2013,106,271000,240000,32,47,27,0,1,105,106,0
10147,E02003651,2014,35,261000,250000,7,16,10,2,0,35,33,2
10148,E02003652,2009,119,260000,215000,48,39,28,4,3,116,114,5
10149,E02003652,2010,121,267000,240000,45,38,33,5,3,118,114,7
10150,E02003652,2011,106,264000,234000,45,24,31,6,5,101,98,8
10151,E02003652,2012,116,239000,220000,40,28,37,11,5,111,104,12
10152,E02003652,2013,194,304000,273000,93,46,50,5,80,114,188,6
10153,E02003652,2014,55,275000,265000,24,17,12,2,15,40,53,2
10154,E02003653,2009,87,197000,172000,21,24,32,10,3,84,77,10
10155,E02003653,2010,132,225000,207000,40,46,27,19,33,99,115,17
10156,E02003653,2011,127,216000,215000,37,25,44,21,46,81,109,18
10157,E02003653,2012,119,216000,205000,29,26,56,8,30,89,112,7
10158,E02003653,2013,112,216000,205000,39,23,36,14,6,106,99,13
10159,E02003653,2014,45,228000,205000,9,10,20,6,0,45,39,6
10160,E02003654,2009,65,327000,250000,36,25,3,1,0,65,63,2
10161,E02003654,2010,64,352000,295000,40,19,4,1,0,64,63,1
10162,E02003654,2011,77,348000,300000,35,32,4,6,5,72,72,5
10163,E02003654,2012,61,340000,300000,27,18,16,0,3,58,60,1
10164,E02003654,2013,89,326000,285000,51,26,10,2,5,84,86,3
10165,E02003654,2014,24,340000,318000,8,11,5,0,0,24,24,0
10166,E02003655,2009,137,284000,247000,54,49,30,4,22,115,134,3
10167,E02003655,2010,135,302000,265000,69,34,27,5,20,115,129,6
10168,E02003655,2011,111,331000,270000,62,31,17,1,4,107,111,0
10169,E02003655,2012,140,301000,250000,73,35,32,0,27,113,140,0
10170,E02003655,2013,164,304000,244000,81,45,37,1,31,133,161,3
10171,E02003655,2014,45,365000,290000,24,6,14,1,3,42,43,2
10172,E02003656,2009,77,237000,188000,24,27,20,6,0,77,71,6
10173,E02003656,2010,92,289000,228000,38,23,26,5,0,92,87,5
10174,E02003656,2011,80,280000,222000,32,17,31,0,1,79,80,0
10175,E02003656,2012,121,254000,235000,43,33,38,7,32,89,114,7
10176,E02003656,2013,147,255000,232000,44,34,60,9,39,108,138,9
10177,E02003656,2014,35,281000,245000,14,6,9,6,7,28,29,6
10178,E02003657,2009,65,308000,255000,27,28,10,0,3,62,64,1
10179,E02003657,2010,69,364000,310000,39,17,13,0,3,66,68,1
10180,E02003657,2011,69,342000,290000,30,30,8,1,1,68,67,2
10181,E02003657,2012,75,386000,322000,39,22,13,1,2,73,74,1
10182,E02003657,2013,94,363000,340000,54,26,14,0,24,70,94,0
10183,E02003657,2014,35,356000,318000,17,6,10,2,4,31,32,3
10184,E02003658,2009,78,313000,248000,30,30,17,1,3,75,76,2
10185,E02003658,2010,97,279000,248000,39,30,24,4,5,92,90,7
10186,E02003658,2011,128,299000,250000,45,45,33,5,23,105,122,6
10187,E02003658,2012,99,319000,250000,34,31,31,3,10,89,90,9
10188,E02003658,2013,115,310000,278000,41,36,34,4,5,110,108,7
10189,E02003658,2014,51,318000,240000,12,15,19,5,0,51,46,5
10190,E02003659,2009,178,262000,240000,77,62,29,10,96,82,166,12
10191,E02003659,2010,145,292000,250000,80,41,15,9,79,66,138,7
10192,E02003659,2011,154,285000,241000,63,36,42,13,77,77,140,14
10193,E02003659,2012,162,298000,230000,45,46,61,10,83,79,154,8
10194,E02003659,2013,255,286000,237000,92,61,69,33,107,148,223,32
10195,E02003659,2014,69,286000,245000,26,22,17,4,13,56,67,2
10196,E02003660,2009,124,266000,240000,54,41,29,0,12,112,123,1
10197,E02003660,2010,168,347000,310000,95,42,31,0,42,126,168,0
10198,E02003660,2011,144,300000,270000,69,42,32,1,29,115,143,1
10199,E02003660,2012,122,307000,266000,54,35,32,1,24,98,121,1
10200,E02003660,2013,191,345000,290000,85,51,52,3,25,166,189,2
10201,E02003660,2014,56,359000,298000,22,20,13,1,1,55,55,1
10202,E02003661,2009,61,277000,235000,29,23,5,4,4,57,57,4
10203,E02003661,2010,58,328000,274000,25,22,7,4,1,57,55,3
10204,E02003661,2011,59,353000,288000,27,22,9,1,0,59,59,0
10205,E02003661,2012,63,375000,310000,30,22,11,0,2,61,63,0
10206,E02003661,2013,77,336000,310000,24,30,20,3,12,65,74,3
10207,E02003661,2014,27,316000,275000,8,14,4,1,4,23,26,1
10208,E02003662,2009,94,179000,166000,15,31,36,12,0,94,80,14
10209,E02003662,2010,104,190000,164000,18,26,41,19,0,104,80,24
10210,E02003662,2011,90,199000,171000,13,18,44,15,0,90,74,16
10211,E02003662,2012,84,190000,164000,19,12,32,21,0,84,63,21
10212,E02003662,2013,107,207000,175000,24,20,39,24,0,107,83,24
10213,E02003662,2014,44,192000,180000,4,7,19,14,0,44,30,14
10214,E02003663,2009,51,150000,150000,2,24,22,3,0,51,48,3
10215,E02003663,2010,62,167000,162000,6,29,24,3,3,59,59,3
10216,E02003663,2011,97,192000,175000,30,33,19,15,50,47,83,14
10217,E02003663,2012,130,207000,203000,30,42,42,16,87,43,118,12
10218,E02003663,2013,248,218000,218000,53,88,73,34,180,68,218,30
10219,E02003663,2014,78,230000,232000,15,25,31,7,50,28,72,6
10220,E02003664,2009,85,142000,142000,0,40,28,17,0,85,67,18
10221,E02003664,2010,75,157000,158000,2,40,19,14,1,74,61,14
10222,E02003664,2011,73,155000,155000,3,30,28,12,4,69,61,12
10223,E02003664,2012,101,159000,155000,1,31,45,24,25,76,76,25
10224,E02003664,2013,124,164000,164000,3,25,69,27,29,95,97,27
10225,E02003664,2014,49,178000,181000,0,12,27,10,11,38,39,10
10226,E02003665,2009,65,186000,175000,8,27,20,10,0,65,54,11
10227,E02003665,2010,70,199000,191000,7,32,24,7,0,70,60,10
10228,E02003665,2011,90,202000,188000,15,32,37,6,0,90,85,5
10229,E02003665,2012,65,205000,187000,7,27,26,5,0,65,60,5
10230,E02003665,2013,87,202000,185000,14,24,37,12,0,87,75,12
10231,E02003665,2014,32,215000,203000,6,9,14,3,0,32,29,3
10232,E02003666,2009,117,157000,145000,6,18,37,56,29,88,57,60
10233,E02003666,2010,121,167000,162000,10,11,36,64,35,86,56,65
10234,E02003666,2011,69,161000,154000,1,14,19,35,5,64,35,34
10235,E02003666,2012,71,176000,163000,3,9,32,27,9,62,45,26
10236,E02003666,2013,101,168000,149000,4,15,48,34,3,98,67,34
10237,E02003666,2014,41,164000,160000,2,4,19,16,0,41,25,16
10238,E02003667,2009,186,176000,172000,33,65,68,20,0,186,166,20
10239,E02003667,2010,201,183000,181000,30,70,76,25,0,201,175,26
10240,E02003667,2011,173,184000,174000,33,51,69,20,0,173,153,20
10241,E02003667,2012,155,181000,174000,24,40,66,25,0,155,133,22
10242,E02003667,2013,208,190000,183000,48,41,88,31,0,208,178,30
10243,E02003667,2014,71,193000,190000,15,13,25,18,0,71,53,18
10244,E02003668,2009,110,248000,237000,34,51,16,9,0,110,102,8
10245,E02003668,2010,103,266000,248000,36,42,15,10,0,103,92,11
10246,E02003668,2011,97,264000,250000,23,51,14,9,1,96,88,9
10247,E02003668,2012,131,247000,240000,28,64,32,7,7,124,124,7
10248,E02003668,2013,109,264000,245000,27,44,27,11,0,109,98,11
10249,E02003668,2014,43,275000,265000,11,18,10,4,1,42,39,4
10250,E02003669,2009,65,136000,128000,1,25,10,29,16,49,35,30
10251,E02003669,2010,44,155000,154000,0,26,14,4,0,44,39,5
10252,E02003669,2011,68,144000,144000,1,17,2,48,35,33,19,49
10253,E02003669,2012,108,141000,140000,0,28,12,68,59,49,39,69
10254,E02003669,2013,66,153000,150000,0,35,8,23,0,66,43,23
10255,E02003669,2014,24,146000,145000,0,7,5,12,0,24,11,13
10256,E02003670,2009,139,190000,180000,22,53,43,21,28,111,117,22
10257,E02003670,2010,154,207000,215000,36,45,50,23,39,115,129,25
10258,E02003670,2011,171,215000,228000,26,50,75,20,65,106,154,17
10259,E02003670,2012,144,212000,218000,22,33,77,12,41,103,133,11
10260,E02003670,2013,182,219000,236000,41,28,90,23,40,142,160,22
10261,E02003670,2014,56,231000,210000,8,15,25,8,4,52,49,7
10262,E02003671,2009,67,153000,155000,3,29,30,5,0,67,60,7
10263,E02003671,2010,82,159000,162000,1,31,43,7,0,82,73,9
10264,E02003671,2011,70,157000,158000,1,20,44,5,0,70,65,5
10265,E02003671,2012,82,160000,157000,2,22,57,1,0,82,81,1
10266,E02003671,2013,109,187000,167000,23,17,63,6,18,91,103,6
10267,E02003671,2014,34,174000,170000,2,5,21,6,1,33,29,5
10268,E02003672,2009,141,316000,272000,66,50,17,8,12,129,132,9
10269,E02003672,2010,123,389000,340000,71,30,16,6,8,115,115,8
10270,E02003672,2011,126,368000,344000,70,31,18,7,11,115,119,7
10271,E02003672,2012,144,370000,350000,87,34,20,3,7,137,141,3
10272,E02003672,2013,155,386000,325000,77,39,27,12,5,150,143,12
10273,E02003672,2014,51,376000,315000,24,14,10,3,2,49,47,4
10274,E02003673,2009,108,318000,280000,54,36,12,6,0,108,100,8
10275,E02003673,2010,132,392000,348000,68,31,22,11,18,114,121,11
10276,E02003673,2011,105,350000,297000,41,37,18,9,8,97,96,9
10277,E02003673,2012,135,359000,315000,63,31,33,8,23,112,127,8
10278,E02003673,2013,140,384000,365000,61,34,31,14,30,110,126,14
10279,E02003673,2014,42,401000,366000,21,8,9,4,4,38,37,5
10280,E02003674,2009,77,394000,335000,40,29,6,2,6,71,74,3
10281,E02003674,2010,68,454000,411000,44,18,4,2,0,68,66,2
10282,E02003674,2011,79,435000,380000,52,18,7,2,0,79,77,2
10283,E02003674,2012,70,452000,395000,39,14,15,2,4,66,67,3
10284,E02003674,2013,73,424000,350000,42,16,10,5,0,73,68,5
10285,E02003674,2014,26,407000,340000,12,6,8,0,0,26,26,0
10286,E02003675,2009,108,292000,274000,24,45,28,11,19,89,97,11
10287,E02003675,2010,156,343000,304000,58,56,23,19,50,106,136,20
10288,E02003675,2011,135,320000,288000,40,40,29,26,47,88,109,26
10289,E02003675,2012,162,313000,285000,28,56,54,24,54,108,139,23
10290,E02003675,2013,192,317000,281000,46,54,31,61,60,132,129,63
10291,E02003675,2014,54,369000,284000,12,24,12,6,4,50,48,6
10292,E02003676,2009,74,532000,442000,44,18,7,5,1,73,67,7
10293,E02003676,2010,72,583000,497000,41,18,9,4,0,72,68,4
10294,E02003676,2011,95,562000,465000,50,32,10,3,0,95,92,3
10295,E02003676,2012,86,609000,499000,56,18,7,5,1,85,81,5
10296,E02003676,2013,85,593000,500000,42,27,9,7,2,83,78,7
10297,E02003676,2014,32,617000,582000,19,9,3,1,3,29,31,1
10298,E02003677,2009,95,263000,250000,21,41,23,10,5,90,85,10
10299,E02003677,2010,99,302000,265000,31,30,30,8,3,96,91,8
10300,E02003677,2011,126,276000,240000,32,40,34,20,4,122,106,20
10301,E02003677,2012,128,293000,267000,31,47,34,16,11,117,109,19
10302,E02003677,2013,135,297000,275000,36,41,47,11,21,114,124,11
10303,E02003677,2014,42,323000,285000,18,9,10,5,2,40,36,6
10304,E02003678,2009,64,281000,228000,16,21,16,11,6,58,53,11
10305,E02003678,2010,76,296000,242000,20,24,24,8,0,76,67,9
10306,E02003678,2011,83,299000,249000,21,19,36,7,0,83,75,8
10307,E02003678,2012,100,320000,250000,28,37,28,7,0,100,93,7
10308,E02003678,2013,109,287000,250000,19,34,38,18,0,109,91,18
10309,E02003678,2014,29,309000,273000,5,10,8,6,0,29,23,6
10310,E02003679,2009,88,211000,192000,11,21,35,21,2,86,66,22
10311,E02003679,2010,122,244000,225000,8,27,69,18,2,120,102,20
10312,E02003679,2011,111,229000,220000,10,18,39,44,14,97,67,44
10313,E02003679,2012,99,260000,234000,7,21,47,24,4,95,75,24
10314,E02003679,2013,128,256000,230000,10,27,60,31,4,124,97,31
10315,E02003679,2014,53,229000,199000,1,7,17,28,14,39,25,28
10316,E02003680,2009,133,410000,360000,67,34,22,10,0,133,120,13
10317,E02003680,2010,134,431000,349000,61,31,28,14,0,134,120,14
10318,E02003680,2011,105,462000,380000,53,26,21,5,0,105,99,6
10319,E02003680,2012,131,449000,380000,70,18,38,5,1,130,125,6
10320,E02003680,2013,162,479000,385000,78,35,33,16,2,160,144,18
10321,E02003680,2014,55,450000,405000,25,13,10,7,4,51,46,9
10322,E02003681,2009,135,390000,350000,53,32,18,32,8,127,99,36
10323,E02003681,2010,161,507000,445000,60,39,17,45,7,154,117,44
10324,E02003681,2011,179,476000,364000,62,32,46,39,46,133,138,41
10325,E02003681,2012,168,487000,398000,60,35,34,39,23,145,130,38
10326,E02003681,2013,164,501000,432000,63,29,27,45,10,154,118,46
10327,E02003681,2014,47,435000,375000,9,8,12,18,3,44,28,19
10328,E02003682,2009,102,372000,342000,30,39,17,16,1,101,85,17
10329,E02003682,2010,134,397000,345000,35,56,14,29,1,133,105,29
10330,E02003682,2011,110,446000,365000,31,41,19,19,3,107,90,20
10331,E02003682,2012,136,424000,355000,39,42,29,26,5,131,108,28
10332,E02003682,2013,142,456000,410000,43,45,31,23,9,133,118,24
10333,E02003682,2014,44,528000,430000,14,14,9,7,0,44,36,8
10334,E02003683,2009,66,610000,458000,35,10,5,16,3,63,50,16
10335,E02003683,2010,82,642000,466000,48,19,5,10,0,82,68,14
10336,E02003683,2011,76,610000,482000,49,11,7,9,10,66,67,9
10337,E02003683,2012,151,487000,400000,57,40,31,23,79,72,125,26
10338,E02003683,2013,127,477000,380000,36,40,23,28,63,64,99,28
10339,E02003683,2014,28,647000,499000,12,8,6,2,0,28,26,2
10340,E02003685,2009,99,515000,482000,69,18,9,3,2,97,95,4
10341,E02003685,2010,121,566000,500000,81,26,11,3,9,112,109,12
10342,E02003685,2011,79,648000,450000,46,18,11,4,0,79,75,4
10343,E02003685,2012,102,754000,569000,71,14,11,6,4,98,97,5
10344,E02003685,2013,119,686000,497000,68,22,16,13,3,116,104,15
10345,E02003685,2014,26,534000,454000,18,4,2,2,0,26,23,3
10346,E02003686,2009,84,478000,440000,55,14,9,6,0,84,77,7
10347,E02003686,2010,103,482000,485000,71,17,6,9,0,103,93,10
10348,E02003686,2011,88,497000,495000,56,12,12,8,0,88,79,9
10349,E02003686,2012,82,494000,482000,55,9,9,9,1,81,73,9
10350,E02003686,2013,94,503000,488000,64,10,9,11,2,92,83,11
10351,E02003686,2014,40,513000,495000,23,6,6,5,0,40,34,6
10352,E02003687,2009,59,520000,432000,36,17,2,4,0,59,56,3
10353,E02003687,2010,85,514000,400000,38,32,7,8,8,77,77,8
10354,E02003687,2011,71,545000,440000,33,23,6,9,0,71,62,9
10355,E02003687,2012,74,549000,450000,32,23,10,9,0,74,65,9
10356,E02003687,2013,83,473000,390000,25,28,18,12,7,76,71,12
10357,E02003687,2014,28,632000,487000,12,13,3,0,0,28,28,0
10358,E02003688,2009,226,605000,445000,94,56,32,44,61,165,178,48
10359,E02003688,2010,203,711000,560000,108,27,24,44,19,184,159,44
10360,E02003688,2011,192,719000,580000,83,39,33,37,20,172,153,39
10361,E02003688,2012,181,811000,635000,84,39,26,32,26,155,149,32
10362,E02003688,2013,198,753000,538000,89,40,35,34,13,185,165,33
10363,E02003688,2014,93,716000,605000,31,16,17,29,11,82,64,29
10364,E02003689,2009,117,685000,594000,60,12,11,34,31,86,82,35
10365,E02003689,2010,117,852000,788000,80,10,4,23,2,115,93,24
10366,E02003689,2011,134,892000,810000,77,16,9,32,22,112,100,34
10367,E02003689,2012,104,876000,818000,63,2,13,26,6,98,78,26
10368,E02003689,2013,164,882000,802000,94,13,13,44,29,135,120,44
10369,E02003689,2014,52,1167000,1202000,41,1,7,3,3,49,48,4
10370,E02003690,2009,75,372000,305000,29,15,5,26,4,71,46,29
10371,E02003690,2010,100,371000,332000,36,26,11,27,9,91,58,42
10372,E02003690,2011,109,384000,345000,39,25,19,26,13,96,65,44
10373,E02003690,2012,134,345000,290000,32,13,25,64,57,77,66,68
10374,E02003690,2013,159,361000,305000,25,16,18,100,74,85,56,103
10375,E02003690,2014,28,437000,362000,12,6,3,7,0,28,21,7
10376,E02003691,2009,67,422000,350000,28,10,11,18,5,62,47,20
10377,E02003691,2010,107,544000,499000,52,16,19,20,4,103,81,26
10378,E02003691,2011,70,504000,420000,36,11,9,14,1,69,54,16
10379,E02003691,2012,75,595000,565000,45,7,11,12,1,74,61,14
10380,E02003691,2013,100,527000,465000,41,11,33,15,3,97,80,20
10381,E02003691,2014,40,754000,500000,21,5,8,6,3,37,32,8
10382,E02003692,2009,92,387000,250000,28,22,7,35,25,67,56,36
10383,E02003692,2010,121,487000,367000,48,33,17,23,5,116,93,28
10384,E02003692,2011,92,451000,365000,37,24,19,12,0,92,78,14
10385,E02003692,2012,87,488000,313000,33,21,18,15,0,87,70,17
10386,E02003692,2013,125,561000,410000,59,36,14,16,0,125,108,17
10387,E02003692,2014,47,483000,385000,21,12,4,10,0,47,37,10
10388,E02003693,2009,88,422000,370000,36,11,20,21,23,65,55,33
10389,E02003693,2010,79,534000,425000,39,14,12,14,4,75,62,17
10390,E02003693,2011,92,465000,395000,48,20,12,12,17,75,77,15
10391,E02003693,2012,76,487000,446000,31,11,18,16,10,66,50,26
10392,E02003693,2013,92,512000,470000,37,21,19,15,6,86,71,21
10393,E02003693,2014,42,546000,500000,17,6,7,12,10,32,30,12
10394,E02003694,2009,74,248000,220000,19,29,10,16,2,72,58,16
10395,E02003694,2010,107,271000,245000,31,31,24,21,8,99,88,19
10396,E02003694,2011,119,270000,235000,25,36,27,31,23,96,86,33
10397,E02003694,2012,117,279000,265000,27,49,17,24,3,114,94,23
10398,E02003694,2013,119,297000,275000,24,41,30,24,15,104,96,23
10399,E02003694,2014,30,306000,292000,7,11,7,5,0,30,25,5
10400,E02003695,2009,128,352000,275000,46,43,16,23,15,113,105,23
10401,E02003695,2010,133,338000,290000,32,51,22,28,4,129,99,34
10402,E02003695,2011,120,377000,322000,34,47,25,14,0,120,101,19
10403,E02003695,2012,116,361000,322000,28,47,23,18,0,116,98,18
10404,E02003695,2013,128,384000,325000,28,46,25,29,0,128,97,31
10405,E02003695,2014,47,370000,322000,11,12,16,8,0,47,36,11
10406,E02003696,2009,101,310000,237000,29,55,12,5,0,101,94,7
10407,E02003696,2010,128,348000,284000,48,50,20,10,18,110,119,9
10408,E02003696,2011,150,339000,279000,47,55,16,32,47,103,116,34
10409,E02003696,2012,127,333000,285000,40,57,11,19,4,123,108,19
10410,E02003696,2013,133,345000,292000,45,54,17,17,5,128,118,15
10411,E02003696,2014,52,311000,269000,13,15,12,12,3,49,41,11
10412,E02003697,2009,53,513000,430000,40,10,3,0,0,53,53,0
10413,E02003697,2010,68,560000,482000,45,17,6,0,1,67,67,1
10414,E02003697,2011,50,516000,478000,37,8,5,0,0,50,50,0
10415,E02003697,2012,65,514000,474000,42,12,10,1,5,60,65,0
10416,E02003697,2013,79,506000,400000,43,16,19,1,2,77,78,1
10417,E02003697,2014,35,559000,570000,28,3,4,0,0,35,35,0
10418,E02003698,2009,99,391000,320000,57,34,6,2,6,93,97,2
10419,E02003698,2010,100,404000,359000,59,28,9,4,3,97,95,5
10420,E02003698,2011,97,387000,358000,50,29,17,1,5,92,96,1
10421,E02003698,2012,84,427000,386000,49,21,12,2,8,76,82,2
10422,E02003698,2013,138,416000,388000,80,32,18,8,3,135,129,9
10423,E02003698,2014,54,398000,384000,32,10,9,3,1,53,51,3
10424,E02003699,2009,49,303000,235000,19,11,13,6,0,49,43,6
10425,E02003699,2010,71,332000,248000,26,25,13,7,2,69,63,8
10426,E02003699,2011,65,303000,250000,18,28,11,8,1,64,58,7
10427,E02003699,2012,75,293000,239000,23,22,22,8,0,75,67,8
10428,E02003699,2013,89,348000,288000,39,22,20,8,5,84,80,9
10429,E02003699,2014,41,283000,248000,12,9,13,7,3,38,34,7
10430,E02003701,2009,148,230000,220000,29,67,40,12,45,103,133,15
10431,E02003701,2010,134,248000,234000,31,57,31,15,3,131,118,16
10432,E02003701,2011,132,235000,222000,24,51,37,20,6,126,113,19
10433,E02003701,2012,118,244000,226000,22,46,30,20,7,111,98,20
10434,E02003701,2013,169,260000,246000,28,52,65,24,30,139,146,23
10435,E02003701,2014,74,261000,240000,16,15,30,13,6,68,61,13
10436,E02003702,2009,62,587000,413000,35,20,4,3,0,62,58,4
10437,E02003702,2010,70,680000,470000,40,18,6,6,1,69,64,6
10438,E02003702,2011,98,542000,425000,53,28,9,8,4,94,90,8
10439,E02003702,2012,76,591000,445000,36,20,18,2,0,76,74,2
10440,E02003702,2013,99,579000,440000,46,26,19,8,2,97,90,9
10441,E02003702,2014,40,485000,405000,19,12,6,3,3,37,37,3
10442,E02003703,2009,91,224000,186000,20,24,10,37,0,91,55,36
10443,E02003703,2010,155,257000,225000,26,54,29,46,50,105,110,45
10444,E02003703,2011,153,277000,213000,34,31,39,49,55,98,105,48
10445,E02003703,2012,128,277000,220000,29,35,23,41,35,93,86,42
10446,E02003703,2013,155,311000,270000,40,39,38,38,38,117,115,40
10447,E02003703,2014,53,278000,221000,13,14,13,13,7,46,38,15
10448,E02003704,2009,77,344000,250000,26,24,6,21,10,67,55,22
10449,E02003704,2010,79,426000,362000,35,29,5,10,0,79,68,11
10450,E02003704,2011,70,452000,328000,24,29,8,9,0,70,60,10
10451,E02003704,2012,89,461000,370000,40,24,7,18,3,86,71,18
10452,E02003704,2013,100,454000,396000,48,29,10,13,2,98,87,13
10453,E02003704,2014,31,460000,360000,15,8,4,4,1,30,27,4
10454,E02003705,2009,60,184000,185000,5,31,12,12,1,59,47,13
10455,E02003705,2010,73,196000,200000,2,44,15,12,1,72,61,12
10456,E02003705,2011,65,192000,195000,4,38,13,10,0,65,55,10
10457,E02003705,2012,83,209000,205000,4,37,10,32,23,60,51,32
10458,E02003705,2013,83,209000,210000,5,50,15,13,2,81,68,15
10459,E02003705,2014,24,225000,222000,1,12,5,6,0,24,18,6
10460,E02003706,2009,120,185000,179000,16,36,21,47,50,70,69,51
10461,E02003706,2010,58,220000,214000,14,25,9,10,0,58,48,10
10462,E02003706,2011,67,214000,205000,9,34,13,11,4,63,56,11
10463,E02003706,2012,75,231000,220000,25,23,7,20,3,72,55,20
10464,E02003706,2013,90,214000,217000,21,26,19,24,1,89,66,24
10465,E02003706,2014,36,232000,232000,8,14,7,7,0,36,28,8
10466,E02003707,2009,81,190000,186000,9,40,12,20,7,74,56,25
10467,E02003707,2010,70,188000,180000,9,26,15,20,1,69,48,22
10468,E02003707,2011,59,208000,200000,14,25,9,11,0,59,46,13
10469,E02003707,2012,70,200000,210000,11,28,10,21,0,70,48,22
10470,E02003707,2013,98,225000,220000,15,45,17,21,4,94,74,24
10471,E02003707,2014,46,235000,247000,11,15,8,12,6,40,33,13
10472,E02003708,2009,40,147000,148000,2,18,8,12,1,39,25,15
10473,E02003708,2010,70,155000,145000,5,23,16,26,0,70,43,27
10474,E02003708,2011,82,158000,157000,6,30,9,37,9,73,45,37
10475,E02003708,2012,80,157000,165000,3,24,25,28,5,75,51,29
10476,E02003708,2013,78,164000,156000,3,21,27,27,2,76,50,28
10477,E02003708,2014,20,161000,161000,0,7,4,9,0,20,11,9
10478,E02003709,2009,39,170000,170000,2,24,6,7,0,39,33,6
10479,E02003709,2010,48,181000,185000,2,31,7,8,1,47,40,8
10480,E02003709,2011,59,188000,182000,3,39,9,8,0,59,52,7
10481,E02003709,2012,61,181000,185000,5,31,10,15,0,61,45,16
10482,E02003709,2013,62,195000,196000,4,34,14,10,1,61,53,9
10483,E02003709,2014,30,198000,205000,1,19,5,5,0,30,25,5
10484,E02003710,2009,81,240000,235000,26,22,6,27,20,61,54,27
10485,E02003710,2010,98,305000,258000,34,36,9,19,14,84,79,19
10486,E02003710,2011,153,255000,195000,41,20,15,77,80,73,76,77
10487,E02003710,2012,98,289000,244000,43,26,9,20,1,97,77,21
10488,E02003710,2013,121,276000,248000,39,43,8,31,0,121,90,31
10489,E02003710,2014,44,304000,235000,13,11,7,13,0,44,31,13
10490,E02003711,2009,151,190000,171000,7,33,25,86,53,98,63,88
10491,E02003711,2010,126,221000,191000,16,28,21,61,17,109,63,63
10492,E02003711,2011,161,214000,199000,10,44,27,80,57,104,80,81
10493,E02003711,2012,142,224000,204000,12,28,25,77,30,112,65,77
10494,E02003711,2013,208,248000,232000,14,37,64,93,55,153,113,95
10495,E02003711,2014,74,227000,199000,4,18,16,36,1,73,37,37
10496,E02003712,2009,101,228000,193000,24,30,28,19,20,81,78,23
10497,E02003712,2010,104,267000,239000,33,29,35,7,0,104,96,8
10498,E02003712,2011,65,247000,220000,20,16,25,4,0,65,60,5
10499,E02003712,2012,104,264000,226000,30,23,40,11,1,103,93,11
10500,E02003712,2013,78,261000,232000,27,14,31,6,0,78,70,8
10501,E02003712,2014,41,275000,244000,11,12,15,3,0,41,38,3
10502,E02003713,2009,59,351000,325000,36,17,5,1,0,59,57,2
10503,E02003713,2010,89,342000,325000,40,31,9,9,3,86,80,9
10504,E02003713,2011,53,346000,339000,22,21,6,4,3,50,49,4
10505,E02003713,2012,72,379000,339000,37,21,7,7,0,72,65,7
10506,E02003713,2013,106,367000,360000,52,26,20,8,0,106,98,8
10507,E02003713,2014,31,374000,375000,14,8,3,6,0,31,24,7
10508,E02003714,2009,89,256000,218000,22,29,15,23,6,83,63,26
10509,E02003714,2010,112,318000,250000,33,42,25,12,1,111,100,12
10510,E02003714,2011,80,301000,256000,14,31,24,11,1,79,68,12
10511,E02003714,2012,97,298000,277000,22,31,31,13,0,97,80,17
10512,E02003714,2013,131,322000,278000,31,43,42,15,1,130,116,15
10513,E02003714,2014,44,308000,266000,10,14,13,7,0,44,36,8
10514,E02003715,2009,60,454000,428000,40,13,6,1,1,59,57,3
10515,E02003715,2010,72,595000,492000,55,12,3,2,2,70,67,5
10516,E02003715,2011,70,563000,522000,51,9,8,2,2,68,64,6
10517,E02003715,2012,54,550000,497000,43,5,5,1,0,54,49,5
10518,E02003715,2013,80,566000,477000,60,14,6,0,2,78,79,1
10519,E02003715,2014,25,542000,430000,18,5,2,0,1,24,23,2
10520,E02003716,2009,74,338000,280000,15,25,14,20,0,74,53,21
10521,E02003716,2010,83,431000,292000,24,25,16,18,0,83,66,17
10522,E02003716,2011,69,406000,322000,20,22,16,11,2,67,57,12
10523,E02003716,2012,77,412000,320000,23,31,14,9,0,77,69,8
10524,E02003716,2013,97,478000,345000,29,24,27,17,10,87,81,16
10525,E02003716,2014,39,495000,370000,17,11,9,2,0,39,37,2
10526,E02003717,2009,136,430000,352000,54,36,20,26,15,121,109,27
10527,E02003717,2010,134,421000,346000,45,34,34,21,1,133,109,25
10528,E02003717,2011,144,479000,390000,53,34,37,20,2,142,124,20
10529,E02003717,2012,139,451000,382000,48,26,36,29,11,128,111,28
10530,E02003717,2013,176,498000,450000,60,39,45,32,16,160,143,33
10531,E02003717,2014,55,471000,435000,11,13,17,14,1,54,41,14
10532,E02003718,2009,81,383000,290000,18,25,20,18,0,81,66,15
10533,E02003718,2010,101,467000,331000,28,33,26,14,0,101,86,15
10534,E02003718,2011,87,417000,340000,17,28,26,16,1,86,69,18
10535,E02003718,2012,135,380000,305000,16,22,59,38,36,99,94,41
10536,E02003718,2013,115,413000,335000,23,25,47,20,2,113,95,20
10537,E02003718,2014,29,477000,363000,7,3,8,11,0,29,17,12
10538,E02003719,2009,103,174000,168000,6,29,40,28,16,87,72,31
10539,E02003719,2010,114,191000,180000,12,23,41,38,40,74,74,40
10540,E02003719,2011,120,182000,180000,5,23,53,39,27,93,78,42
10541,E02003719,2012,97,196000,188000,3,26,43,25,0,97,70,27
10542,E02003719,2013,106,210000,207000,3,20,29,54,22,84,51,55
10543,E02003719,2014,33,214000,218000,1,6,18,8,0,33,23,10
10544,E02003720,2009,92,245000,214000,16,24,35,17,0,92,74,18
10545,E02003720,2010,96,264000,234000,8,37,29,22,2,94,71,25
10546,E02003720,2011,97,253000,238000,16,27,36,18,1,96,77,20
10547,E02003720,2012,101,279000,271000,12,23,49,17,4,97,83,18
10548,E02003720,2013,109,296000,285000,13,32,45,19,0,109,89,20
10549,E02003720,2014,52,277000,250000,7,11,13,21,14,38,31,21
10550,E02003721,2009,142,232000,225000,5,27,37,73,48,94,67,75
10551,E02003721,2010,106,275000,245000,11,29,31,35,9,97,68,38
10552,E02003721,2011,105,259000,245000,15,31,25,34,0,105,66,39
10553,E02003721,2012,76,271000,250000,9,16,22,29,1,75,45,31
10554,E02003721,2013,98,280000,271000,7,20,30,41,4,94,56,42
10555,E02003721,2014,30,285000,278000,3,4,10,13,0,30,17,13
10556,E02003722,2009,75,293000,246000,8,21,23,23,0,75,50,25
10557,E02003722,2010,90,332000,290000,9,30,22,29,0,90,62,28
10558,E02003722,2011,94,342000,250000,12,16,31,35,17,77,60,34
10559,E02003722,2012,97,365000,300000,6,30,30,31,0,97,67,30
10560,E02003722,2013,88,439000,368000,6,29,36,17,3,85,71,17
10561,E02003722,2014,31,471000,370000,4,9,10,8,0,31,23,8
10562,E02003723,2009,54,329000,286000,12,13,12,17,6,48,37,17
10563,E02003723,2010,76,336000,285000,12,16,21,27,10,66,46,30
10564,E02003723,2011,104,353000,270000,12,15,31,46,46,58,58,46
10565,E02003723,2012,79,346000,259000,11,10,27,31,27,52,51,28
10566,E02003723,2013,75,417000,300000,11,15,21,28,20,55,47,28
10567,E02003723,2014,21,378000,383000,2,3,9,7,0,21,13,8
10568,E02003724,2009,111,202000,190000,8,55,17,31,22,89,74,37
10569,E02003724,2010,128,251000,234000,6,55,36,31,13,115,96,32
10570,E02003724,2011,129,233000,224000,3,49,45,32,11,118,88,41
10571,E02003724,2012,100,256000,245000,4,38,28,30,0,100,69,31
10572,E02003724,2013,152,254000,240000,4,40,37,71,38,114,78,74
10573,E02003724,2014,49,283000,276000,3,20,14,12,5,44,37,12
10574,E02003725,2009,93,457000,360000,19,8,28,38,8,85,53,40
10575,E02003725,2010,86,568000,500000,18,9,36,23,1,85,62,24
10576,E02003725,2011,93,508000,450000,17,8,31,37,7,86,55,38
10577,E02003725,2012,164,426000,347000,13,8,34,109,78,86,55,109
10578,E02003725,2013,255,480000,400000,14,6,33,202,168,87,53,202
10579,E02003725,2014,43,768000,560000,7,1,14,21,12,31,22,21
10580,E02003726,2009,88,354000,274000,7,12,50,19,2,86,69,19
10581,E02003726,2010,112,312000,272000,7,12,54,39,14,98,71,41
10582,E02003726,2011,114,380000,294000,8,20,55,31,8,106,82,32
10583,E02003726,2012,99,363000,302000,3,2,66,28,0,99,71,28
10584,E02003726,2013,97,392000,308000,2,7,51,37,0,97,59,38
10585,E02003726,2014,30,438000,366000,1,1,22,6,0,30,24,6
10586,E02003727,2009,163,221000,235000,5,23,94,41,27,136,122,41
10587,E02003727,2010,164,263000,275000,8,27,103,26,0,164,138,26
10588,E02003727,2011,183,264000,270000,13,20,120,30,7,176,151,32
10589,E02003727,2012,123,283000,283000,3,22,82,16,0,123,107,16
10590,E02003727,2013,182,298000,302000,13,23,87,59,39,143,122,60
10591,E02003727,2014,45,328000,308000,2,7,22,14,11,34,31,14
10592,E02003728,2009,102,210000,212000,3,31,19,49,15,87,50,52
10593,E02003728,2010,118,251000,250000,7,37,23,51,1,117,65,53
10594,E02003728,2011,135,262000,260000,10,49,22,54,0,135,78,57
10595,E02003728,2012,120,270000,265000,4,43,14,59,2,118,61,59
10596,E02003728,2013,137,290000,284000,6,35,31,65,0,137,71,66
10597,E02003728,2014,83,336000,326000,2,14,13,54,27,56,30,53
10598,E02003729,2009,105,221000,212000,14,36,39,16,6,99,84,21
10599,E02003729,2010,125,245000,236000,21,54,29,21,4,121,103,22
10600,E02003729,2011,114,252000,245000,21,52,31,10,14,100,100,14
10601,E02003729,2012,124,260000,244000,22,46,44,12,5,119,112,12
10602,E02003729,2013,133,284000,272000,21,53,37,22,27,106,110,23
10603,E02003729,2014,30,282000,262000,2,13,10,5,0,30,25,5
10604,E02003730,2009,147,427000,308000,19,20,37,71,71,76,74,73
10605,E02003730,2010,225,415000,295000,28,29,47,121,100,125,97,128
10606,E02003730,2011,163,412000,315000,14,19,39,91,61,102,70,93
10607,E02003730,2012,191,392000,297000,30,18,43,100,90,101,88,103
10608,E02003730,2013,487,427000,356000,97,42,103,245,354,133,243,244
10609,E02003730,2014,97,496000,385000,15,14,27,41,49,48,54,43
10610,E02003731,2009,103,414000,338000,31,37,10,25,16,87,78,25
10611,E02003731,2010,111,481000,410000,34,37,11,29,17,94,82,29
10612,E02003731,2011,104,495000,412000,30,39,20,15,9,95,89,15
10613,E02003731,2012,77,510000,465000,26,22,18,11,3,74,66,11
10614,E02003731,2013,83,525000,425000,22,32,17,12,2,81,71,12
10615,E02003731,2014,25,647000,500000,7,6,6,6,0,25,19,6
10616,E02003733,2009,67,166000,152000,29,22,15,1,0,67,66,1
10617,E02003733,2010,60,174000,153000,22,19,19,0,2,58,60,0
10618,E02003733,2011,51,189000,162000,22,14,11,4,5,46,47,4
10619,E02003733,2012,56,183000,158000,25,18,12,1,0,56,54,2
10620,E02003733,2013,73,211000,165000,31,25,13,4,8,65,70,3
10621,E02003733,2014,32,215000,160000,11,12,8,1,0,32,32,0
10622,E02003736,2009,105,211000,190000,52,34,18,1,19,86,105,0
10623,E02003736,2010,111,222000,190000,55,38,15,3,1,110,105,6
10624,E02003736,2011,103,224000,190000,56,33,13,1,2,101,96,7
10625,E02003736,2012,80,227000,190000,42,22,15,1,0,80,78,2
10626,E02003736,2013,131,223000,198000,65,42,23,1,1,130,127,4
10627,E02003736,2014,40,232000,200000,22,7,9,2,0,40,38,2
10628,E02003737,2009,205,163000,148000,59,58,69,19,68,137,179,26
10629,E02003737,2010,179,168000,155000,55,55,57,12,31,148,161,18
10630,E02003737,2011,221,166000,157000,52,93,56,20,75,146,196,25
10631,E02003737,2012,191,166000,150000,52,48,66,25,48,143,161,30
10632,E02003737,2013,199,173000,149000,46,44,74,35,50,149,157,42
10633,E02003737,2014,78,168000,166000,12,19,41,6,19,59,69,9
10634,E02003738,2009,53,193000,170000,20,20,12,1,0,53,52,1
10635,E02003738,2010,55,259000,203000,29,15,11,0,0,55,54,1
10636,E02003738,2011,72,276000,242000,44,15,11,2,11,61,70,2
10637,E02003738,2012,62,208000,186000,25,22,14,1,6,56,55,7
10638,E02003738,2013,56,230000,216000,24,13,18,1,1,55,55,1
10639,E02003738,2014,22,204000,194000,8,8,6,0,0,22,22,0
10640,E02003739,2009,103,223000,200000,55,19,24,5,2,101,93,10
10641,E02003739,2010,106,235000,214000,58,20,19,9,0,106,94,12
10642,E02003739,2011,125,244000,207000,69,25,23,8,2,123,115,10
10643,E02003739,2012,107,231000,210000,49,23,28,7,0,107,95,12
10644,E02003739,2013,115,260000,230000,65,23,22,5,2,113,109,6
10645,E02003739,2014,35,241000,250000,15,9,9,2,0,35,32,3
10646,E02003740,2009,57,254000,227000,24,15,14,4,6,51,51,6
10647,E02003740,2010,69,334000,295000,37,16,14,2,3,66,66,3
10648,E02003740,2011,85,307000,265000,35,26,22,2,22,63,81,4
10649,E02003740,2012,67,300000,260000,39,10,17,1,11,56,65,2
10650,E02003740,2013,59,301000,264000,20,28,7,4,9,50,55,4
10651,E02003740,2014,24,357000,275000,9,7,6,2,0,24,22,2
10652,E02003756,2009,2,528000,528000,2,0,0,0,0,2,2,0
10653,E02003756,2010,1,375000,375000,1,0,0,0,0,1,1,0
10654,E02003756,2011,1,550000,550000,1,0,0,0,0,1,1,0
10655,E02003756,2012,4,282000,230000,3,1,0,0,0,4,4,0
10656,E02003757,2009,38,182000,182000,24,6,5,3,0,38,35,3
10657,E02003757,2010,50,186000,179000,21,13,13,3,4,46,47,3
10658,E02003757,2011,34,192000,173000,17,6,9,2,1,33,32,2
10659,E02003757,2012,48,174000,150000,17,12,9,10,0,48,38,10
10660,E02003757,2013,57,202000,195000,34,7,12,4,0,57,53,4
10661,E02003757,2014,21,230000,210000,15,3,2,1,0,21,20,1
10662,E02003758,2009,101,198000,158000,42,24,33,2,4,97,96,5
10663,E02003758,2010,92,220000,187000,51,17,19,5,6,86,86,6
10664,E02003758,2011,101,211000,155000,33,38,24,6,5,96,95,6
10665,E02003758,2012,105,215000,160000,39,31,34,1,3,102,104,1
10666,E02003758,2013,151,214000,172000,64,43,39,5,5,146,146,5
10667,E02003758,2014,45,242000,210000,27,13,4,1,1,44,45,0
10668,E02003759,2009,75,221000,220000,44,24,7,0,0,75,75,0
10669,E02003759,2010,98,228000,202000,45,35,16,2,10,88,97,1
10670,E02003759,2011,89,224000,185000,43,33,13,0,1,88,88,1
10671,E02003759,2012,80,222000,195000,42,27,11,0,2,78,80,0
10672,E02003759,2013,92,221000,191000,45,43,3,1,0,92,91,1
10673,E02003759,2014,29,257000,248000,18,8,3,0,0,29,29,0
10674,E02003760,2009,82,127000,119000,4,22,54,2,21,61,79,3
10675,E02003760,2010,73,132000,123000,2,18,49,4,17,56,70,3
10676,E02003760,2011,63,119000,106000,7,13,40,3,1,62,57,6
10677,E02003760,2012,63,131000,115000,5,8,49,1,0,63,61,2
10678,E02003760,2013,98,140000,126000,11,19,66,2,8,90,92,6
10679,E02003760,2014,27,138000,128000,1,5,18,3,0,27,22,5
10680,E02003761,2009,84,187000,174000,52,20,10,2,10,74,82,2
10681,E02003761,2010,79,207000,190000,45,15,17,2,9,70,79,0
10682,E02003761,2011,132,188000,175000,55,33,34,10,41,91,123,9
10683,E02003761,2012,84,211000,194000,53,17,13,1,2,82,83,1
10684,E02003761,2013,88,223000,215000,54,17,16,1,9,79,87,1
10685,E02003761,2014,40,206000,196000,24,8,8,0,2,38,39,1
10686,E02003762,2009,109,213000,175000,51,32,19,7,10,99,102,7
10687,E02003762,2010,85,235000,195000,36,34,11,4,2,83,81,4
10688,E02003762,2011,101,227000,195000,49,30,17,5,7,94,96,5
10689,E02003762,2012,113,230000,187000,51,37,19,6,6,107,107,6
10690,E02003762,2013,117,239000,210000,57,29,23,8,3,114,109,8
10691,E02003762,2014,41,230000,192000,17,17,5,2,0,41,38,3
10692,E02003763,2009,147,161000,147000,42,39,48,18,7,140,127,20
10693,E02003763,2010,152,169000,158000,44,39,61,8,0,152,147,5
10694,E02003763,2011,167,167000,152000,41,47,70,9,16,151,156,11
10695,E02003763,2012,159,182000,173000,48,41,61,9,13,146,150,9
10696,E02003763,2013,219,181000,170000,57,44,108,10,26,193,208,11
10697,E02003763,2014,68,187000,167000,18,15,31,4,0,68,66,2
10698,E02003764,2009,188,162000,154000,54,42,36,56,56,132,131,57
10699,E02003764,2010,156,173000,162000,48,24,35,49,41,115,103,53
10700,E02003764,2011,194,169000,160000,52,33,41,68,49,145,124,70
10701,E02003764,2012,185,168000,162000,53,40,44,48,40,145,138,47
10702,E02003764,2013,194,173000,160000,52,33,54,55,15,179,137,57
10703,E02003764,2014,74,173000,161000,18,15,25,16,4,70,56,18
10704,E02003765,2009,104,189000,170000,22,29,19,34,31,73,63,41
10705,E02003765,2010,105,211000,185000,23,39,20,23,11,94,77,28
10706,E02003765,2011,109,203000,180000,18,42,21,28,12,97,78,31
10707,E02003765,2012,117,205000,185000,15,39,47,16,38,79,100,17
10708,E02003765,2013,131,243000,218000,43,35,36,17,20,111,108,23
10709,E02003765,2014,44,256000,234000,15,13,11,5,4,40,37,7
10710,E02003766,2009,143,200000,185000,56,35,28,24,61,82,123,20
10711,E02003766,2010,132,202000,200000,46,32,37,17,53,79,122,10
10712,E02003766,2011,105,203000,184000,42,23,26,14,18,87,91,14
10713,E02003766,2012,85,184000,168000,20,27,23,15,0,85,69,16
10714,E02003766,2013,92,227000,194000,38,22,24,8,0,92,83,9
10715,E02003766,2014,38,196000,172000,11,7,16,4,0,38,34,4
10716,E02003767,2009,61,285000,250000,36,19,5,1,3,58,61,0
10717,E02003767,2010,75,363000,315000,46,20,8,1,2,73,73,2
10718,E02003767,2011,61,301000,250000,42,14,4,1,1,60,61,0
10719,E02003767,2012,88,332000,274000,58,16,14,0,7,81,87,1
10720,E02003767,2013,94,344000,285000,65,20,9,0,1,93,94,0
10721,E02003767,2014,28,352000,250000,16,9,3,0,1,27,28,0
10722,E02003768,2009,159,278000,225000,86,38,22,13,5,154,144,15
10723,E02003768,2010,118,315000,247000,65,27,19,7,4,114,112,6
10724,E02003768,2011,170,283000,232000,93,39,19,19,36,134,152,18
10725,E02003768,2012,164,301000,240000,82,43,32,7,30,134,157,7
10726,E02003768,2013,212,273000,221000,96,50,45,21,49,163,187,25
10727,E02003768,2014,57,276000,246000,26,17,7,7,12,45,50,7
10728,E02003769,2009,77,264000,200000,45,20,8,4,1,76,70,7
10729,E02003769,2010,81,236000,210000,36,36,8,1,2,79,80,1
10730,E02003769,2011,73,234000,202000,43,23,5,2,5,68,70,3
10731,E02003769,2012,73,233000,212000,48,15,9,1,0,73,70,3
10732,E02003769,2013,107,242000,202000,50,35,16,6,2,105,92,15
10733,E02003769,2014,40,272000,247000,21,9,9,1,1,39,39,1
10734,E02003770,2009,175,215000,189000,69,42,27,37,98,77,136,39
10735,E02003770,2010,224,237000,218000,100,43,50,31,152,72,200,24
10736,E02003770,2011,294,236000,204000,110,60,97,27,198,96,266,28
10737,E02003770,2012,219,230000,210000,85,47,59,28,136,83,191,28
10738,E02003770,2013,282,247000,238000,139,55,72,16,142,140,264,18
10739,E02003770,2014,89,252000,245000,39,24,20,6,23,66,82,7
10740,E02003771,2009,92,162000,159000,15,35,25,17,0,92,74,18
10741,E02003771,2010,99,187000,154000,22,25,22,30,4,95,66,33
10742,E02003771,2011,88,186000,162000,18,26,19,25,13,75,62,26
10743,E02003771,2012,118,194000,168000,30,33,29,26,15,103,93,25
10744,E02003771,2013,129,183000,163000,16,37,42,34,21,108,96,33
10745,E02003771,2014,45,205000,182000,13,11,13,8,1,44,36,9
10746,E02003772,2009,128,195000,179000,46,41,30,11,14,114,118,10
10747,E02003772,2010,104,217000,198000,43,26,25,10,1,103,95,9
10748,E02003772,2011,132,202000,186000,48,31,27,26,12,120,108,24
10749,E02003772,2012,97,205000,190000,40,19,30,8,0,97,88,9
10750,E02003772,2013,140,223000,197000,60,26,36,18,1,139,121,19
10751,E02003772,2014,55,200000,194000,16,10,20,9,0,55,47,8
10752,E02003773,2009,148,148000,140000,28,45,60,15,10,138,133,15
10753,E02003773,2010,119,172000,166000,36,27,47,9,0,119,108,11
10754,E02003773,2011,160,167000,158000,28,45,66,21,31,129,139,21
10755,E02003773,2012,185,176000,167000,39,52,87,7,36,149,174,11
10756,E02003773,2013,222,177000,165000,35,51,116,20,41,181,204,18
10757,E02003773,2014,67,179000,168000,11,18,30,8,1,66,59,8
10758,E02003774,2009,65,182000,165000,17,22,21,5,0,65,60,5
10759,E02003774,2010,72,181000,167000,15,28,22,7,0,72,65,7
10760,E02003774,2011,89,189000,155000,23,25,34,7,0,89,82,7
10761,E02003774,2012,59,190000,175000,16,16,25,2,1,58,57,2
10762,E02003774,2013,82,194000,181000,18,25,28,11,8,74,71,11
10763,E02003774,2014,28,206000,182000,7,11,6,4,0,28,24,4
10764,E02003775,2009,92,224000,196000,46,30,14,2,2,90,87,5
10765,E02003775,2010,91,236000,223000,46,22,19,4,2,89,86,5
10766,E02003775,2011,97,253000,243000,54,16,15,12,17,80,86,11
10767,E02003775,2012,97,246000,235000,56,16,20,5,8,89,90,7
10768,E02003775,2013,114,259000,250000,66,20,19,9,3,111,105,9
10769,E02003775,2014,32,255000,228000,17,6,8,1,0,32,31,1
10770,E02003776,2009,95,223000,195000,39,20,33,3,0,95,91,4
10771,E02003776,2010,111,248000,220000,46,34,29,2,0,111,108,3
10772,E02003776,2011,94,262000,248000,49,21,22,2,2,92,91,3
10773,E02003776,2012,82,244000,220000,31,21,27,3,0,82,78,4
10774,E02003776,2013,102,246000,217000,36,21,42,3,0,102,99,3
10775,E02003776,2014,40,277000,250000,21,3,16,0,0,40,40,0
10776,E02003777,2009,99,209000,197000,44,36,18,1,0,99,98,1
10777,E02003777,2010,104,230000,202000,40,41,19,4,1,103,99,5
10778,E02003777,2011,163,251000,240000,83,43,35,2,47,116,161,2
10779,E02003777,2012,180,268000,250000,91,52,32,5,84,96,173,7
10780,E02003777,2013,211,277000,263000,109,36,42,24,95,116,187,24
10781,E02003777,2014,53,257000,192000,20,11,10,12,14,39,40,13
10782,E02003778,2009,73,236000,215000,24,20,28,1,18,55,72,1
10783,E02003778,2010,85,252000,235000,42,25,16,2,21,64,83,2
10784,E02003778,2011,96,274000,246000,52,21,21,2,22,74,94,2
10785,E02003778,2012,63,263000,248000,27,19,16,1,3,60,60,3
10786,E02003778,2013,62,246000,211000,15,20,27,0,13,49,62,0
10787,E02003778,2014,42,236000,230000,6,11,24,1,1,41,39,3
10788,E02003779,2009,89,187000,159000,25,35,26,3,0,89,80,9
10789,E02003779,2010,84,202000,170000,24,23,34,3,0,84,80,4
10790,E02003779,2011,85,199000,177000,23,28,31,3,0,85,79,6
10791,E02003779,2012,68,202000,174000,22,19,27,0,1,67,66,2
10792,E02003779,2013,90,210000,191000,25,29,32,4,0,90,82,8
10793,E02003779,2014,20,250000,192000,4,6,10,0,0,20,16,4
10794,E02003780,2009,186,225000,216000,34,49,54,49,78,108,131,55
10795,E02003780,2010,206,248000,230000,56,51,38,61,89,117,145,61
10796,E02003780,2011,244,240000,218000,39,62,53,90,112,132,142,102
10797,E02003780,2012,182,281000,250000,46,54,36,46,50,132,132,50
10798,E02003780,2013,187,287000,250000,33,54,46,54,51,136,126,61
10799,E02003780,2014,54,274000,261000,8,25,9,12,9,45,38,16
10800,E02003781,2009,77,246000,229000,34,22,18,3,4,73,72,5
10801,E02003781,2010,105,279000,246000,51,27,21,6,1,104,98,7
10802,E02003781,2011,81,277000,250000,39,22,13,7,0,81,72,9
10803,E02003781,2012,90,265000,236000,37,21,27,5,2,88,83,7
10804,E02003781,2013,80,281000,253000,27,30,19,4,5,75,76,4
10805,E02003781,2014,38,317000,322000,13,8,14,3,9,29,35,3
10806,E02003783,2009,68,332000,264000,32,23,7,6,2,66,59,9
10807,E02003783,2010,80,358000,300000,29,27,18,6,6,74,67,13
10808,E02003783,2011,70,335000,335000,29,22,11,8,0,70,57,13
10809,E02003783,2012,89,352000,345000,35,31,13,10,4,85,76,13
10810,E02003783,2013,86,409000,320000,44,24,12,6,2,84,76,10
10811,E02003783,2014,28,356000,334000,7,9,7,5,1,27,22,6
10812,E02003784,2009,108,295000,229000,51,43,14,0,0,108,105,3
10813,E02003784,2010,104,291000,243000,45,36,19,4,2,102,98,6
10814,E02003784,2011,116,306000,265000,57,35,22,2,1,115,108,8
10815,E02003784,2012,112,310000,270000,56,35,16,5,0,112,102,10
10816,E02003784,2013,96,331000,254000,50,27,17,2,0,96,90,6
10817,E02003784,2014,34,313000,284000,15,10,7,2,0,34,32,2
10818,E02003785,2009,142,222000,210000,39,39,43,21,27,115,111,31
10819,E02003785,2010,124,284000,235000,43,33,40,8,6,118,113,11
10820,E02003785,2011,136,259000,236000,46,32,42,16,35,101,111,25
10821,E02003785,2012,105,269000,235000,29,32,34,10,23,82,95,10
10822,E02003785,2013,118,268000,242000,40,30,24,24,23,95,93,25
10823,E02003785,2014,44,232000,236000,8,6,15,15,12,32,29,15
10824,E02003786,2009,124,343000,229000,37,47,16,24,38,86,99,25
10825,E02003786,2010,128,373000,292000,50,35,14,29,28,100,97,31
10826,E02003786,2011,111,446000,305000,42,41,12,16,17,94,95,16
10827,E02003786,2012,86,413000,318000,30,33,14,9,2,84,76,10
10828,E02003786,2013,93,430000,375000,41,34,11,7,1,92,86,7
10829,E02003786,2014,24,508000,398000,16,3,3,2,1,23,22,2
10830,E02003787,2009,81,303000,240000,43,19,16,3,0,81,77,4
10831,E02003787,2010,88,257000,207000,36,34,17,1,0,88,86,2
10832,E02003787,2011,82,319000,258000,42,23,16,1,0,82,80,2
10833,E02003787,2012,85,323000,243000,40,16,27,2,0,85,82,3
10834,E02003787,2013,97,310000,250000,44,26,25,2,0,97,94,3
10835,E02003787,2014,45,304000,238000,19,11,14,1,0,45,42,3
10836,E02003788,2009,86,366000,278000,46,25,14,1,2,84,82,4
10837,E02003788,2010,76,369000,290000,38,27,11,0,1,75,73,3
10838,E02003788,2011,86,343000,295000,48,27,8,3,10,76,78,8
10839,E02003788,2012,69,392000,300000,40,22,7,0,6,63,66,3
10840,E02003788,2013,94,407000,316000,57,20,17,0,0,94,93,1
10841,E02003788,2014,24,513000,392000,13,7,4,0,4,20,23,1
10842,E02003789,2009,81,199000,185000,22,34,23,2,1,80,77,4
10843,E02003789,2010,112,217000,214000,33,48,27,4,2,110,107,5
10844,E02003789,2011,86,208000,200000,12,46,25,3,1,85,83,3
10845,E02003789,2012,90,248000,221000,20,41,25,4,0,90,82,8
10846,E02003789,2013,91,239000,218000,18,36,32,5,1,90,85,6
10847,E02003789,2014,34,259000,250000,7,16,10,1,0,34,32,2
10848,E02003790,2009,104,284000,242000,52,36,15,1,0,104,103,1
10849,E02003790,2010,117,280000,245000,55,33,27,2,5,112,114,3
10850,E02003790,2011,104,312000,245000,53,35,16,0,2,102,103,1
10851,E02003790,2012,100,292000,248000,42,36,19,3,1,99,97,3
10852,E02003790,2013,140,350000,295000,63,41,32,4,9,131,133,7
10853,E02003790,2014,37,333000,300000,17,12,7,1,1,36,35,2
10854,E02003791,2009,73,312000,250000,40,18,15,0,1,72,73,0
10855,E02003791,2010,110,350000,296000,50,40,19,1,14,96,109,1
10856,E02003791,2011,100,328000,282000,46,35,15,4,8,92,96,4
10857,E02003791,2012,98,364000,345000,49,24,25,0,1,97,98,0
10858,E02003791,2013,91,381000,322000,43,23,24,1,4,87,87,4
10859,E02003791,2014,42,317000,268000,16,11,12,3,1,41,39,3
10860,E02003792,2009,103,264000,225000,37,30,21,15,25,78,86,17
10861,E02003792,2010,142,284000,237000,58,54,18,12,8,134,128,14
10862,E02003792,2011,93,328000,250000,37,35,20,1,2,91,92,1
10863,E02003792,2012,105,324000,280000,53,33,16,3,15,90,102,3
10864,E02003792,2013,136,308000,250000,58,40,31,7,1,135,125,11
10865,E02003792,2014,54,318000,275000,23,19,11,1,3,51,53,1
10866,E02003793,2009,77,305000,270000,39,24,11,3,2,75,74,3
10867,E02003793,2010,81,321000,268000,37,24,16,4,5,76,77,4
10868,E02003793,2011,90,311000,250000,35,35,18,2,6,84,85,5
10869,E02003793,2012,67,303000,248000,28,23,14,2,1,66,64,3
10870,E02003793,2013,90,318000,267000,33,34,21,2,3,87,85,5
10871,E02003793,2014,38,373000,320000,18,12,7,1,1,37,37,1
10872,E02004356,2009,96,157000,154000,19,33,43,1,0,96,94,2
10873,E02004356,2010,72,160000,157000,16,25,24,7,0,72,64,8
10874,E02004356,2011,85,161000,155000,18,40,21,6,3,82,78,7
10875,E02004356,2012,91,157000,150000,19,31,31,10,4,87,82,9
10876,E02004356,2013,93,164000,164000,22,38,27,6,1,92,86,7
10877,E02004356,2014,35,177000,160000,7,13,12,3,0,35,33,2
10878,E02004357,2009,70,137000,135000,7,13,47,3,0,70,68,2
10879,E02004357,2010,68,151000,146000,9,20,37,2,0,68,66,2
10880,E02004357,2011,83,149000,141000,13,20,41,9,1,82,72,11
10881,E02004357,2012,91,150000,145000,17,20,46,8,0,91,84,7
10882,E02004357,2013,98,149000,148000,10,28,55,5,0,98,93,5
10883,E02004357,2014,27,157000,152000,3,4,18,2,0,27,25,2
10884,E02004358,2009,115,164000,158000,34,36,36,9,0,115,105,10
10885,E02004358,2010,109,173000,172000,32,44,23,10,0,109,99,10
10886,E02004358,2011,105,162000,158000,28,31,34,12,0,105,92,13
10887,E02004358,2012,91,167000,160000,21,29,33,8,0,91,83,8
10888,E02004358,2013,149,165000,160000,30,48,51,20,3,146,128,21
10889,E02004358,2014,59,192000,188000,15,24,17,3,0,59,56,3
10890,E02004359,2009,103,217000,212000,41,38,18,6,2,101,98,5
10891,E02004359,2010,77,220000,188000,27,24,22,4,0,77,72,5
10892,E02004359,2011,90,213000,176000,34,26,24,6,0,90,86,4
10893,E02004359,2012,81,216000,205000,34,21,22,4,0,81,77,4
10894,E02004359,2013,80,216000,205000,32,19,25,4,0,80,76,4
10895,E02004359,2014,42,269000,258000,20,12,7,3,0,42,39,3
10896,E02004361,2009,116,244000,230000,49,44,15,8,0,116,108,8
10897,E02004361,2010,103,258000,240000,49,36,7,11,0,103,92,11
10898,E02004361,2011,110,259000,239000,53,36,10,11,0,110,99,11
10899,E02004361,2012,94,278000,262000,50,26,11,7,2,92,88,6
10900,E02004361,2013,135,276000,250000,79,31,10,15,3,132,121,14
10901,E02004361,2014,44,268000,226000,21,12,5,6,0,44,38,6
10902,E02004362,2009,127,167000,158000,4,45,64,14,3,124,113,14
10903,E02004362,2010,126,168000,168000,3,38,60,25,0,126,101,25
10904,E02004362,2011,127,175000,170000,0,54,56,17,0,127,110,17
10905,E02004362,2012,122,172000,172000,3,34,69,16,0,122,106,16
10906,E02004362,2013,189,178000,177000,2,58,94,35,5,184,154,35
10907,E02004362,2014,50,182000,181000,2,17,27,4,0,50,46,4
10908,E02004363,2009,88,182000,168000,18,10,16,44,0,88,44,44
10909,E02004363,2010,105,220000,165000,30,10,7,58,0,105,46,59
10910,E02004363,2011,113,207000,180000,34,8,13,58,0,113,56,57
10911,E02004363,2012,109,185000,142000,26,8,12,63,0,109,46,63
10912,E02004363,2013,140,175000,146000,23,13,14,90,0,140,50,90
10913,E02004363,2014,53,205000,165000,11,5,7,30,0,53,23,30
10914,E02004364,2009,165,190000,175000,19,34,38,74,4,161,91,74
10915,E02004364,2010,185,207000,205000,21,34,55,75,0,185,108,77
10916,E02004364,2011,134,188000,184000,6,25,45,58,0,134,76,58
10917,E02004364,2012,165,209000,190000,14,22,57,72,0,165,93,72
10918,E02004364,2013,204,210000,194000,15,39,71,79,0,204,123,81
10919,E02004364,2014,68,218000,199000,6,7,31,24,0,68,43,25
10920,E02004365,2009,163,136000,135000,1,8,72,82,55,108,80,83
10921,E02004365,2010,90,135000,135000,0,2,51,37,0,90,53,37
10922,E02004365,2011,109,123000,112000,2,2,44,61,0,109,50,59
10923,E02004365,2012,101,126000,128000,0,4,45,52,0,101,52,49
10924,E02004365,2013,113,136000,135000,0,4,61,48,0,113,63,50
10925,E02004365,2014,49,131000,125000,0,2,21,26,5,44,23,26
10926,E02004366,2009,210,176000,151000,6,10,18,176,24,186,34,176
10927,E02004366,2010,178,199000,170000,4,5,17,152,3,175,23,155
10928,E02004366,2011,137,177000,150000,2,7,15,113,4,133,23,114
10929,E02004366,2012,170,179000,162000,2,6,15,147,0,170,25,145
10930,E02004366,2013,222,183000,154000,4,5,24,189,7,215,33,189
10931,E02004366,2014,89,198000,175000,1,1,12,75,0,89,14,75
10932,E02004367,2009,196,263000,218000,30,19,16,131,16,180,66,130
10933,E02004367,2010,176,269000,236000,24,15,23,114,6,170,62,114
10934,E02004367,2011,212,271000,232000,32,11,22,147,20,192,65,147
10935,E02004367,2012,167,279000,237000,26,9,15,117,12,155,50,117
10936,E02004367,2013,218,285000,240000,29,17,21,151,22,196,68,150
10937,E02004367,2014,80,288000,236000,12,1,7,60,0,80,19,61
10938,E02004368,2009,111,178000,168000,42,26,32,11,4,107,100,11
10939,E02004368,2010,113,200000,192000,59,20,26,8,0,113,104,9
10940,E02004368,2011,134,192000,181000,59,29,36,10,0,134,126,8
10941,E02004368,2012,110,205000,189000,54,23,26,7,0,110,103,7
10942,E02004368,2013,146,203000,190000,78,31,25,12,1,145,134,12
10943,E02004368,2014,45,208000,204000,23,8,10,4,0,45,41,4
10944,E02004369,2009,148,192000,179000,69,51,13,15,1,147,133,15
10945,E02004369,2010,127,204000,195000,70,36,11,10,0,127,117,10
10946,E02004369,2011,155,211000,195000,79,51,7,18,1,154,137,18
10947,E02004369,2012,154,194000,182000,81,42,13,18,2,152,135,19
10948,E02004369,2013,177,204000,190000,82,59,11,25,9,168,152,25
10949,E02004369,2014,71,223000,205000,32,23,7,9,1,70,62,9
10950,E02004370,2009,63,132000,120000,5,21,34,3,6,57,60,3
10951,E02004370,2010,63,150000,132000,8,18,35,2,8,55,61,2
10952,E02004370,2011,84,145000,130000,12,27,41,4,7,77,81,3
10953,E02004370,2012,68,150000,138000,15,19,31,3,5,63,65,3
10954,E02004370,2013,90,162000,147000,13,25,51,1,20,70,89,1
10955,E02004370,2014,33,156000,140000,3,9,20,1,2,31,32,1
10956,E02004371,2009,85,160000,130000,14,19,43,9,0,85,76,9
10957,E02004371,2010,92,148000,134000,11,21,50,10,0,92,83,9
10958,E02004371,2011,93,145000,131000,17,20,45,11,0,93,81,12
10959,E02004371,2012,95,156000,136000,13,22,48,12,0,95,83,12
10960,E02004371,2013,93,156000,140000,16,21,47,9,4,89,85,8
10961,E02004371,2014,54,161000,156000,10,7,30,7,0,54,47,7
10962,E02004372,2009,52,136000,126000,7,16,25,4,0,52,48,4
10963,E02004372,2010,45,128000,119000,1,9,26,9,0,45,36,9
10964,E02004372,2011,71,127000,128000,8,22,27,14,2,69,56,15
10965,E02004372,2012,54,137000,137000,7,18,20,9,0,54,46,8
10966,E02004372,2013,92,135000,134000,9,23,46,14,8,84,78,14
10967,E02004372,2014,33,172000,165000,3,10,16,4,0,33,29,4
10968,E02004373,2009,105,155000,145000,16,37,27,25,12,93,81,24
10969,E02004373,2010,97,157000,145000,11,41,33,12,1,96,85,12
10970,E02004373,2011,90,155000,145000,14,32,28,16,0,90,74,16
10971,E02004373,2012,97,156000,150000,16,40,26,15,0,97,81,16
10972,E02004373,2013,127,175000,161000,28,47,40,12,0,127,116,11
10973,E02004373,2014,60,176000,162000,10,19,22,9,1,59,51,9
10974,E02004374,2009,119,170000,150000,11,12,69,27,0,119,91,28
10975,E02004374,2010,101,196000,175000,9,17,57,18,2,99,82,19
10976,E02004374,2011,127,173000,160000,12,25,68,22,0,127,108,19
10977,E02004374,2012,123,183000,159000,16,19,59,29,0,123,95,28
10978,E02004374,2013,154,198000,170000,14,29,84,27,1,153,129,25
10979,E02004374,2014,61,199000,188000,5,15,31,10,0,61,51,10
10980,E02004375,2009,125,165000,150000,16,14,48,47,11,114,77,48
10981,E02004375,2010,114,160000,134000,13,16,36,49,4,110,65,49
10982,E02004375,2011,110,162000,146000,15,18,29,48,3,107,64,46
10983,E02004375,2012,113,188000,156000,28,15,34,36,2,111,76,37
10984,E02004375,2013,139,176000,150000,21,19,48,51,1,138,87,52
10985,E02004375,2014,66,187000,158000,14,5,18,29,0,66,37,29
10986,E02004376,2009,89,137000,130000,1,5,44,39,4,85,50,39
10987,E02004376,2010,107,147000,125000,6,7,48,46,0,107,61,46
10988,E02004376,2011,111,132000,120000,1,7,44,59,0,111,52,59
10989,E02004376,2012,108,142000,125000,5,4,42,57,2,106,51,57
10990,E02004376,2013,147,140000,124000,4,5,60,78,5,142,70,77
10991,E02004376,2014,55,142000,128000,1,1,27,26,3,52,29,26
10992,E02004377,2009,153,165000,160000,50,47,17,39,0,153,115,38
10993,E02004377,2010,132,169000,147000,35,34,19,44,0,132,87,45
10994,E02004377,2011,150,174000,155000,38,59,19,34,0,150,115,35
10995,E02004377,2012,128,175000,160000,32,49,16,31,1,127,99,29
10996,E02004377,2013,208,177000,159000,53,73,25,57,1,207,151,57
10997,E02004377,2014,77,204000,181000,25,29,11,12,1,76,65,12
10998,E02004378,2009,147,101000,90000,2,7,29,109,2,145,35,112
10999,E02004378,2010,138,113000,100000,0,4,23,111,1,137,23,115
11000,E02004378,2011,132,110000,92000,1,4,17,110,0,132,16,116
11001,E02004378,2012,116,118000,108000,0,4,17,95,2,114,22,94
11002,E02004378,2013,162,121000,96000,1,5,36,120,2,160,41,121
11003,E02004378,2014,71,121000,104000,0,1,12,58,0,71,13,58
11004,E02004379,2009,97,366000,285000,48,30,15,4,5,92,93,4
11005,E02004379,2010,93,438000,385000,55,21,12,5,18,75,88,5
11006,E02004379,2011,69,394000,312000,40,18,7,4,0,69,66,3
11007,E02004379,2012,94,436000,362000,62,21,11,0,3,91,94,0
11008,E02004379,2013,101,427000,342000,47,31,20,3,0,101,98,3
11009,E02004379,2014,30,438000,352000,14,8,6,2,0,30,28,2
11010,E02004380,2009,111,427000,370000,47,25,11,28,23,88,82,29
11011,E02004380,2010,114,490000,356000,55,22,17,20,10,104,97,17
11012,E02004380,2011,150,408000,346000,44,23,27,56,56,94,96,54
11013,E02004380,2012,139,451000,355000,54,28,32,25,26,113,115,24
11014,E02004380,2013,137,507000,395000,65,18,19,35,16,121,102,35
11015,E02004380,2014,52,456000,384000,22,16,11,3,0,52,49,3
11016,E02004381,2009,177,244000,216000,15,31,70,61,3,174,114,63
11017,E02004381,2010,156,291000,236000,18,32,62,44,1,155,114,42
11018,E02004381,2011,151,295000,240000,11,34,71,35,2,149,116,35
11019,E02004381,2012,143,300000,245000,5,34,70,34,3,140,111,32
11020,E02004381,2013,175,335000,250000,15,36,77,47,11,164,128,47
11021,E02004381,2014,66,346000,290000,5,16,29,16,5,61,49,17
11022,E02004382,2009,72,282000,250000,31,25,10,6,0,72,66,6
11023,E02004382,2010,72,310000,270000,17,35,13,7,0,72,65,7
11024,E02004382,2011,59,361000,282000,20,27,8,4,0,59,55,4
11025,E02004382,2012,62,285000,250000,16,28,10,8,1,61,54,8
11026,E02004382,2013,89,289000,260000,21,34,24,10,0,89,79,10
11027,E02004382,2014,22,298000,250000,7,7,3,5,0,22,17,5
11028,E02004383,2009,118,310000,265000,19,35,47,17,0,118,100,18
11029,E02004383,2010,97,341000,310000,19,29,39,10,0,97,88,9
11030,E02004383,2011,109,360000,305000,25,25,44,15,0,109,94,15
11031,E02004383,2012,114,377000,324000,17,33,47,17,2,112,98,16
11032,E02004383,2013,120,408000,345000,16,38,53,13,2,118,107,13
11033,E02004383,2014,40,418000,380000,7,12,16,5,0,40,36,4
11034,E02004384,2009,118,187000,176000,38,34,23,23,0,118,95,23
11035,E02004384,2010,111,228000,220000,45,32,15,19,1,110,93,18
11036,E02004384,2011,141,233000,225000,64,32,18,27,1,140,116,25
11037,E02004384,2012,110,230000,229000,54,27,8,21,1,109,89,21
11038,E02004384,2013,152,233000,230000,64,34,21,33,1,151,120,32
11039,E02004384,2014,49,243000,242000,23,10,8,8,0,49,41,8
11040,E02004385,2009,117,187000,175000,44,42,18,13,0,117,105,12
11041,E02004385,2010,132,199000,200000,58,34,20,20,1,131,112,20
11042,E02004385,2011,143,198000,195000,50,53,19,21,0,143,124,19
11043,E02004385,2012,127,199000,200000,47,39,17,24,0,127,103,24
11044,E02004385,2013,158,207000,210000,64,57,16,21,4,154,136,22
11045,E02004385,2014,51,218000,220000,16,12,12,11,0,51,41,10
11046,E02004386,2009,88,189000,175000,17,17,24,30,12,76,58,30
11047,E02004386,2010,89,188000,182000,26,23,33,7,1,88,82,7
11048,E02004386,2011,61,189000,182000,14,18,24,5,0,61,55,6
11049,E02004386,2012,89,179000,170000,17,19,33,20,0,89,67,22
11050,E02004386,2013,107,192000,180000,27,33,32,15,0,107,91,16
11051,E02004386,2014,39,201000,195000,10,12,10,7,0,39,32,7
11052,E02004387,2009,63,162000,160000,11,24,20,8,0,63,55,8
11053,E02004387,2010,69,166000,160000,13,30,21,5,0,69,64,5
11054,E02004387,2011,59,164000,160000,9,22,21,7,0,59,52,7
11055,E02004387,2012,86,167000,158000,9,32,35,10,3,83,76,10
11056,E02004387,2013,86,180000,175000,13,40,22,11,0,86,75,11
11057,E02004387,2014,36,209000,184000,6,18,8,4,0,36,32,4
11058,E02004388,2009,134,185000,184000,59,40,17,18,28,106,116,18
11059,E02004388,2010,145,196000,196000,43,41,33,28,20,125,116,29
11060,E02004388,2011,136,202000,199000,37,44,40,15,5,131,123,13
11061,E02004388,2012,134,207000,209000,48,46,32,8,9,125,125,9
11062,E02004388,2013,130,203000,204000,41,38,31,20,11,119,107,23
11063,E02004388,2014,50,227000,220000,21,17,6,6,1,49,43,7
11064,E02004389,2009,182,221000,213000,93,45,25,19,32,150,165,17
11065,E02004389,2010,156,247000,240000,83,44,17,12,9,147,146,10
11066,E02004389,2011,171,256000,247000,106,38,15,12,0,171,158,13
11067,E02004389,2012,142,247000,244000,79,39,11,13,0,142,129,13
11068,E02004389,2013,191,253000,245000,105,43,20,23,0,191,168,23
11069,E02004389,2014,70,311000,270000,42,14,7,7,0,70,62,8
11070,E02004390,2009,135,237000,220000,68,46,17,4,6,129,130,5
11071,E02004390,2010,135,253000,230000,72,31,16,16,16,119,116,19
11072,E02004390,2011,119,271000,246000,73,23,20,3,4,115,116,3
11073,E02004390,2012,130,261000,240000,76,31,19,4,1,129,126,4
11074,E02004390,2013,172,271000,245000,92,39,31,10,0,172,161,11
11075,E02004390,2014,58,283000,270000,31,13,9,5,0,58,52,6
11076,E02004391,2009,122,162000,150000,12,16,21,73,0,122,51,71
11077,E02004391,2010,131,197000,182000,20,16,38,57,1,130,73,58
11078,E02004391,2011,132,178000,158000,20,16,25,71,0,132,62,70
11079,E02004391,2012,135,190000,173000,15,14,43,63,3,132,74,61
11080,E02004391,2013,137,204000,182000,18,22,43,54,2,135,85,52
11081,E02004391,2014,69,214000,208000,6,4,14,45,20,49,24,45
11082,E02004392,2009,102,358000,250000,47,29,22,4,7,95,97,5
11083,E02004392,2010,116,336000,279000,54,36,24,2,0,116,114,2
11084,E02004392,2011,103,349000,275000,51,31,19,2,0,103,99,4
11085,E02004392,2012,124,321000,282000,48,37,33,6,0,124,115,9
11086,E02004392,2013,133,318000,260000,59,32,38,4,0,133,128,5
11087,E02004392,2014,54,347000,285000,22,12,19,1,0,54,53,1
11088,E02004393,2009,99,291000,250000,65,18,11,5,6,93,93,6
11089,E02004393,2010,104,312000,275000,63,26,14,1,8,96,103,1
11090,E02004393,2011,99,273000,250000,52,26,16,5,15,84,93,6
11091,E02004393,2012,121,289000,250000,72,22,21,6,10,111,115,6
11092,E02004393,2013,132,326000,272000,85,14,18,15,18,114,117,15
11093,E02004393,2014,41,339000,250000,20,12,7,2,3,38,39,2
11094,E02004394,2009,93,358000,290000,55,20,15,3,0,93,91,2
11095,E02004394,2010,81,363000,315000,42,20,13,6,2,79,76,5
11096,E02004394,2011,76,329000,264000,37,25,9,5,1,75,71,5
11097,E02004394,2012,103,328000,270000,55,25,18,5,1,102,99,4
11098,E02004394,2013,134,370000,290000,68,34,31,1,8,126,132,2
11099,E02004394,2014,33,393000,300000,15,11,5,2,0,33,32,1
11100,E02004395,2009,115,219000,198000,21,37,46,11,23,92,105,10
11101,E02004395,2010,139,241000,217000,23,42,60,14,4,135,124,15
11102,E02004395,2011,146,254000,215000,42,35,52,17,10,136,127,19
11103,E02004395,2012,137,252000,216000,34,32,49,22,9,128,115,22
11104,E02004395,2013,163,258000,232000,46,41,58,18,11,152,144,19
11105,E02004395,2014,47,247000,245000,9,16,14,8,1,46,39,8
11106,E02004396,2009,133,284000,250000,100,19,8,6,1,132,127,6
11107,E02004396,2010,127,318000,250000,82,26,14,5,0,127,122,5
11108,E02004396,2011,136,317000,272000,106,20,7,3,1,135,133,3
11109,E02004396,2012,150,300000,250000,100,26,19,5,7,143,145,5
11110,E02004396,2013,151,306000,270000,104,22,15,10,5,146,142,9
11111,E02004396,2014,62,321000,285000,38,17,6,1,0,62,60,2
11112,E02004397,2009,130,254000,216000,56,29,24,21,1,129,109,21
11113,E02004397,2010,128,294000,245000,56,31,28,13,1,127,113,15
11114,E02004397,2011,129,285000,265000,63,18,22,26,2,127,102,27
11115,E02004397,2012,108,267000,231000,43,24,30,11,5,103,96,12
11116,E02004397,2013,142,300000,241000,65,34,24,19,8,134,124,18
11117,E02004397,2014,58,307000,244000,21,15,12,10,1,57,48,10
11118,E02004398,2009,85,143000,133000,14,37,22,12,0,85,73,12
11119,E02004398,2010,83,159000,140000,21,24,30,8,2,81,76,7
11120,E02004398,2011,89,149000,137000,17,36,26,10,0,89,79,10
11121,E02004398,2012,80,162000,148000,23,28,17,12,1,79,68,12
11122,E02004398,2013,103,160000,150000,19,52,25,7,1,102,95,8
11123,E02004398,2014,48,164000,159000,9,15,16,8,0,48,40,8
11124,E02004399,2009,147,167000,171000,62,21,17,47,7,140,101,46
11125,E02004399,2010,159,165000,168000,51,21,27,60,6,153,99,60
11126,E02004399,2011,188,165000,155000,57,39,19,73,2,186,117,71
11127,E02004399,2012,168,169000,165000,69,24,20,55,3,165,113,55
11128,E02004399,2013,184,187000,190000,77,21,32,54,16,168,130,54
11129,E02004399,2014,96,184000,191000,35,18,17,26,15,81,69,27
11130,E02004400,2009,234,269000,245000,150,24,15,45,23,211,187,47
11131,E02004400,2010,220,293000,273000,166,23,9,22,6,214,197,23
11132,E02004400,2011,187,285000,250000,126,25,11,25,9,178,163,24
11133,E02004400,2012,201,283000,265000,155,13,8,25,3,198,174,27
11134,E02004400,2013,231,294000,278000,178,23,8,22,2,229,209,22
11135,E02004400,2014,102,275000,249000,64,14,6,18,1,101,83,19
11136,E02004401,2009,178,213000,210000,75,34,10,59,3,175,118,60
11137,E02004401,2010,157,219000,198000,69,33,7,48,0,157,110,47
11138,E02004401,2011,188,222000,194000,73,36,9,70,5,183,118,70
11139,E02004401,2012,177,218000,200000,69,28,10,70,11,166,106,71
11140,E02004401,2013,210,226000,214000,85,49,6,70,2,208,137,73
11141,E02004401,2014,85,224000,196000,30,12,6,37,0,85,50,35
11142,E02004402,2009,202,137000,125000,12,13,26,151,15,187,55,147
11143,E02004402,2010,193,152000,135000,18,14,19,142,2,191,54,139
11144,E02004402,2011,171,144000,130000,14,6,21,130,0,171,41,130
11145,E02004402,2012,201,149000,135000,14,14,24,149,3,198,52,149
11146,E02004402,2013,262,146000,130000,16,11,29,206,14,248,55,207
11147,E02004402,2014,106,153000,143000,6,6,16,78,6,100,29,77
11148,E02004403,2009,75,391000,295000,32,18,13,12,1,74,63,12
11149,E02004403,2010,80,426000,343000,38,22,13,7,0,80,72,8
11150,E02004403,2011,71,385000,355000,29,25,11,6,0,71,66,5
11151,E02004403,2012,76,415000,327000,29,24,14,9,2,74,67,9
11152,E02004403,2013,69,441000,330000,30,19,10,10,2,67,59,10
11153,E02004403,2014,34,416000,340000,13,12,6,3,0,34,31,3
11154,E02004404,2009,69,430000,320000,28,22,15,4,3,66,64,5
11155,E02004404,2010,93,429000,337000,43,30,16,4,0,93,89,4
11156,E02004404,2011,72,476000,419000,30,27,14,1,0,72,71,1
11157,E02004404,2012,73,437000,345000,29,17,23,4,0,73,69,4
11158,E02004404,2013,76,450000,369000,29,28,17,2,2,74,71,5
11159,E02004404,2014,35,611000,445000,18,10,6,1,1,34,34,1
11160,E02004405,2009,99,244000,248000,38,36,6,19,23,76,80,19
11161,E02004405,2010,108,273000,265000,51,31,13,13,21,87,94,14
11162,E02004405,2011,131,272000,270000,53,39,26,13,33,98,116,15
11163,E02004405,2012,108,280000,268000,53,24,16,15,15,93,91,17
11164,E02004405,2013,108,261000,265000,46,28,15,19,4,104,88,20
11165,E02004405,2014,41,286000,286000,18,13,0,10,0,41,31,10
11166,E02004406,2009,95,312000,264000,59,12,6,18,5,90,78,17
11167,E02004406,2010,113,372000,330000,74,16,8,15,1,112,96,17
11168,E02004406,2011,111,358000,303000,63,13,7,28,3,108,82,29
11169,E02004406,2012,162,396000,358000,106,20,8,28,14,148,134,28
11170,E02004406,2013,134,374000,314000,77,17,13,27,7,127,104,30
11171,E02004406,2014,51,372000,320000,27,6,2,16,1,50,35,16
11172,E02004407,2009,99,507000,384000,52,22,15,10,5,94,90,9
11173,E02004407,2010,125,445000,400000,58,25,18,24,9,116,101,24
11174,E02004407,2011,119,445000,365000,50,32,24,13,20,99,105,14
11175,E02004407,2012,131,504000,430000,68,23,20,20,19,112,110,21
11176,E02004407,2013,140,403000,352000,48,42,24,26,18,122,116,24
11177,E02004407,2014,48,509000,424000,24,9,8,7,5,43,41,7
11178,E02004408,2009,81,215000,210000,22,34,20,5,4,77,71,10
11179,E02004408,2010,86,220000,214000,21,32,20,13,19,67,74,12
11180,E02004408,2011,121,243000,229000,36,40,32,13,26,95,103,18
11181,E02004408,2012,133,235000,223000,50,39,34,10,8,125,117,16
11182,E02004408,2013,118,242000,235000,41,39,27,11,5,113,103,15
11183,E02004408,2014,42,254000,240000,15,12,11,4,1,41,34,8
11184,E02004409,2009,59,473000,381000,39,10,6,4,3,56,54,5
11185,E02004409,2010,56,568000,428000,47,5,2,2,0,56,53,3
11186,E02004409,2011,60,513000,380000,34,12,12,2,0,60,54,6
11187,E02004409,2012,68,504000,433000,41,16,8,3,0,68,64,4
11188,E02004409,2013,68,551000,460000,47,12,6,3,1,67,64,4
11189,E02004409,2014,26,611000,445000,21,2,1,2,0,26,24,2
11190,E02004410,2009,95,398000,358000,67,24,3,1,0,95,94,1
11191,E02004410,2010,121,444000,366000,71,35,8,7,6,115,114,7
11192,E02004410,2011,92,408000,359000,47,23,10,12,7,85,81,11
11193,E02004410,2012,120,402000,346000,60,38,10,12,19,101,112,8
11194,E02004410,2013,142,416000,362000,76,44,14,8,10,132,133,9
11195,E02004410,2014,47,410000,360000,24,18,3,2,2,45,46,1
11196,E02004411,2009,172,224000,199000,45,51,36,40,19,153,133,39
11197,E02004411,2010,149,228000,198000,34,36,55,24,10,139,123,26
11198,E02004411,2011,173,227000,192000,42,52,53,26,10,163,145,28
11199,E02004411,2012,147,227000,200000,43,34,44,26,7,140,122,25
11200,E02004411,2013,138,213000,193000,37,31,39,31,1,137,104,34
11201,E02004411,2014,38,223000,204000,9,7,16,6,0,38,32,6
11202,E02004412,2009,140,220000,197000,54,29,30,27,9,131,113,27
11203,E02004412,2010,151,244000,225000,67,28,19,37,2,149,115,36
11204,E02004412,2011,128,247000,215000,59,30,13,26,1,127,102,26
11205,E02004412,2012,156,230000,205000,57,46,15,38,11,145,117,39
11206,E02004412,2013,170,249000,223000,55,51,42,22,23,147,146,24
11207,E02004412,2014,63,292000,266000,29,13,13,8,7,56,55,8
11208,E02004413,2009,105,299000,249000,52,33,11,9,3,102,97,8
11209,E02004413,2010,91,311000,270000,46,30,11,4,0,91,87,4
11210,E02004413,2011,85,325000,290000,52,23,6,4,0,85,81,4
11211,E02004413,2012,75,301000,236000,40,23,6,6,0,75,69,6
11212,E02004413,2013,93,333000,276000,41,27,16,9,4,89,84,9
11213,E02004413,2014,27,412000,273000,12,9,6,0,0,27,27,0
11214,E02004414,2009,107,216000,200000,30,27,38,12,15,92,95,12
11215,E02004414,2010,121,240000,230000,33,46,32,10,21,100,111,10
11216,E02004414,2011,145,238000,230000,48,50,33,14,61,84,133,12
11217,E02004414,2012,150,238000,240000,49,44,30,27,56,94,123,27
11218,E02004414,2013,151,261000,245000,45,53,39,14,37,114,137,14
11219,E02004414,2014,38,254000,248000,9,18,10,1,3,35,37,1
11220,E02004415,2009,85,376000,350000,52,23,8,2,30,55,81,4
11221,E02004415,2010,100,449000,400000,69,18,8,5,33,67,95,5
11222,E02004415,2011,78,357000,295000,33,30,14,1,24,54,76,2
11223,E02004415,2012,130,393000,282000,54,48,23,5,51,79,124,6
11224,E02004415,2013,122,370000,295000,63,32,25,2,53,69,119,3
11225,E02004415,2014,31,442000,430000,18,8,5,0,2,29,31,0
11226,E02004416,2009,66,338000,250000,48,15,3,0,6,60,66,0
11227,E02004416,2010,80,348000,312000,54,23,2,1,1,79,80,0
11228,E02004416,2011,75,356000,250000,41,24,9,1,0,75,74,1
11229,E02004416,2012,71,294000,245000,41,17,7,6,0,71,65,6
11230,E02004416,2013,88,326000,272000,51,25,10,2,0,88,86,2
11231,E02004416,2014,37,340000,286000,20,13,3,1,2,35,36,1
11232,E02004417,2009,101,175000,164000,30,41,19,11,1,100,90,11
11233,E02004417,2010,100,194000,168000,29,38,24,9,5,95,90,10
11234,E02004417,2011,147,187000,178000,45,57,33,12,26,121,138,9
11235,E02004417,2012,102,191000,185000,33,34,28,7,20,82,94,8
11236,E02004417,2013,184,222000,211000,83,54,44,3,59,125,181,3
11237,E02004417,2014,54,213000,208000,22,15,11,6,2,52,48,6
11238,E02004418,2009,72,191000,168000,25,30,14,3,0,72,69,3
11239,E02004418,2010,83,209000,200000,42,23,14,4,0,83,79,4
11240,E02004418,2011,79,192000,185000,29,30,12,8,8,71,71,8
11241,E02004418,2012,102,193000,184000,29,39,25,9,18,84,94,8
11242,E02004418,2013,79,201000,184000,28,31,16,4,1,78,76,3
11243,E02004418,2014,35,204000,194000,12,12,8,3,0,35,32,3
11244,E02004419,2009,61,159000,145000,16,17,21,7,4,57,55,6
11245,E02004419,2010,61,183000,153000,15,20,20,6,0,61,55,6
11246,E02004419,2011,47,155000,136000,10,14,18,5,0,47,40,7
11247,E02004419,2012,55,168000,145000,8,20,21,6,0,55,49,6
11248,E02004419,2013,62,164000,146000,12,23,20,7,3,59,55,7
11249,E02004419,2014,30,173000,176000,7,6,13,4,4,26,26,4
11250,E02004420,2009,152,285000,240000,75,61,16,0,23,129,152,0
11251,E02004420,2010,198,319000,262000,91,62,37,8,48,150,192,6
11252,E02004420,2011,200,301000,250000,103,43,46,8,87,113,194,6
11253,E02004420,2012,222,303000,248000,100,70,46,6,89,133,217,5
11254,E02004420,2013,298,301000,245000,124,82,69,23,125,173,275,23
11255,E02004420,2014,87,307000,245000,41,17,18,11,30,57,76,11
11256,E02004421,2009,166,172000,162000,34,91,19,22,0,166,140,26
11257,E02004421,2010,143,178000,176000,33,68,19,23,0,143,121,22
11258,E02004421,2011,173,183000,180000,48,76,19,30,18,155,142,31
11259,E02004421,2012,184,182000,175000,38,87,26,33,36,148,150,34
11260,E02004421,2013,226,193000,185000,51,107,24,44,41,185,179,47
11261,E02004421,2014,90,217000,204000,35,35,3,17,23,67,73,17
11262,E02004422,2009,172,213000,200000,94,39,29,10,0,172,159,13
11263,E02004422,2010,162,212000,204000,70,56,17,19,0,162,142,20
11264,E02004422,2011,178,218000,204000,72,58,37,11,8,170,165,13
11265,E02004422,2012,159,225000,208000,68,55,27,9,16,143,149,10
11266,E02004422,2013,192,226000,220000,94,58,25,15,14,178,178,14
11267,E02004422,2014,63,231000,205000,31,19,9,4,0,63,59,4
11268,E02004423,2009,149,208000,190000,60,64,10,15,0,149,134,15
11269,E02004423,2010,109,235000,203000,50,46,6,7,0,109,100,9
11270,E02004423,2011,127,208000,195000,45,55,15,12,0,127,115,12
11271,E02004423,2012,119,219000,190000,47,51,7,14,0,119,105,14
11272,E02004423,2013,170,239000,210000,78,75,10,7,1,169,163,7
11273,E02004423,2014,63,225000,198000,30,20,5,8,0,63,54,9
11274,E02004424,2009,107,334000,303000,54,34,14,5,4,103,102,5
11275,E02004424,2010,112,390000,299000,51,45,10,6,5,107,106,6
11276,E02004424,2011,95,387000,368000,51,30,11,3,1,94,91,4
11277,E02004424,2012,86,382000,348000,47,22,9,8,1,85,78,8
11278,E02004424,2013,112,387000,322000,52,38,18,4,0,112,109,3
11279,E02004424,2014,41,402000,330000,17,16,5,3,0,41,38,3
11280,E02004425,2009,103,240000,215000,20,48,24,11,0,103,92,11
11281,E02004425,2010,125,258000,250000,29,57,27,12,0,125,111,14
11282,E02004425,2011,117,254000,248000,24,38,36,19,1,116,97,20
11283,E02004425,2012,102,255000,235000,18,40,34,10,0,102,93,9
11284,E02004425,2013,167,277000,250000,43,63,43,18,1,166,150,17
11285,E02004425,2014,56,279000,272000,11,20,15,10,11,45,45,11
11286,E02004426,2009,123,278000,238000,33,39,21,30,8,115,93,30
11287,E02004426,2010,112,362000,255000,48,28,16,20,9,103,91,21
11288,E02004426,2011,99,313000,242000,29,32,14,24,8,91,75,24
11289,E02004426,2012,137,332000,250000,39,45,26,27,9,128,110,27
11290,E02004426,2013,148,348000,271000,57,45,30,16,1,147,133,15
11291,E02004426,2014,48,353000,295000,18,10,14,6,0,48,42,6
11292,E02004427,2009,115,299000,240000,43,43,13,16,3,112,96,19
11293,E02004427,2010,118,312000,295000,44,45,10,19,1,117,99,19
11294,E02004427,2011,102,347000,309000,43,30,10,19,0,102,83,19
11295,E02004427,2012,146,322000,275000,38,52,37,19,26,120,126,20
11296,E02004427,2013,174,338000,315000,56,71,22,25,25,149,149,25
11297,E02004427,2014,48,357000,330000,18,17,3,10,5,43,37,11
11298,E02004428,2009,72,221000,184000,22,26,6,18,19,53,55,17
11299,E02004428,2010,97,203000,175000,25,21,10,41,28,69,55,42
11300,E02004428,2011,73,210000,190000,19,25,16,13,11,62,60,13
11301,E02004428,2012,126,227000,216000,33,50,19,24,50,76,100,26
11302,E02004428,2013,130,223000,222000,25,63,20,22,35,95,107,23
11303,E02004428,2014,54,221000,222000,17,17,7,13,7,47,42,12
11304,E02004429,2009,112,223000,174000,28,39,8,37,34,78,75,37
11305,E02004429,2010,84,270000,217000,24,46,8,6,1,83,78,6
11306,E02004429,2011,112,293000,215000,36,54,6,16,0,112,96,16
11307,E02004429,2012,73,287000,225000,23,40,3,7,0,73,66,7
11308,E02004429,2013,101,284000,230000,30,59,3,9,1,100,92,9
11309,E02004429,2014,34,334000,232000,11,18,2,3,1,33,31,3
11310,E02004430,2009,105,200000,189000,31,51,19,4,2,103,101,4
11311,E02004430,2010,101,220000,208000,28,49,20,4,0,101,97,4
11312,E02004430,2011,108,199000,193000,22,57,24,5,0,108,103,5
11313,E02004430,2012,110,212000,202000,31,51,26,2,0,110,108,2
11314,E02004430,2013,129,212000,198000,28,65,32,4,0,129,125,4
11315,E02004430,2014,62,231000,227000,19,24,18,1,0,62,61,1
11316,E02004431,2009,138,183000,174000,30,46,53,9,6,132,128,10
11317,E02004431,2010,152,200000,188000,41,45,48,18,17,135,133,19
11318,E02004431,2011,134,195000,178000,27,43,51,13,6,128,118,16
11319,E02004431,2012,134,197000,191000,31,46,48,9,3,131,123,11
11320,E02004431,2013,169,208000,193000,37,51,74,7,5,164,162,7
11321,E02004431,2014,63,215000,204000,16,17,24,6,5,58,55,8
11322,E02004432,2009,53,294000,242000,25,21,6,1,1,52,52,1
11323,E02004432,2010,90,321000,250000,30,33,17,10,4,86,82,8
11324,E02004432,2011,88,332000,250000,39,40,5,4,0,88,84,4
11325,E02004432,2012,80,270000,232000,21,37,16,6,6,74,74,6
11326,E02004432,2013,60,308000,266000,25,21,7,7,2,58,53,7
11327,E02004432,2014,41,388000,333000,22,12,5,2,0,41,39,2
11328,E02004433,2009,97,177000,174000,22,13,31,31,12,85,65,32
11329,E02004433,2010,162,191000,172000,28,34,39,61,43,119,99,63
11330,E02004433,2011,111,185000,178000,24,21,34,32,2,109,77,34
11331,E02004433,2012,100,201000,188000,22,17,39,22,1,99,78,22
11332,E02004433,2013,118,204000,194000,26,27,38,27,1,117,90,28
11333,E02004433,2014,45,208000,188000,6,11,18,10,0,45,34,11
11334,E02004434,2009,74,150000,135000,17,16,25,16,0,74,57,17
11335,E02004434,2010,105,156000,135000,22,23,29,31,0,105,70,35
11336,E02004434,2011,89,162000,140000,19,20,25,25,1,88,64,25
11337,E02004434,2012,92,163000,148000,12,25,38,17,2,90,72,20
11338,E02004434,2013,122,170000,144000,29,20,49,24,1,121,95,27
11339,E02004434,2014,58,165000,148000,12,8,23,15,1,57,42,16
11340,E02004435,2009,67,136000,135000,0,12,52,3,0,67,64,3
11341,E02004435,2010,62,146000,149000,1,8,52,1,0,62,61,1
11342,E02004435,2011,181,173000,165000,16,40,112,13,91,90,172,9
11343,E02004435,2012,190,159000,150000,12,20,100,58,109,81,134,56
11344,E02004435,2013,127,173000,165000,9,30,73,15,48,79,112,15
11345,E02004435,2014,45,169000,167000,3,8,30,4,1,44,41,4
11346,E02004436,2009,39,109000,117000,0,3,26,10,0,39,28,11
11347,E02004436,2010,36,127000,124000,1,3,26,6,0,36,30,6
11348,E02004436,2011,44,123000,125000,0,8,32,4,0,44,39,5
11349,E02004436,2012,43,124000,128000,1,1,33,8,1,42,34,9
11350,E02004436,2013,51,132000,135000,0,2,42,7,0,51,43,8
11351,E02004436,2014,21,137000,145000,1,0,17,3,0,21,18,3
11352,E02004437,2009,101,180000,174000,14,20,39,28,36,65,73,28
11353,E02004437,2010,93,204000,195000,21,17,38,17,19,74,77,16
11354,E02004437,2011,105,182000,180000,11,25,58,11,27,78,93,12
11355,E02004437,2012,99,228000,236000,36,22,29,12,42,57,88,11
11356,E02004437,2013,106,186000,169000,22,15,43,26,21,85,78,28
11357,E02004437,2014,51,178000,170000,8,7,15,21,14,37,30,21
11358,E02004438,2009,62,129000,130000,0,11,39,12,7,55,50,12
11359,E02004438,2010,56,141000,140000,0,13,39,4,0,56,51,5
11360,E02004438,2011,100,138000,142000,0,5,49,46,36,64,53,47
11361,E02004438,2012,121,168000,157000,6,24,54,37,60,61,84,37
11362,E02004438,2013,148,151000,149000,3,14,72,59,61,87,89,59
11363,E02004438,2014,29,151000,150000,0,1,20,8,1,28,22,7
11364,E02004439,2009,45,155000,140000,2,3,35,5,12,33,43,2
11365,E02004439,2010,49,127000,125000,0,6,29,14,0,49,38,11
11366,E02004439,2011,34,143000,140000,2,4,24,4,1,33,31,3
11367,E02004439,2012,71,154000,136000,2,12,45,12,15,56,64,7
11368,E02004439,2013,49,140000,136000,2,2,31,14,4,45,40,9
11369,E02004439,2014,24,146000,148000,1,1,16,6,0,24,18,6
11370,E02004440,2009,56,140000,134000,2,7,38,9,0,56,48,8
11371,E02004440,2010,59,143000,145000,0,6,44,9,0,59,50,9
11372,E02004440,2011,79,140000,140000,1,7,61,10,0,79,69,10
11373,E02004440,2012,90,173000,164000,3,6,71,10,28,62,80,10
11374,E02004440,2013,123,188000,175000,8,22,76,17,55,68,107,16
11375,E02004440,2014,44,168000,156000,0,0,40,4,6,38,40,4
11376,E02004441,2009,42,160000,150000,10,9,17,6,0,42,36,6
11377,E02004441,2010,57,152000,138000,6,12,31,8,0,57,49,8
11378,E02004441,2011,46,154000,138000,8,11,21,6,0,46,40,6
11379,E02004441,2012,55,158000,149000,9,13,25,8,1,54,47,8
11380,E02004441,2013,66,162000,156000,6,21,31,8,2,64,60,6
11381,E02004441,2014,25,175000,148000,4,5,10,6,0,25,19,6
11382,E02004442,2009,52,121000,121000,3,7,30,12,0,52,42,10
11383,E02004442,2010,47,134000,130000,2,8,32,5,0,47,42,5
11384,E02004442,2011,38,126000,131000,0,5,25,8,0,38,31,7
11385,E02004442,2012,42,152000,140000,6,6,28,2,0,42,40,2
11386,E02004442,2013,59,126000,130000,1,3,44,11,0,59,48,11
11387,E02004442,2014,31,148000,150000,2,2,23,4,0,31,26,5
11388,E02004443,2009,84,162000,152000,5,9,42,28,24,60,55,29
11389,E02004443,2010,109,176000,158000,11,9,44,45,38,71,63,46
11390,E02004443,2011,101,177000,154000,12,10,42,37,31,70,63,38
11391,E02004443,2012,109,173000,158000,9,10,43,47,39,70,62,47
11392,E02004443,2013,151,176000,153000,14,13,50,74,63,88,73,78
11393,E02004443,2014,39,170000,163000,2,1,17,19,16,23,20,19
11394,E02004444,2009,93,237000,220000,47,14,20,12,1,92,80,13
11395,E02004444,2010,109,244000,227000,45,26,25,13,0,109,94,15
11396,E02004444,2011,102,246000,229000,45,13,23,21,1,101,82,20
11397,E02004444,2012,109,232000,218000,40,17,31,21,0,109,88,21
11398,E02004444,2013,114,238000,220000,48,13,40,13,0,114,101,13
11399,E02004444,2014,55,251000,244000,22,14,11,8,0,55,47,8
11400,E02004445,2009,57,140000,140000,6,11,26,14,0,57,43,14
11401,E02004445,2010,71,145000,140000,6,10,38,17,0,71,52,19
11402,E02004445,2011,65,152000,143000,10,16,28,11,0,65,54,11
11403,E02004445,2012,83,155000,143000,11,14,43,15,1,82,68,15
11404,E02004445,2013,96,146000,150000,9,9,48,30,0,96,63,33
11405,E02004445,2014,33,148000,158000,6,7,8,12,0,33,21,12
11406,E02004446,2009,74,230000,196000,33,24,16,1,1,73,72,2
11407,E02004446,2010,82,270000,219000,37,35,10,0,0,82,82,0
11408,E02004446,2011,84,278000,225000,49,24,10,1,0,84,83,1
11409,E02004446,2012,73,269000,225000,48,15,10,0,0,73,73,0
11410,E02004446,2013,111,277000,232000,63,34,14,0,2,109,111,0
11411,E02004446,2014,31,289000,228000,16,10,5,0,1,30,31,0
11412,E02004447,2009,61,295000,250000,32,17,11,1,0,61,61,0
11413,E02004447,2010,52,438000,325000,40,4,8,0,0,52,52,0
11414,E02004447,2011,62,315000,290000,38,19,4,1,1,61,61,1
11415,E02004447,2012,53,324000,262000,32,15,6,0,1,52,53,0
11416,E02004447,2013,69,316000,285000,45,16,7,1,1,68,69,0
11417,E02004447,2014,26,454000,320000,17,7,2,0,0,26,26,0
11418,E02004448,2009,93,218000,180000,33,35,21,4,8,85,89,4
11419,E02004448,2010,75,227000,172000,27,29,14,5,0,75,70,5
11420,E02004448,2011,83,259000,225000,33,25,19,6,7,76,78,5
11421,E02004448,2012,87,248000,228000,31,33,17,6,3,84,82,5
11422,E02004448,2013,104,233000,201000,44,36,17,7,3,101,97,7
11423,E02004448,2014,43,257000,225000,13,16,10,4,2,41,39,4
11424,E02004449,2009,133,149000,145000,12,42,60,19,20,113,115,18
11425,E02004449,2010,142,156000,140000,18,38,44,42,35,107,102,40
11426,E02004449,2011,120,158000,144000,18,39,39,24,6,114,95,25
11427,E02004449,2012,112,163000,156000,16,33,45,18,4,108,91,21
11428,E02004449,2013,151,165000,155000,16,46,60,29,8,143,125,26
11429,E02004449,2014,49,163000,150000,3,15,23,8,2,47,41,8
11430,E02004450,2009,60,282000,229000,24,31,4,1,0,60,58,2
11431,E02004450,2010,72,314000,250000,37,24,8,3,3,69,70,2
11432,E02004450,2011,67,383000,310000,44,17,6,0,1,66,66,1
11433,E02004450,2012,72,317000,274000,41,23,8,0,0,72,72,0
11434,E02004450,2013,68,330000,278000,33,27,8,0,0,68,68,0
11435,E02004450,2014,25,366000,322000,12,10,3,0,0,25,25,0
11436,E02004451,2009,108,216000,171000,32,43,33,0,2,106,106,2
11437,E02004451,2010,119,229000,185000,37,46,32,4,0,119,111,8
11438,E02004451,2011,130,231000,192000,49,47,32,2,0,130,127,3
11439,E02004451,2012,108,214000,182000,30,38,36,4,6,102,98,10
11440,E02004451,2013,141,230000,205000,47,46,44,4,8,133,131,10
11441,E02004451,2014,48,235000,208000,16,11,19,2,4,44,43,5
11442,E02004452,2009,156,197000,188000,46,51,42,17,39,117,139,17
11443,E02004452,2010,149,222000,203000,70,38,20,21,42,107,128,21
11444,E02004452,2011,152,221000,199000,65,49,27,11,40,112,142,10
11445,E02004452,2012,136,230000,220000,58,41,28,9,26,110,125,11
11446,E02004452,2013,123,244000,218000,63,31,20,9,3,120,114,9
11447,E02004452,2014,55,233000,223000,26,15,12,2,1,54,53,2
11448,E02004453,2009,92,156000,150000,6,46,29,11,34,58,82,10
11449,E02004453,2010,59,180000,150000,8,22,20,9,4,55,50,9
11450,E02004453,2011,49,169000,158000,4,29,7,9,0,49,41,8
11451,E02004453,2012,74,171000,155000,9,28,26,11,7,67,62,12
11452,E02004453,2013,84,181000,165000,12,28,32,12,4,80,74,10
11453,E02004453,2014,32,195000,160000,5,5,14,8,1,31,23,9
11454,E02004454,2009,116,155000,145000,12,32,29,43,18,98,73,43
11455,E02004454,2010,137,166000,160000,17,40,31,49,18,119,88,49
11456,E02004454,2011,137,166000,152000,29,29,23,56,20,117,82,55
11457,E02004454,2012,154,168000,153000,23,31,47,53,36,118,102,52
11458,E02004454,2013,206,164000,148000,23,40,46,97,32,174,110,96
11459,E02004454,2014,59,152000,150000,4,11,20,24,0,59,35,24
11460,E02004455,2009,104,224000,200000,44,41,18,1,2,102,103,1
11461,E02004455,2010,105,266000,240000,44,33,26,2,21,84,103,2
11462,E02004455,2011,108,229000,189000,35,33,21,19,28,80,88,20
11463,E02004455,2012,82,231000,212000,27,30,20,5,2,80,76,6
11464,E02004455,2013,96,252000,223000,39,34,20,3,2,94,93,3
11465,E02004455,2014,50,266000,238000,23,19,6,2,2,48,48,2
11466,E02004456,2009,112,145000,138000,13,49,37,13,4,108,94,18
11467,E02004456,2010,160,160000,151000,22,59,45,34,45,115,124,36
11468,E02004456,2011,185,174000,158000,35,65,61,24,49,136,158,27
11469,E02004456,2012,98,176000,164000,15,33,38,12,19,79,84,14
11470,E02004456,2013,145,169000,160000,23,44,62,16,10,135,126,19
11471,E02004456,2014,56,163000,161000,4,19,25,8,0,56,46,10
11472,E02004457,2009,111,190000,175000,31,39,35,6,26,85,105,6
11473,E02004457,2010,118,203000,178000,25,51,27,15,20,98,103,15
11474,E02004457,2011,127,201000,181000,33,50,35,9,15,112,118,9
11475,E02004457,2012,122,203000,182000,29,47,36,10,6,116,111,11
11476,E02004457,2013,137,205000,180000,31,53,46,7,0,137,131,6
11477,E02004457,2014,51,251000,220000,18,19,13,1,0,51,49,2
11478,E02004458,2009,141,223000,206000,60,35,36,10,5,136,131,10
11479,E02004458,2010,146,243000,219000,63,44,32,7,1,145,137,9
11480,E02004458,2011,143,235000,205000,55,47,34,7,2,141,133,10
11481,E02004458,2012,131,240000,220000,49,25,51,6,1,130,122,9
11482,E02004458,2013,177,271000,250000,85,39,40,13,3,174,163,14
11483,E02004458,2014,56,265000,249000,24,15,14,3,2,54,52,4
11484,E02004459,2009,132,239000,212000,41,54,22,15,11,121,118,14
11485,E02004459,2010,145,291000,250000,56,49,27,13,7,138,132,13
11486,E02004459,2011,164,288000,240000,56,71,27,10,5,159,153,11
11487,E02004459,2012,141,289000,240000,48,50,35,8,1,140,131,10
11488,E02004459,2013,175,275000,245000,55,59,43,18,2,173,155,20
11489,E02004459,2014,50,277000,249000,16,6,19,9,0,50,41,9
11490,E02004460,2009,115,167000,146000,13,44,21,37,33,82,76,39
11491,E02004460,2010,89,180000,162000,5,46,30,8,1,88,84,5
11492,E02004460,2011,97,174000,168000,11,49,34,3,0,97,92,5
11493,E02004460,2012,84,189000,175000,9,40,26,9,0,84,75,9
11494,E02004460,2013,129,190000,175000,12,60,47,10,0,129,123,6
11495,E02004460,2014,55,225000,199000,9,18,23,5,0,55,51,4
11496,E02004461,2009,52,143000,136000,4,9,37,2,1,51,51,1
11497,E02004461,2010,38,138000,137000,0,5,31,2,0,38,37,1
11498,E02004461,2011,50,137000,138000,2,4,40,4,0,50,45,5
11499,E02004461,2012,44,155000,141000,3,4,36,1,0,44,43,1
11500,E02004461,2013,61,157000,152000,1,7,46,7,0,61,54,7
11501,E02004461,2014,23,157000,160000,0,2,19,2,0,23,21,2
11502,E02004462,2009,125,170000,149000,22,17,51,35,11,114,88,37
11503,E02004462,2010,207,177000,155000,21,37,66,83,76,131,124,83
11504,E02004462,2011,150,169000,153000,18,22,53,57,10,140,91,59
11505,E02004462,2012,139,174000,158000,17,23,45,54,3,136,83,56
11506,E02004462,2013,187,176000,158000,22,22,79,64,4,183,118,69
11507,E02004462,2014,90,175000,166000,7,13,35,35,8,82,53,37
11508,E02004463,2009,87,227000,175000,22,36,20,9,1,86,77,10
11509,E02004463,2010,97,291000,248000,42,35,14,6,7,90,90,7
11510,E02004463,2011,100,238000,200000,29,46,19,6,2,98,93,7
11511,E02004463,2012,76,235000,210000,26,25,19,6,1,75,70,6
11512,E02004463,2013,91,286000,245000,36,21,28,6,2,89,84,7
11513,E02004463,2014,51,268000,250000,19,15,13,4,0,51,48,3
11514,E02004464,2009,83,334000,297000,39,30,13,1,0,83,82,1
11515,E02004464,2010,73,438000,365000,46,22,5,0,1,72,73,0
11516,E02004464,2011,85,381000,325000,48,27,10,0,0,85,84,1
11517,E02004464,2012,98,360000,314000,50,34,14,0,0,98,97,1
11518,E02004464,2013,127,376000,325000,71,38,15,3,0,127,124,3
11519,E02004464,2014,57,409000,370000,38,12,5,2,1,56,55,2
11520,E02004465,2009,60,359000,302000,21,22,11,6,0,60,54,6
11521,E02004465,2010,93,448000,308000,35,27,15,16,0,93,77,16
11522,E02004465,2011,66,411000,319000,16,30,9,11,0,66,55,11
11523,E02004465,2012,80,365000,318000,24,30,14,12,0,80,68,12
11524,E02004465,2013,112,438000,355000,34,44,17,17,0,112,96,16
11525,E02004465,2014,35,400000,372000,10,13,8,4,0,35,31,4
11526,E02004466,2009,72,267000,233000,17,34,15,6,0,72,65,7
11527,E02004466,2010,89,282000,250000,18,47,18,6,1,88,82,7
11528,E02004466,2011,88,262000,242000,13,45,22,8,0,88,79,9
11529,E02004466,2012,116,251000,246000,17,55,34,10,0,116,105,11
11530,E02004466,2013,95,277000,243000,10,40,34,11,1,94,84,11
11531,E02004466,2014,47,282000,265000,4,22,16,5,3,44,42,5
11532,E02004467,2009,97,219000,208000,12,34,30,21,5,92,74,23
11533,E02004467,2010,104,322000,272000,17,42,23,22,40,64,83,21
11534,E02004467,2011,114,289000,249000,23,42,28,21,34,80,87,27
11535,E02004467,2012,170,298000,270000,28,54,64,24,70,100,146,24
11536,E02004467,2013,160,310000,259000,24,47,56,33,35,125,112,48
11537,E02004467,2014,41,301000,262000,9,6,14,12,2,39,28,13
11538,E02004468,2009,155,527000,455000,102,31,4,18,1,154,136,19
11539,E02004468,2010,161,548000,500000,95,36,3,27,1,160,132,29
11540,E02004468,2011,137,620000,500000,76,35,5,21,0,137,115,22
11541,E02004468,2012,152,596000,518000,99,36,7,10,1,151,142,10
11542,E02004468,2013,196,552000,480000,106,43,9,38,5,191,158,38
11543,E02004468,2014,66,567000,508000,42,13,1,10,0,66,56,10
11544,E02004469,2009,69,311000,250000,24,29,5,11,0,69,58,11
11545,E02004469,2010,90,343000,300000,32,43,10,5,0,90,85,5
11546,E02004469,2011,78,338000,282000,25,35,12,6,0,78,71,7
11547,E02004469,2012,98,337000,301000,41,35,10,12,0,98,86,12
11548,E02004469,2013,123,345000,300000,34,52,23,14,0,123,108,15
11549,E02004469,2014,38,359000,322000,9,18,7,4,0,38,34,4
11550,E02004470,2009,244,236000,216000,23,37,75,109,66,178,130,114
11551,E02004470,2010,271,238000,220000,20,39,61,151,76,195,120,151
11552,E02004470,2011,256,260000,228000,21,43,68,124,52,204,131,125
11553,E02004470,2012,236,239000,225000,14,28,67,127,31,205,110,126
11554,E02004470,2013,337,255000,228000,23,38,109,167,43,294,171,166
11555,E02004470,2014,114,285000,246000,16,8,31,59,6,108,55,59
11556,E02004471,2009,110,288000,250000,19,31,18,42,27,83,70,40
11557,E02004471,2010,135,267000,235000,22,35,30,48,12,123,82,53
11558,E02004471,2011,123,306000,220000,21,25,25,52,28,95,73,50
11559,E02004471,2012,139,294000,245000,22,28,23,66,26,113,74,65
11560,E02004471,2013,176,303000,250000,26,30,26,94,48,128,85,91
11561,E02004471,2014,63,315000,272000,7,12,8,36,16,47,28,35
11562,E02004472,2009,77,386000,250000,29,28,13,7,1,76,68,9
11563,E02004472,2010,93,390000,278000,33,35,13,12,0,93,81,12
11564,E02004472,2011,93,369000,270000,25,42,15,11,0,93,82,11
11565,E02004472,2012,80,419000,284000,23,33,16,8,0,80,72,8
11566,E02004472,2013,108,348000,290000,38,39,17,14,1,107,93,15
11567,E02004472,2014,33,342000,270000,6,16,5,6,0,33,27,6
11568,E02004473,2009,66,187000,181000,10,45,5,6,1,65,59,7
11569,E02004473,2010,83,198000,200000,20,42,6,15,1,82,68,15
11570,E02004473,2011,71,198000,192000,14,48,4,5,0,71,65,6
11571,E02004473,2012,88,201000,195000,20,42,10,16,2,86,71,17
11572,E02004473,2013,103,198000,196000,14,63,12,14,3,100,89,14
11573,E02004473,2014,43,214000,210000,10,20,9,4,0,43,39,4
11574,E02004474,2009,98,235000,200000,29,54,6,9,6,92,89,9
11575,E02004474,2010,87,215000,195000,19,57,5,6,2,85,81,6
11576,E02004474,2011,86,224000,196000,21,59,3,3,2,84,82,4
11577,E02004474,2012,94,223000,211000,22,60,7,5,0,94,89,5
11578,E02004474,2013,130,246000,217000,43,67,12,8,1,129,122,8
11579,E02004474,2014,34,278000,248000,16,16,0,2,1,33,32,2
11580,E02004475,2009,95,199000,185000,28,44,6,17,14,81,77,18
11581,E02004475,2010,64,237000,219000,19,36,4,5,2,62,59,5
11582,E02004475,2011,73,223000,207000,27,44,1,1,1,72,72,1
11583,E02004475,2012,85,216000,200000,30,41,8,6,0,85,79,6
11584,E02004475,2013,107,234000,218000,42,48,7,10,3,104,97,10
11585,E02004475,2014,35,237000,230000,14,17,0,4,0,35,31,4
11586,E02004476,2009,97,261000,230000,54,30,3,10,3,94,86,11
11587,E02004476,2010,105,292000,238000,54,41,1,9,6,99,96,9
11588,E02004476,2011,98,252000,215000,39,42,1,16,2,96,82,16
11589,E02004476,2012,94,301000,246000,49,38,2,5,0,94,89,5
11590,E02004476,2013,110,325000,248000,51,49,2,8,2,108,102,8
11591,E02004476,2014,52,299000,248000,25,19,2,6,3,49,46,6
11592,E02004477,2009,75,233000,215000,29,45,1,0,1,74,75,0
11593,E02004477,2010,110,254000,240000,40,66,2,2,3,107,108,2
11594,E02004477,2011,102,261000,230000,39,57,6,0,15,87,101,1
11595,E02004477,2012,89,274000,240000,41,38,8,2,0,89,86,3
11596,E02004477,2013,117,272000,250000,50,55,9,3,0,117,114,3
11597,E02004477,2014,38,305000,258000,19,18,1,0,0,38,38,0
11598,E02004478,2009,101,205000,175000,24,23,12,42,5,96,57,44
11599,E02004478,2010,97,214000,191000,28,31,10,28,3,94,69,28
11600,E02004478,2011,77,203000,180000,19,25,15,18,2,75,54,23
11601,E02004478,2012,79,209000,192000,24,28,9,18,0,79,60,19
11602,E02004478,2013,109,190000,175000,21,34,16,38,0,109,68,41
11603,E02004478,2014,41,209000,200000,9,9,3,20,0,41,20,21
11604,E02004479,2009,107,219000,190000,31,57,4,15,10,97,92,15
11605,E02004479,2010,105,229000,204000,24,63,8,10,2,103,91,14
11606,E02004479,2011,97,229000,210000,30,56,4,7,0,97,90,7
11607,E02004479,2012,106,227000,207000,32,59,7,8,6,100,97,9
11608,E02004479,2013,156,244000,230000,42,84,11,19,16,140,136,20
11609,E02004479,2014,60,240000,226000,16,35,5,4,5,55,56,4
11610,E02004480,2009,57,167000,155000,28,13,9,7,1,56,50,7
11611,E02004480,2010,70,188000,174000,41,15,10,4,0,70,65,5
11612,E02004480,2011,59,185000,170000,28,19,5,7,0,59,52,7
11613,E02004480,2012,93,186000,170000,49,28,11,5,0,93,88,5
11614,E02004480,2013,110,180000,162000,62,32,10,6,0,110,104,6
11615,E02004480,2014,36,206000,180000,19,10,7,0,0,36,36,0
11616,E02004481,2009,71,152000,154000,32,30,9,0,0,71,71,0
11617,E02004481,2010,74,167000,160000,40,26,7,1,0,74,73,1
11618,E02004481,2011,74,164000,163000,39,30,4,1,0,74,72,2
11619,E02004481,2012,75,162000,152000,49,20,4,2,0,75,73,2
11620,E02004481,2013,92,166000,160000,59,24,7,2,1,91,90,2
11621,E02004481,2014,36,183000,168000,24,8,2,2,1,35,34,2
11622,E02004482,2009,50,149000,150000,10,19,20,1,0,50,49,1
11623,E02004482,2010,63,160000,154000,12,34,15,2,0,63,61,2
11624,E02004482,2011,60,159000,155000,15,28,17,0,0,60,59,1
11625,E02004482,2012,66,152000,148000,10,26,26,4,0,66,61,5
11626,E02004482,2013,82,160000,158000,22,33,25,2,0,82,79,3
11627,E02004482,2014,23,159000,155000,5,8,10,0,0,23,23,0
11628,E02004483,2009,93,181000,170000,50,33,7,3,0,93,90,3
11629,E02004483,2010,111,201000,190000,51,38,6,16,13,98,94,17
11630,E02004483,2011,88,183000,169000,47,26,6,9,7,81,79,9
11631,E02004483,2012,89,190000,185000,51,34,2,2,2,87,87,2
11632,E02004483,2013,110,190000,182000,69,36,4,1,0,110,109,1
11633,E02004483,2014,55,203000,200000,38,12,2,3,0,55,52,3
11634,E02004484,2009,124,165000,155000,79,36,2,7,0,124,116,8
11635,E02004484,2010,75,168000,162000,47,20,2,6,0,75,69,6
11636,E02004484,2011,94,169000,155000,56,34,2,2,0,94,92,2
11637,E02004484,2012,107,159000,152000,60,24,1,22,17,90,85,22
11638,E02004484,2013,124,187000,174000,94,23,4,3,0,124,122,2
11639,E02004484,2014,41,177000,166000,28,11,0,2,0,41,39,2
11640,E02004485,2009,76,284000,235000,39,16,20,1,6,70,75,1
11641,E02004485,2010,85,355000,306000,46,20,15,4,1,84,81,4
11642,E02004485,2011,86,303000,246000,35,30,11,10,0,86,77,9
11643,E02004485,2012,72,328000,268000,28,15,24,5,1,71,66,6
11644,E02004485,2013,86,298000,250000,35,14,32,5,0,86,80,6
11645,E02004485,2014,23,367000,330000,12,5,4,2,0,23,22,1
11646,E02004486,2009,95,241000,225000,34,39,18,4,0,95,90,5
11647,E02004486,2010,129,234000,220000,29,55,33,12,13,116,117,12
11648,E02004486,2011,134,248000,242000,37,58,29,10,8,126,124,10
11649,E02004486,2012,114,270000,250000,42,47,11,14,2,112,100,14
11650,E02004486,2013,120,284000,263000,37,52,21,10,8,112,110,10
11651,E02004486,2014,51,302000,280000,12,24,12,3,9,42,49,2
11652,E02004487,2009,57,233000,180000,17,21,12,7,6,51,50,7
11653,E02004487,2010,75,201000,180000,18,25,20,12,0,75,62,13
11654,E02004487,2011,64,252000,224000,25,26,10,3,0,64,60,4
11655,E02004487,2012,76,244000,192000,15,31,25,5,0,76,70,6
11656,E02004487,2013,99,228000,210000,29,32,31,7,0,99,92,7
11657,E02004487,2014,24,250000,200000,5,6,9,4,0,24,20,4
11658,E02004488,2009,113,182000,175000,15,44,24,30,0,113,84,29
11659,E02004488,2010,112,203000,208000,17,38,34,23,0,112,88,24
11660,E02004488,2011,117,190000,207000,11,42,32,32,0,117,82,35
11661,E02004488,2012,111,203000,204000,20,32,34,25,0,111,85,26
11662,E02004488,2013,128,210000,215000,23,33,39,33,0,128,95,33
11663,E02004488,2014,53,217000,235000,9,15,16,13,0,53,40,13
11664,E02004489,2009,133,333000,295000,70,40,18,5,15,118,130,3
11665,E02004489,2010,146,328000,277000,79,37,22,8,2,144,135,11
11666,E02004489,2011,94,283000,238000,37,27,13,17,1,93,76,18
11667,E02004489,2012,121,345000,267000,53,35,21,12,2,119,108,13
11668,E02004489,2013,141,331000,268000,57,38,33,13,1,140,127,14
11669,E02004489,2014,47,381000,325000,29,5,10,3,0,47,42,5
11670,E02004490,2009,55,175000,168000,7,23,15,10,1,54,43,12
11671,E02004490,2010,42,188000,176000,1,20,14,7,0,42,35,7
11672,E02004490,2011,62,197000,171000,5,32,16,9,0,62,53,9
11673,E02004490,2012,63,185000,173000,5,24,19,15,1,62,48,15
11674,E02004490,2013,72,205000,198000,7,27,21,17,2,70,55,17
11675,E02004490,2014,18,227000,195000,4,8,3,3,0,18,15,3
11676,E02004491,2009,119,235000,192000,35,43,30,11,4,115,106,13
11677,E02004491,2010,103,233000,200000,29,28,30,16,0,103,85,18
11678,E02004491,2011,97,223000,200000,22,33,33,9,2,95,85,12
11679,E02004491,2012,97,273000,220000,34,24,25,14,4,93,83,14
11680,E02004491,2013,95,247000,220000,25,26,32,12,0,95,83,12
11681,E02004491,2014,37,305000,231000,12,8,8,9,0,37,28,9
11682,E02004492,2009,168,195000,176000,32,50,40,46,30,138,122,46
11683,E02004492,2010,160,222000,198000,41,51,37,31,0,160,127,33
11684,E02004492,2011,155,210000,190000,30,42,57,26,13,142,129,26
11685,E02004492,2012,176,211000,198000,23,51,55,47,8,168,127,49
11686,E02004492,2013,188,215000,197000,28,48,66,46,1,187,142,46
11687,E02004492,2014,62,239000,212000,11,8,18,25,0,62,36,26
11688,E02004493,2009,117,211000,184000,20,45,20,32,0,117,82,35
11689,E02004493,2010,147,226000,195000,21,38,54,34,9,138,113,34
11690,E02004493,2011,166,230000,203000,20,58,46,42,0,166,124,42
11691,E02004493,2012,152,249000,215000,32,39,38,43,10,142,110,42
11692,E02004493,2013,172,241000,219000,20,48,57,47,4,168,125,47
11693,E02004493,2014,59,229000,210000,7,13,21,18,0,59,40,19
11694,E02004494,2009,207,176000,175000,5,20,56,126,41,166,75,132
11695,E02004494,2010,214,195000,185000,9,26,57,122,24,190,92,122
11696,E02004494,2011,214,189000,187000,11,24,70,109,12,202,105,109
11697,E02004494,2012,163,195000,185000,7,20,50,86,15,148,75,88
11698,E02004494,2013,253,200000,192000,9,20,76,148,11,242,105,148
11699,E02004494,2014,124,200000,186000,3,5,26,90,28,96,34,90
11700,E02004495,2009,80,304000,223000,18,40,12,10,1,79,68,12
11701,E02004495,2010,103,293000,250000,28,49,16,10,0,103,93,10
11702,E02004495,2011,91,284000,250000,19,48,16,8,5,86,81,10
11703,E02004495,2012,83,305000,250000,21,33,19,10,3,80,73,10
11704,E02004495,2013,113,335000,275000,41,39,28,5,8,105,107,6
11705,E02004495,2014,32,299000,255000,6,11,14,1,4,28,31,1
11706,E02004496,2009,102,251000,236000,31,49,18,4,1,101,97,5
11707,E02004496,2010,124,260000,250000,34,63,20,7,14,110,114,10
11708,E02004496,2011,98,294000,252000,25,55,14,4,1,97,92,6
11709,E02004496,2012,146,266000,250000,16,80,22,28,18,128,118,28
11710,E02004496,2013,166,269000,250000,27,77,23,39,33,133,126,40
11711,E02004496,2014,48,310000,299000,13,17,13,5,8,40,43,5
11712,E02004497,2009,94,238000,218000,25,39,13,17,4,90,72,22
11713,E02004497,2010,110,295000,268000,38,41,14,17,5,105,91,19
11714,E02004497,2011,105,268000,242000,37,30,11,27,4,101,78,27
11715,E02004497,2012,99,270000,247000,40,23,14,22,5,94,74,25
11716,E02004497,2013,139,288000,250000,39,48,39,13,2,137,117,22
11717,E02004497,2014,38,278000,239000,13,8,7,10,0,38,26,12
11718,E02004498,2009,146,240000,224000,36,46,35,29,61,85,116,30
11719,E02004498,2010,150,237000,206000,33,45,39,33,38,112,114,36
11720,E02004498,2011,135,248000,220000,34,44,30,27,32,103,106,29
11721,E02004498,2012,162,240000,211000,32,47,39,44,28,134,120,42
11722,E02004498,2013,172,237000,206000,24,47,58,43,20,152,128,44
11723,E02004498,2014,48,228000,215000,5,12,20,11,0,48,38,10
11724,E02004499,2009,77,187000,177000,4,33,39,1,0,77,76,1
11725,E02004499,2010,75,207000,191000,6,33,33,3,0,75,71,4
11726,E02004499,2011,99,218000,205000,9,47,42,1,0,99,98,1
11727,E02004499,2012,69,215000,198000,5,24,40,0,0,69,69,0
11728,E02004499,2013,83,216000,204000,3,20,55,5,0,83,78,5
11729,E02004499,2014,42,247000,235000,4,11,26,1,0,42,41,1
11730,E02004500,2009,92,362000,276000,51,27,12,2,1,91,88,4
11731,E02004500,2010,116,346000,286000,62,30,20,4,0,116,113,3
11732,E02004500,2011,111,362000,332000,73,18,13,7,1,110,106,5
11733,E02004500,2012,102,313000,287000,58,21,17,6,3,99,96,6
11734,E02004500,2013,130,339000,310000,67,26,29,8,2,128,123,7
11735,E02004500,2014,39,423000,350000,28,4,4,3,3,36,36,3
11736,E02004501,2009,53,306000,225000,23,13,15,2,0,53,51,2
11737,E02004501,2010,93,287000,250000,39,34,15,5,0,93,87,6
11738,E02004501,2011,80,284000,255000,27,31,17,5,1,79,74,6
11739,E02004501,2012,67,275000,222000,21,30,11,5,1,66,62,5
11740,E02004501,2013,72,273000,248000,18,25,21,8,0,72,64,8
11741,E02004501,2014,28,320000,276000,8,10,8,2,0,28,26,2
11742,E02004502,2009,70,440000,398000,43,22,3,2,0,70,68,2
11743,E02004502,2010,83,513000,399000,44,25,10,4,0,83,76,7
11744,E02004502,2011,69,460000,369000,39,23,6,1,2,67,66,3
11745,E02004502,2012,68,447000,387000,36,26,5,1,1,67,66,2
11746,E02004502,2013,94,499000,385000,50,33,8,3,2,92,91,3
11747,E02004502,2014,38,571000,412000,24,9,4,1,1,37,37,1
11748,E02004503,2009,110,197000,195000,29,40,21,20,0,110,85,25
11749,E02004503,2010,118,214000,216000,36,42,16,24,5,113,91,27
11750,E02004503,2011,118,217000,214000,36,36,25,21,1,117,93,25
11751,E02004503,2012,113,211000,220000,33,40,25,15,1,112,95,18
11752,E02004503,2013,131,208000,212000,36,46,18,31,0,131,99,32
11753,E02004503,2014,56,221000,220000,15,22,11,8,1,55,48,8
11754,E02004504,2009,94,217000,191000,39,20,27,8,0,94,85,9
11755,E02004504,2010,112,239000,219000,59,15,20,18,0,112,93,19
11756,E02004504,2011,95,242000,236000,49,13,17,16,0,95,77,18
11757,E02004504,2012,122,246000,242000,65,14,27,16,2,120,102,20
11758,E02004504,2013,138,242000,217000,75,10,39,14,1,137,120,18
11759,E02004504,2014,69,227000,190000,26,7,25,11,0,69,55,14
11760,E02004505,2009,52,252000,228000,26,22,3,1,0,52,51,1
11761,E02004505,2010,67,254000,235000,26,34,5,2,0,67,65,2
11762,E02004505,2011,52,260000,230000,22,26,1,3,0,52,49,3
11763,E02004505,2012,48,242000,226000,18,22,2,6,0,48,42,6
11764,E02004505,2013,58,248000,245000,20,30,4,4,2,56,54,4
11765,E02004505,2014,29,285000,232000,10,12,5,2,2,27,27,2
11766,E02004506,2009,101,324000,260000,66,27,2,6,13,88,95,6
11767,E02004506,2010,95,388000,320000,61,27,3,4,12,83,91,4
11768,E02004506,2011,79,359000,264000,45,21,9,4,18,61,75,4
11769,E02004506,2012,86,372000,310000,53,27,4,2,12,74,84,2
11770,E02004506,2013,104,338000,282000,66,25,8,5,13,91,98,6
11771,E02004506,2014,38,356000,281000,23,11,2,2,0,38,36,2
11772,E02004507,2009,142,169000,152000,45,36,43,18,0,142,123,19
11773,E02004507,2010,147,171000,162000,42,33,45,27,0,147,120,27
11774,E02004507,2011,126,185000,166000,43,29,35,19,0,126,107,19
11775,E02004507,2012,143,184000,156000,40,26,55,22,0,143,121,22
11776,E02004507,2013,178,182000,156000,45,32,83,18,0,178,159,19
11777,E02004507,2014,56,169000,156000,13,9,24,10,0,56,47,9
11778,E02004508,2009,83,240000,225000,39,26,12,6,7,76,76,7
11779,E02004508,2010,77,266000,240000,40,24,6,7,12,65,69,8
11780,E02004508,2011,73,261000,228000,38,28,4,3,3,70,70,3
11781,E02004508,2012,80,265000,224000,41,28,7,4,1,79,76,4
11782,E02004508,2013,98,266000,244000,55,26,12,5,1,97,94,4
11783,E02004508,2014,25,280000,247000,15,6,3,1,0,25,23,2
11784,E02004509,2009,263,160000,140000,50,52,48,113,154,109,150,113
11785,E02004509,2010,286,185000,174000,56,80,67,83,139,147,204,82
11786,E02004509,2011,290,203000,196000,64,75,97,54,144,146,235,55
11787,E02004509,2012,312,206000,193000,104,77,80,51,109,203,262,50
11788,E02004509,2013,289,204000,200000,60,66,116,47,97,192,244,45
11789,E02004509,2014,74,208000,198000,15,10,35,14,11,63,60,14
11790,E02004512,2009,242,181000,148000,28,48,55,111,78,164,129,113
11791,E02004512,2010,188,165000,148000,16,35,66,71,23,165,118,70
11792,E02004512,2011,170,184000,166000,14,43,56,57,22,148,113,57
11793,E02004512,2012,201,174000,160000,16,34,79,72,27,174,130,71
11794,E02004512,2013,232,178000,164000,30,44,78,80,24,208,151,81
11795,E02004512,2014,96,188000,166000,17,9,28,42,25,71,53,43
11796,E02004513,2009,153,115000,123000,5,21,31,96,82,71,55,98
11797,E02004513,2010,94,127000,129000,6,19,38,31,4,90,64,30
11798,E02004513,2011,125,132000,133000,8,16,31,70,50,75,55,70
11799,E02004513,2012,153,127000,125000,6,14,30,103,62,91,52,101
11800,E02004513,2013,111,135000,137000,9,15,20,67,37,74,44,67
11801,E02004513,2014,44,137000,136000,2,3,13,26,12,32,18,26
11802,E02004514,2009,76,239000,190000,35,15,12,14,3,73,63,13
11803,E02004514,2010,80,278000,225000,34,20,8,18,0,80,62,18
11804,E02004514,2011,77,262000,222000,34,21,11,11,3,74,66,11
11805,E02004514,2012,84,317000,231000,43,17,8,16,5,79,68,16
11806,E02004514,2013,109,270000,209000,42,34,22,11,1,108,99,10
11807,E02004514,2014,32,250000,191000,11,7,4,10,0,32,21,11
11808,E02004515,2009,83,285000,222000,42,32,5,4,0,83,79,4
11809,E02004515,2010,82,285000,228000,40,27,8,7,0,82,76,6
11810,E02004515,2011,83,229000,215000,44,27,4,8,0,83,75,8
11811,E02004515,2012,75,269000,227000,45,25,2,3,1,74,72,3
11812,E02004515,2013,107,287000,245000,60,32,8,7,0,107,100,7
11813,E02004515,2014,31,306000,285000,14,12,2,3,0,31,28,3
11814,E02004516,2009,148,131000,125000,7,44,86,11,1,147,136,12
11815,E02004516,2010,157,140000,134000,13,33,95,16,6,151,141,16
11816,E02004516,2011,214,141000,138000,11,41,145,17,42,172,201,13
11817,E02004516,2012,257,154000,148000,17,44,173,23,88,169,241,16
11818,E02004516,2013,278,159000,150000,25,43,181,29,113,165,263,15
11819,E02004516,2014,81,150000,146000,4,15,47,15,19,62,68,13
11820,E02004517,2009,124,184000,175000,50,47,20,7,2,122,118,6
11821,E02004517,2010,106,205000,190000,43,32,23,8,0,106,99,7
11822,E02004517,2011,105,204000,180000,38,42,17,8,0,105,98,7
11823,E02004517,2012,143,206000,200000,53,34,30,26,39,104,117,26
11824,E02004517,2013,212,211000,214000,90,51,49,22,58,154,191,21
11825,E02004517,2014,63,220000,228000,31,17,11,4,11,52,59,4
11826,E02004518,2009,157,202000,175000,29,51,29,48,81,76,109,48
11827,E02004518,2010,196,194000,166000,26,49,38,83,96,100,112,84
11828,E02004518,2011,139,234000,202000,30,41,41,27,43,96,112,27
11829,E02004518,2012,180,220000,195000,36,69,26,49,79,101,133,47
11830,E02004518,2013,257,218000,200000,38,85,65,69,133,124,194,63
11831,E02004518,2014,95,219000,200000,10,33,25,27,37,58,69,26
11832,E02004519,2009,93,197000,190000,44,37,4,8,0,93,85,8
11833,E02004519,2010,92,219000,215000,36,46,7,3,0,92,87,5
11834,E02004519,2011,126,221000,212000,59,53,7,7,0,126,120,6
11835,E02004519,2012,99,226000,210000,43,50,4,2,0,99,97,2
11836,E02004519,2013,124,214000,204000,50,53,8,13,1,123,111,13
11837,E02004519,2014,32,223000,220000,17,11,0,4,0,32,28,4
11838,E02004520,2009,65,178000,150000,19,21,10,15,2,63,49,16
11839,E02004520,2010,132,156000,153000,18,19,69,26,64,68,106,26
11840,E02004520,2011,110,159000,152000,17,40,39,14,37,73,93,17
11841,E02004520,2012,95,170000,163000,14,22,41,18,27,68,77,18
11842,E02004520,2013,96,173000,162000,16,28,31,21,2,94,75,21
11843,E02004520,2014,36,186000,168000,9,10,13,4,2,34,32,4
11844,E02004521,2009,110,157000,142000,20,35,39,16,2,108,95,15
11845,E02004521,2010,113,165000,155000,17,49,19,28,1,112,84,29
11846,E02004521,2011,130,164000,151000,26,42,36,26,5,125,105,25
11847,E02004521,2012,119,155000,145000,26,37,31,25,2,117,93,26
11848,E02004521,2013,138,170000,150000,33,38,33,34,7,131,105,33
11849,E02004521,2014,49,170000,162000,5,21,16,7,0,49,42,7
11850,E02004522,2009,143,215000,182000,48,53,22,20,17,126,123,20
11851,E02004522,2010,145,220000,199000,28,62,34,21,20,125,124,21
11852,E02004522,2011,156,228000,210000,50,59,30,17,16,140,141,15
11853,E02004522,2012,157,244000,218000,66,57,23,11,27,130,147,10
11854,E02004522,2013,134,243000,209000,42,47,30,15,11,123,119,15
11855,E02004522,2014,44,261000,213000,19,11,10,4,0,44,40,4
11856,E02004523,2009,121,149000,140000,19,52,37,13,29,92,109,12
11857,E02004523,2010,102,158000,148000,25,31,32,14,26,76,89,13
11858,E02004523,2011,150,150000,140000,27,52,41,30,46,104,122,28
11859,E02004523,2012,131,161000,158000,31,49,37,14,40,91,118,13
11860,E02004523,2013,185,164000,158000,37,58,66,24,56,129,163,22
11861,E02004523,2014,79,174000,170000,15,22,33,9,33,46,70,9
11862,E02004524,2009,120,285000,246000,79,32,4,5,3,117,115,5
11863,E02004524,2010,97,305000,250000,54,30,8,5,9,88,92,5
11864,E02004524,2011,89,282000,250000,54,24,9,2,8,81,87,2
11865,E02004524,2012,103,306000,250000,68,23,9,3,4,99,100,3
11866,E02004524,2013,118,325000,260000,77,31,9,1,1,117,116,2
11867,E02004524,2014,30,349000,291000,18,9,3,0,0,30,30,0
11868,E02004525,2009,111,185000,167000,30,42,26,13,18,93,98,13
11869,E02004525,2010,109,211000,185000,36,42,11,20,14,95,89,20
11870,E02004525,2011,140,213000,181000,46,65,13,16,3,137,125,15
11871,E02004525,2012,111,212000,190000,36,50,12,13,5,106,97,14
11872,E02004525,2013,143,226000,205000,60,50,20,13,10,133,130,13
11873,E02004525,2014,49,244000,210000,19,21,5,4,2,47,45,4
11874,E02004526,2009,114,231000,212000,62,20,23,9,15,99,105,9
11875,E02004526,2010,127,276000,250000,80,30,6,11,9,118,115,12
11876,E02004526,2011,134,248000,241000,77,30,11,16,5,129,118,16
11877,E02004526,2012,101,268000,240000,63,20,4,14,3,98,87,14
11878,E02004526,2013,147,278000,250000,97,26,12,12,2,145,134,13
11879,E02004526,2014,68,271000,250000,43,13,6,6,0,68,62,6
11880,E02004527,2009,115,236000,212000,26,27,29,33,1,114,77,38
11881,E02004527,2010,125,292000,242000,35,34,30,26,11,114,100,25
11882,E02004527,2011,157,275000,242000,38,33,46,40,35,122,120,37
11883,E02004527,2012,118,265000,232000,29,18,33,38,23,95,80,38
11884,E02004527,2013,141,276000,250000,29,43,33,36,1,140,105,36
11885,E02004527,2014,54,269000,246000,11,8,18,17,0,54,37,17
11886,E02004528,2009,77,357000,325000,42,24,9,2,0,77,75,2
11887,E02004528,2010,86,399000,335000,44,29,12,1,1,85,85,1
11888,E02004528,2011,80,373000,318000,41,27,11,1,0,80,79,1
11889,E02004528,2012,86,374000,334000,37,34,12,3,0,86,83,3
11890,E02004528,2013,116,405000,355000,52,43,21,0,5,111,116,0
11891,E02004528,2014,46,437000,376000,27,12,6,1,2,44,45,1
11892,E02004529,2009,49,474000,420000,30,15,3,1,3,46,48,1
11893,E02004529,2010,80,513000,438000,42,30,7,1,7,73,75,5
11894,E02004529,2011,52,511000,450000,37,10,5,0,2,50,52,0
11895,E02004529,2012,54,519000,455000,28,17,7,2,4,50,52,2
11896,E02004529,2013,70,542000,489000,39,19,6,6,6,64,63,7
11897,E02004529,2014,33,654000,520000,20,13,0,0,7,26,33,0
11898,E02004530,2009,53,261000,243000,21,17,6,9,0,53,44,9
11899,E02004530,2010,86,282000,280000,17,36,14,19,13,73,67,19
11900,E02004530,2011,89,316000,288000,24,35,16,14,16,73,72,17
11901,E02004530,2012,85,257000,250000,7,44,18,16,2,83,69,16
11902,E02004530,2013,110,323000,288000,23,46,18,23,2,108,88,22
11903,E02004530,2014,45,311000,300000,11,21,7,6,0,45,39,6
11904,E02004531,2009,78,307000,288000,18,29,20,11,3,75,65,13
11905,E02004531,2010,116,395000,359000,22,48,25,21,41,75,92,24
11906,E02004531,2011,116,411000,358000,26,40,29,21,28,88,93,23
11907,E02004531,2012,117,396000,345000,17,47,34,19,14,103,97,20
11908,E02004531,2013,108,415000,367000,36,32,21,19,9,99,90,18
11909,E02004531,2014,50,437000,383000,19,17,12,2,4,46,48,2
11910,E02004532,2009,95,334000,297000,22,19,29,25,4,91,69,26
11911,E02004532,2010,108,351000,326000,24,39,17,28,0,108,79,29
11912,E02004532,2011,119,360000,298000,27,30,20,42,11,108,74,45
11913,E02004532,2012,85,352000,348000,19,20,20,26,9,76,58,27
11914,E02004532,2013,110,382000,328000,22,30,26,32,4,106,75,35
11915,E02004532,2014,46,366000,350000,5,9,16,16,0,46,30,16
11916,E02004533,2009,50,185000,183000,0,20,22,8,0,50,41,9
11917,E02004533,2010,68,224000,220000,4,37,18,9,0,68,55,13
11918,E02004533,2011,66,233000,228000,5,29,25,7,0,66,58,8
11919,E02004533,2012,79,201000,209000,0,21,38,20,0,79,60,19
11920,E02004533,2013,83,216000,217000,2,29,36,16,0,83,67,16
11921,E02004533,2014,27,267000,235000,1,8,14,4,0,27,24,3
11922,E02004534,2009,108,203000,180000,14,19,42,33,0,108,72,36
11923,E02004534,2010,101,227000,205000,13,27,37,24,1,100,73,28
11924,E02004534,2011,99,211000,200000,11,23,37,28,0,99,71,28
11925,E02004534,2012,117,224000,206000,17,20,50,30,0,117,85,32
11926,E02004534,2013,138,227000,214000,16,27,51,44,0,138,93,45
11927,E02004534,2014,60,250000,229000,6,14,21,19,0,60,41,19
11928,E02004535,2009,41,385000,210000,12,12,13,4,0,41,36,5
11929,E02004535,2010,61,338000,230000,9,15,19,18,0,61,43,18
11930,E02004535,2011,50,337000,238000,10,11,14,15,2,48,35,15
11931,E02004535,2012,79,333000,275000,18,21,30,10,19,60,69,10
11932,E02004535,2013,85,273000,230000,10,24,28,23,2,83,62,23
11933,E02004535,2014,28,353000,250000,3,2,15,8,0,28,20,8
11934,E02004536,2009,63,471000,410000,19,32,11,1,0,63,61,2
11935,E02004536,2010,80,482000,422000,25,37,5,13,5,75,66,14
11936,E02004536,2011,77,459000,435000,27,29,14,7,0,77,70,7
11937,E02004536,2012,74,493000,442000,21,38,7,8,1,73,66,8
11938,E02004536,2013,98,513000,433000,28,38,17,15,0,98,83,15
11939,E02004536,2014,27,436000,440000,3,13,6,5,0,27,22,5
11940,E02004537,2009,104,197000,190000,1,46,32,25,0,104,73,31
11941,E02004537,2010,99,197000,202000,1,23,37,38,0,99,60,39
11942,E02004537,2011,118,213000,216000,3,41,52,22,0,118,94,24
11943,E02004537,2012,122,212000,220000,0,37,52,33,0,122,90,32
11944,E02004537,2013,119,222000,230000,2,21,61,35,0,119,83,36
11945,E02004537,2014,42,240000,250000,0,10,18,14,0,42,28,14
11946,E02004538,2009,134,366000,300000,40,44,32,18,21,113,115,19
11947,E02004538,2010,159,385000,317000,31,48,53,27,43,116,132,27
11948,E02004538,2011,171,434000,340000,50,46,41,34,48,123,136,35
11949,E02004538,2012,155,432000,370000,29,43,43,40,42,113,115,40
11950,E02004538,2013,181,480000,375000,51,47,31,52,20,161,129,52
11951,E02004538,2014,44,462000,408000,13,14,9,8,1,43,34,10
11952,E02004539,2009,80,238000,242000,5,28,37,10,0,80,69,11
11953,E02004539,2010,114,255000,235000,10,34,41,29,0,114,83,31
11954,E02004539,2011,113,260000,245000,11,35,43,24,0,113,83,30
11955,E02004539,2012,85,262000,250000,6,20,41,18,0,85,67,18
11956,E02004539,2013,105,280000,250000,11,23,48,23,0,105,82,23
11957,E02004539,2014,38,313000,284000,4,13,15,6,0,38,32,6
11958,E02004540,2009,99,430000,300000,34,26,19,20,0,99,77,22
11959,E02004540,2010,90,398000,340000,23,25,20,22,1,89,68,22
11960,E02004540,2011,81,446000,328000,28,15,21,17,0,81,63,18
11961,E02004540,2012,97,443000,350000,25,24,22,26,1,96,71,26
11962,E02004540,2013,114,542000,384000,28,24,24,38,7,107,76,38
11963,E02004540,2014,24,488000,380000,5,2,12,5,0,24,19,5
11964,E02004541,2009,160,326000,278000,24,37,39,60,9,151,99,61
11965,E02004541,2010,213,366000,325000,41,59,40,73,2,211,139,74
11966,E02004541,2011,166,392000,348000,27,56,21,62,1,165,105,61
11967,E02004541,2012,176,403000,370000,24,66,42,44,14,162,131,45
11968,E02004541,2013,211,392000,358000,26,68,41,76,0,211,133,78
11969,E02004541,2014,75,386000,350000,6,17,16,36,0,75,39,36
11970,E02004542,2009,52,433000,392000,21,14,9,8,0,52,43,9
11971,E02004542,2010,74,495000,442000,31,19,17,7,0,74,66,8
11972,E02004542,2011,68,636000,411000,31,14,10,13,1,67,54,14
11973,E02004542,2012,73,502000,395000,19,21,14,19,13,60,54,19
11974,E02004542,2013,90,625000,464000,40,20,19,11,6,84,79,11
11975,E02004542,2014,41,611000,575000,20,5,8,8,5,36,33,8
11976,E02004543,2009,62,354000,248000,17,21,12,12,0,62,46,16
11977,E02004543,2010,63,426000,420000,23,15,15,10,0,63,49,14
11978,E02004543,2011,66,381000,355000,14,23,12,17,2,64,47,19
11979,E02004543,2012,49,405000,273000,13,13,9,14,0,49,34,15
11980,E02004543,2013,86,455000,435000,21,18,17,30,8,78,56,30
11981,E02004543,2014,32,523000,452000,10,7,5,10,3,29,22,10
11982,E02004544,2009,127,241000,222000,24,25,46,32,36,91,92,35
11983,E02004544,2010,87,264000,230000,22,17,24,24,22,65,63,24
11984,E02004544,2011,103,288000,272000,30,20,34,19,31,72,82,21
11985,E02004544,2012,128,240000,220000,17,18,55,38,59,69,90,38
11986,E02004544,2013,153,252000,235000,25,30,66,32,41,112,120,33
11987,E02004544,2014,54,296000,286000,16,7,13,18,13,41,36,18
11988,E02004545,2009,50,152000,145000,0,11,23,16,0,50,34,16
11989,E02004545,2010,51,156000,160000,3,7,26,15,0,51,35,16
11990,E02004545,2011,65,171000,158000,3,12,40,10,0,65,56,9
11991,E02004545,2012,58,176000,166000,7,4,36,11,0,58,47,11
11992,E02004545,2013,77,162000,160000,1,5,54,17,0,77,60,17
11993,E02004545,2014,19,169000,180000,0,2,11,6,0,19,13,6
11994,E02004546,2009,65,151000,146000,6,8,34,17,0,65,47,18
11995,E02004546,2010,61,162000,155000,3,12,32,14,0,61,45,16
11996,E02004546,2011,50,164000,152000,3,7,30,10,0,50,41,9
11997,E02004546,2012,70,162000,149000,1,11,36,22,8,62,47,23
11998,E02004546,2013,85,196000,174000,5,10,52,18,25,60,69,16
11999,E02004546,2014,33,175000,165000,1,1,22,9,2,31,25,8
12000,E02004547,2009,119,149000,140000,3,6,44,66,50,69,49,70
12001,E02004547,2010,102,182000,166000,5,9,62,26,39,63,73,29
12002,E02004547,2011,91,176000,165000,3,13,57,18,18,73,73,18
12003,E02004547,2012,74,176000,168000,4,8,32,30,14,60,46,28
12004,E02004547,2013,110,201000,194000,2,19,61,28,31,79,82,28
12005,E02004547,2014,31,182000,182000,0,4,19,8,0,31,23,8
12006,E02004548,2009,177,207000,195000,48,42,75,12,0,177,161,16
12007,E02004548,2010,167,227000,215000,49,36,69,13,0,167,152,15
12008,E02004548,2011,199,214000,205000,46,41,95,17,0,199,182,17
12009,E02004548,2012,171,224000,215000,44,30,81,16,0,171,154,17
12010,E02004548,2013,177,224000,215000,44,37,77,19,0,177,158,19
12011,E02004548,2014,68,234000,226000,18,6,37,7,0,68,59,9
12012,E02004549,2009,62,169000,154000,5,4,47,6,0,62,56,6
12013,E02004549,2010,48,150000,156000,2,7,31,8,0,48,40,8
12014,E02004549,2011,66,158000,153000,3,4,50,9,0,66,56,10
12015,E02004549,2012,50,155000,158000,2,2,37,9,1,49,41,9
12016,E02004549,2013,72,184000,163000,7,3,56,6,2,70,66,6
12017,E02004549,2014,37,191000,176000,4,1,31,1,0,37,36,1
12018,E02004550,2009,54,135000,134000,3,8,28,15,0,54,39,15
12019,E02004550,2010,62,152000,146000,3,12,29,18,0,62,45,17
12020,E02004550,2011,63,141000,147000,0,5,38,20,0,63,44,19
12021,E02004550,2012,60,147000,150000,3,1,40,16,3,57,45,15
12022,E02004550,2013,78,162000,161000,0,6,55,17,0,78,62,16
12023,E02004550,2014,31,166000,160000,3,2,14,12,0,31,20,11
12024,E02004551,2009,73,146000,143000,2,6,49,16,1,72,57,16
12025,E02004551,2010,74,153000,152000,1,12,44,17,0,74,54,20
12026,E02004551,2011,44,169000,165000,1,7,31,5,1,43,39,5
12027,E02004551,2012,52,168000,159000,1,8,35,8,0,52,43,9
12028,E02004551,2013,54,177000,167000,2,6,33,13,1,53,41,13
12029,E02004551,2014,38,176000,171000,1,3,26,8,0,38,29,9
12030,E02004552,2009,55,175000,165000,3,11,32,9,1,54,45,10
12031,E02004552,2010,65,194000,174000,10,8,33,14,0,65,52,13
12032,E02004552,2011,63,183000,165000,8,11,32,12,0,63,50,13
12033,E02004552,2012,52,187000,169000,6,10,25,11,0,52,41,11
12034,E02004552,2013,87,190000,173000,13,10,47,17,0,87,70,17
12035,E02004552,2014,28,184000,184000,2,2,15,9,0,28,19,9
12036,E02004553,2009,48,155000,146000,5,9,31,3,0,48,44,4
12037,E02004553,2010,59,154000,147000,3,9,35,12,0,59,46,13
12038,E02004553,2011,64,165000,155000,6,15,33,10,0,64,55,9
12039,E02004553,2012,59,158000,150000,4,9,38,8,0,59,51,8
12040,E02004553,2013,81,162000,153000,4,15,47,15,0,81,65,16
12041,E02004553,2014,27,171000,141000,3,1,18,5,0,27,21,6
12042,E02004554,2009,43,157000,148000,2,5,28,8,0,43,33,10
12043,E02004554,2010,75,172000,165000,8,11,41,15,3,72,61,14
12044,E02004554,2011,69,189000,175000,8,8,45,8,0,69,61,8
12045,E02004554,2012,54,176000,161000,4,6,34,10,0,54,44,10
12046,E02004554,2013,85,168000,160000,7,6,55,17,0,85,68,17
12047,E02004554,2014,32,169000,156000,1,5,19,7,0,32,24,8
12048,E02004555,2009,78,237000,202000,35,26,12,5,4,74,73,5
12049,E02004555,2010,72,228000,195000,27,33,9,3,1,71,69,3
12050,E02004555,2011,65,259000,215000,34,16,12,3,0,65,62,3
12051,E02004555,2012,46,224000,202000,18,16,11,1,0,46,45,1
12052,E02004555,2013,91,258000,222000,47,22,19,3,5,86,87,4
12053,E02004555,2014,32,248000,248000,16,11,3,2,3,29,30,2
12054,E02004556,2009,69,357000,250000,42,18,7,2,2,67,68,1
12055,E02004556,2010,77,374000,265000,43,20,6,8,1,76,71,6
12056,E02004556,2011,71,416000,340000,44,20,1,6,2,69,66,5
12057,E02004556,2012,69,404000,322000,49,16,3,1,2,67,68,1
12058,E02004556,2013,103,417000,353000,73,19,6,5,3,100,98,5
12059,E02004556,2014,36,545000,370000,25,6,5,0,3,33,36,0
12060,E02004557,2009,105,199000,190000,40,34,25,6,16,89,95,10
12061,E02004557,2010,115,222000,198000,39,36,37,3,17,98,111,4
12062,E02004557,2011,134,246000,212000,65,34,26,9,21,113,124,10
12063,E02004557,2012,107,253000,217000,43,29,28,7,19,88,99,8
12064,E02004557,2013,135,214000,200000,43,42,43,7,6,129,126,9
12065,E02004557,2014,44,225000,208000,15,8,21,0,0,44,43,1
12066,E02004558,2009,121,189000,172000,20,25,41,35,22,99,79,42
12067,E02004558,2010,82,220000,195000,18,26,22,16,2,80,62,20
12068,E02004558,2011,96,200000,166000,18,22,31,25,0,96,71,25
12069,E02004558,2012,100,196000,162000,16,21,35,28,7,93,66,34
12070,E02004558,2013,118,218000,192000,22,31,34,31,4,114,84,34
12071,E02004558,2014,33,207000,182000,5,5,14,9,0,33,23,10
12072,E02004559,2009,78,211000,192000,32,25,20,1,1,77,76,2
12073,E02004559,2010,100,217000,205000,32,40,27,1,0,100,99,1
12074,E02004559,2011,89,225000,214000,36,29,24,0,0,89,89,0
12075,E02004559,2012,96,222000,207000,28,35,31,2,0,96,94,2
12076,E02004559,2013,113,230000,210000,32,46,33,2,0,113,111,2
12077,E02004559,2014,30,220000,222000,9,12,8,1,0,30,29,1
12078,E02004560,2009,79,190000,188000,37,23,13,6,2,77,73,6
12079,E02004560,2010,99,228000,220000,55,30,8,6,16,83,93,6
12080,E02004560,2011,84,229000,212000,52,20,8,4,0,84,79,5
12081,E02004560,2012,93,213000,195000,53,27,12,1,4,89,92,1
12082,E02004560,2013,110,222000,185000,54,39,10,7,1,109,103,7
12083,E02004560,2014,52,234000,220000,32,10,7,3,0,52,49,3
12084,E02004561,2009,110,263000,225000,76,25,6,3,0,110,105,5
12085,E02004561,2010,124,279000,236000,80,26,13,5,0,124,119,5
12086,E02004561,2011,123,284000,245000,78,32,12,1,10,113,121,2
12087,E02004561,2012,105,274000,233000,66,32,7,0,10,95,105,0
12088,E02004561,2013,118,301000,245000,83,25,6,4,4,114,114,4
12089,E02004561,2014,52,276000,244000,33,12,5,2,2,50,48,4
12090,E02004562,2009,110,192000,169000,39,32,28,11,0,110,99,11
12091,E02004562,2010,121,205000,172000,37,29,42,13,0,121,107,14
12092,E02004562,2011,125,211000,180000,42,36,35,12,0,125,112,13
12093,E02004562,2012,137,210000,190000,47,43,39,8,0,137,127,10
12094,E02004562,2013,129,226000,190000,44,34,43,8,1,128,120,9
12095,E02004562,2014,48,235000,215000,21,13,11,3,0,48,46,2
12096,E02004563,2009,80,215000,210000,23,52,2,3,1,79,77,3
12097,E02004563,2010,55,247000,223000,20,31,2,2,1,54,53,2
12098,E02004563,2011,58,219000,211000,17,35,2,4,0,58,54,4
12099,E02004563,2012,51,214000,200000,19,23,6,3,0,51,48,3
12100,E02004563,2013,78,245000,220000,34,36,6,2,0,78,76,2
12101,E02004563,2014,31,256000,235000,12,15,4,0,0,31,31,0
12102,E02004564,2009,82,221000,208000,30,37,11,4,0,82,78,4
12103,E02004564,2010,82,240000,223000,39,39,2,2,0,82,80,2
12104,E02004564,2011,101,226000,205000,40,52,6,3,0,101,99,2
12105,E02004564,2012,108,228000,211000,41,52,9,6,6,102,102,6
12106,E02004564,2013,143,230000,210000,57,61,13,12,14,129,131,12
12107,E02004564,2014,54,267000,249000,30,18,5,1,11,43,53,1
12108,E02004565,2009,193,228000,205000,58,104,14,17,10,183,176,17
12109,E02004565,2010,189,262000,229000,67,101,12,9,7,182,180,9
12110,E02004565,2011,200,260000,220000,67,108,17,8,4,196,192,8
12111,E02004565,2012,205,263000,230000,76,106,17,6,6,199,197,8
12112,E02004565,2013,224,276000,237000,84,113,17,10,8,216,213,11
12113,E02004565,2014,82,306000,268000,35,39,3,5,5,77,76,6
12114,E02004566,2009,44,197000,175000,7,17,10,10,0,44,34,10
12115,E02004566,2010,63,219000,168000,16,20,10,17,0,63,46,17
12116,E02004566,2011,52,235000,176000,11,19,14,8,0,52,44,8
12117,E02004566,2012,42,226000,175000,11,12,11,8,0,42,34,8
12118,E02004566,2013,73,222000,172000,21,18,13,21,9,64,52,21
12119,E02004566,2014,18,233000,202000,6,6,4,2,0,18,16,2
12120,E02004567,2009,110,247000,223000,36,53,13,8,3,107,101,9
12121,E02004567,2010,108,250000,236000,39,49,12,8,0,108,100,8
12122,E02004567,2011,115,261000,230000,41,58,7,9,0,115,104,11
12123,E02004567,2012,103,267000,245000,37,51,6,9,1,102,94,9
12124,E02004567,2013,113,256000,245000,33,60,10,10,2,111,103,10
12125,E02004567,2014,48,257000,230000,13,25,5,5,8,40,43,5
12126,E02004568,2009,116,207000,185000,30,51,25,10,1,115,106,10
12127,E02004568,2010,130,252000,210000,46,53,24,7,5,125,123,7
12128,E02004568,2011,141,220000,198000,36,69,28,8,9,132,134,7
12129,E02004568,2012,113,211000,195000,19,50,36,8,1,112,105,8
12130,E02004568,2013,150,250000,223000,42,60,34,14,8,142,136,14
12131,E02004568,2014,56,251000,225000,14,28,11,3,2,54,53,3
12132,E02004569,2009,110,183000,166000,19,40,23,28,7,103,83,27
12133,E02004569,2010,103,202000,182000,20,45,17,21,7,96,82,21
12134,E02004569,2011,99,198000,175000,26,41,17,15,0,99,84,15
12135,E02004569,2012,112,183000,172000,22,51,13,26,9,103,86,26
12136,E02004569,2013,131,187000,185000,33,50,20,28,4,127,103,28
12137,E02004569,2014,52,183000,190000,10,19,10,13,0,52,39,13
12138,E02004570,2009,125,231000,205000,37,55,3,30,15,110,95,30
12139,E02004570,2010,145,259000,230000,43,73,11,18,1,144,127,18
12140,E02004570,2011,127,240000,220000,32,64,6,25,2,125,102,25
12141,E02004570,2012,129,229000,220000,28,69,6,26,2,127,102,27
12142,E02004570,2013,153,252000,221000,31,79,6,37,9,144,116,37
12143,E02004570,2014,44,255000,223000,9,23,2,10,1,43,34,10
12144,E02004571,2009,109,236000,205000,30,59,14,6,2,107,102,7
12145,E02004571,2010,99,257000,225000,32,50,6,11,0,99,89,10
12146,E02004571,2011,105,269000,230000,29,62,8,6,5,100,99,6
12147,E02004571,2012,126,248000,218000,31,67,9,19,10,116,106,20
12148,E02004571,2013,133,258000,238000,43,74,11,5,4,129,127,6
12149,E02004571,2014,31,263000,239000,11,16,3,1,0,31,30,1
12150,E02004572,2009,72,180000,170000,18,34,15,5,0,72,67,5
12151,E02004572,2010,68,195000,190000,15,34,14,5,0,68,62,6
12152,E02004572,2011,87,205000,178000,25,39,18,5,0,87,82,5
12153,E02004572,2012,66,191000,178000,12,31,17,6,1,65,59,7
12154,E02004572,2013,104,212000,185000,29,47,21,7,0,104,97,7
12155,E02004572,2014,50,212000,210000,14,25,8,3,0,50,47,3
12156,E02004575,2009,159,195000,168000,51,52,34,22,23,136,137,22
12157,E02004575,2010,172,223000,189000,72,47,30,23,12,160,148,24
12158,E02004575,2011,167,216000,190000,53,52,37,25,11,156,142,25
12159,E02004575,2012,146,197000,175000,43,60,25,18,3,143,127,19
12160,E02004575,2013,192,212000,192000,67,67,37,21,4,188,171,21
12161,E02004575,2014,44,225000,186000,17,12,10,5,0,44,39,5
12162,E02004576,2009,2,312000,312000,2,0,0,0,0,2,2,0
12163,E02004576,2011,3,213000,210000,1,1,1,0,0,3,3,0
12164,E02004576,2012,2,288000,288000,1,1,0,0,0,2,2,0
12165,E02004576,2013,1,460000,460000,1,0,0,0,0,1,1,0
12166,E02004577,2009,70,242000,200000,35,23,10,2,0,70,68,2
12167,E02004577,2010,64,281000,230000,38,20,3,3,2,62,59,5
12168,E02004577,2011,53,246000,215000,28,19,3,3,3,50,48,5
12169,E02004577,2012,36,337000,212000,17,12,6,1,0,36,33,3
12170,E02004577,2013,69,265000,235000,33,26,7,3,2,67,64,5
12171,E02004577,2014,26,315000,215000,13,8,5,0,1,25,23,3
12172,E02004579,2009,74,173000,155000,35,31,8,0,4,70,73,1
12173,E02004579,2010,79,243000,210000,55,22,2,0,1,78,79,0
12174,E02004579,2011,87,221000,194000,53,28,6,0,5,82,87,0
12175,E02004579,2012,89,193000,184000,50,31,8,0,3,86,89,0
12176,E02004579,2013,93,213000,205000,62,21,10,0,5,88,93,0
12177,E02004579,2014,40,197000,184000,21,16,3,0,0,40,40,0
12178,E02004580,2009,12,181000,170000,8,3,1,0,0,12,11,1
12179,E02004580,2010,18,217000,208000,12,6,0,0,0,18,18,0
12180,E02004580,2011,10,239000,242000,8,1,0,1,0,10,9,1
12181,E02004580,2012,14,215000,225000,8,4,1,1,0,14,13,1
12182,E02004580,2013,17,184000,162000,8,8,0,1,1,16,15,2
12183,E02004580,2014,7,182000,191000,2,3,2,0,0,7,6,1
12184,E02004581,2009,86,199000,175000,40,39,5,2,0,86,84,2
12185,E02004581,2010,95,204000,182000,40,42,9,4,1,94,91,4
12186,E02004581,2011,91,229000,200000,49,33,7,2,8,83,89,2
12187,E02004581,2012,116,219000,185000,57,48,6,5,7,109,111,5
12188,E02004581,2013,140,231000,190000,69,57,12,2,5,135,139,1
12189,E02004581,2014,39,219000,190000,17,19,3,0,0,39,39,0
12190,E02004582,2009,120,144000,139000,39,72,7,2,7,113,118,2
12191,E02004582,2010,111,156000,143000,36,60,11,4,14,97,107,4
12192,E02004582,2011,104,149000,134000,43,50,8,3,5,99,100,4
12193,E02004582,2012,109,151000,142000,43,63,2,1,3,106,108,1
12194,E02004582,2013,123,150000,140000,54,60,5,4,0,123,120,3
12195,E02004582,2014,49,174000,154000,26,19,3,1,6,43,48,1
12196,E02004583,2009,150,147000,140000,49,61,24,16,4,146,135,15
12197,E02004583,2010,115,165000,152000,34,42,18,21,2,113,93,22
12198,E02004583,2011,118,171000,162000,39,45,26,8,1,117,110,8
12199,E02004583,2012,119,175000,162000,36,40,32,11,2,117,107,12
12200,E02004583,2013,147,179000,164000,59,55,24,9,1,146,138,9
12201,E02004583,2014,50,165000,153000,17,18,12,3,0,50,47,3
12202,E02004584,2009,142,163000,161000,73,42,6,21,1,141,120,22
12203,E02004584,2010,137,163000,160000,62,40,8,27,0,137,109,28
12204,E02004584,2011,161,166000,157000,93,38,4,26,0,161,136,25
12205,E02004584,2012,132,180000,170000,83,35,2,12,4,128,120,12
12206,E02004584,2013,160,170000,161000,93,41,4,22,1,159,136,24
12207,E02004584,2014,43,163000,158000,17,19,2,5,0,43,37,6
12208,E02004585,2009,109,153000,140000,57,43,8,1,2,107,108,1
12209,E02004585,2010,105,157000,148000,59,39,7,0,0,105,105,0
12210,E02004585,2011,114,151000,144000,64,41,8,1,7,107,113,1
12211,E02004585,2012,129,152000,142000,53,54,18,4,23,106,126,3
12212,E02004585,2013,188,161000,154000,104,61,20,3,60,128,184,4
12213,E02004585,2014,76,159000,151000,41,24,10,1,17,59,75,1
12214,E02004586,2009,127,158000,140000,52,23,23,29,4,123,96,31
12215,E02004586,2010,126,154000,140000,47,31,9,39,8,118,93,33
12216,E02004586,2011,125,152000,135000,47,25,16,37,13,112,86,39
12217,E02004586,2012,112,165000,149000,44,34,9,25,4,108,87,25
12218,E02004586,2013,167,154000,137000,60,38,19,50,2,165,120,47
12219,E02004586,2014,57,169000,150000,23,15,7,12,3,54,44,13
12220,E02004587,2009,81,124000,122000,33,24,21,3,0,81,76,5
12221,E02004587,2010,78,134000,129000,27,25,19,7,0,78,71,7
12222,E02004587,2011,101,136000,130000,40,36,19,6,0,101,95,6
12223,E02004587,2012,87,128000,127000,34,24,21,8,0,87,79,8
12224,E02004587,2013,98,129000,125000,32,37,22,7,1,97,91,7
12225,E02004587,2014,41,137000,125000,19,9,6,7,0,41,34,7
12226,E02004588,2009,94,111000,107000,8,19,14,53,11,83,46,48
12227,E02004588,2010,88,116000,116000,9,18,15,46,6,82,47,41
12228,E02004588,2011,91,112000,110000,6,27,22,36,1,90,56,35
12229,E02004588,2012,64,112000,102000,6,13,11,34,1,63,31,33
12230,E02004588,2013,87,114000,103000,9,19,13,46,1,86,45,42
12231,E02004588,2014,38,124000,115000,8,9,5,16,2,36,22,16
12232,E02004589,2009,81,141000,130000,28,23,12,18,1,80,63,18
12233,E02004589,2010,98,136000,130000,31,27,15,25,4,94,72,26
12234,E02004589,2011,99,152000,137000,34,27,16,22,0,99,75,24
12235,E02004589,2012,95,137000,132000,31,33,15,16,0,95,78,17
12236,E02004589,2013,105,150000,133000,42,23,21,19,0,105,86,19
12237,E02004589,2014,47,155000,140000,18,14,7,8,0,47,39,8
12238,E02004590,2009,120,114000,107000,69,35,11,5,0,120,115,5
12239,E02004590,2010,115,128000,120000,67,30,14,4,0,115,110,5
12240,E02004590,2011,143,117000,111000,77,46,14,6,0,143,136,7
12241,E02004590,2012,105,127000,122000,67,32,4,2,1,104,103,2
12242,E02004590,2013,116,121000,119000,84,27,4,1,2,114,114,2
12243,E02004590,2014,57,115000,108000,36,15,3,3,2,55,52,5
12244,E02004591,2009,83,300000,265000,27,34,12,10,1,82,73,10
12245,E02004591,2010,110,405000,322000,53,31,20,6,1,109,103,7
12246,E02004591,2011,93,376000,295000,44,16,26,7,3,90,85,8
12247,E02004591,2012,90,387000,326000,42,24,18,6,1,89,83,7
12248,E02004591,2013,87,378000,364000,38,19,21,9,1,86,78,9
12249,E02004591,2014,29,371000,338000,9,12,8,0,0,29,29,0
12250,E02004592,2009,182,220000,194000,28,53,62,39,2,180,143,39
12251,E02004592,2010,200,223000,210000,30,56,68,46,4,196,154,46
12252,E02004592,2011,230,259000,219000,43,62,69,56,22,208,171,59
12253,E02004592,2012,218,263000,226000,47,42,58,71,53,165,150,68
12254,E02004592,2013,287,297000,250000,63,58,96,70,44,243,215,72
12255,E02004592,2014,69,293000,250000,13,16,15,25,3,66,43,26
12256,E02004593,2009,87,409000,352000,51,21,15,0,2,85,87,0
12257,E02004593,2010,113,470000,440000,68,32,13,0,14,99,113,0
12258,E02004593,2011,107,462000,385000,69,28,10,0,7,100,107,0
12259,E02004593,2012,109,425000,355000,53,31,25,0,10,99,109,0
12260,E02004593,2013,118,426000,348000,61,32,24,1,15,103,116,2
12261,E02004593,2014,47,494000,470000,28,11,8,0,4,43,47,0
12262,E02004594,2009,73,337000,294000,40,21,11,1,8,65,71,2
12263,E02004594,2010,81,375000,310000,47,18,15,1,7,74,79,2
12264,E02004594,2011,79,372000,290000,45,20,13,1,0,79,77,2
12265,E02004594,2012,97,396000,340000,48,28,20,1,0,97,96,1
12266,E02004594,2013,87,419000,370000,54,14,18,1,0,87,85,2
12267,E02004594,2014,36,396000,305000,16,11,7,2,0,36,34,2
12268,E02004595,2009,220,303000,246000,95,54,57,14,58,162,206,14
12269,E02004595,2010,234,337000,292000,103,67,52,12,74,160,221,13
12270,E02004595,2011,247,316000,275000,118,62,49,18,93,154,226,21
12271,E02004595,2012,233,342000,295000,99,64,56,14,77,156,220,13
12272,E02004595,2013,310,323000,300000,121,79,90,20,92,218,287,23
12273,E02004595,2014,90,335000,322000,37,22,23,8,18,72,83,7
12274,E02004596,2009,211,318000,304000,120,46,43,2,125,86,208,3
12275,E02004596,2010,190,347000,312000,101,53,28,8,87,103,180,10
12276,E02004596,2011,165,299000,275000,78,52,33,2,87,78,160,5
12277,E02004596,2012,175,314000,300000,85,41,46,3,88,87,171,4
12278,E02004596,2013,213,331000,310000,104,53,55,1,98,115,209,4
12279,E02004596,2014,50,381000,360000,27,13,10,0,8,42,47,3
12280,E02004597,2009,131,245000,235000,61,29,16,25,40,91,106,25
12281,E02004597,2010,130,268000,252000,64,27,15,24,31,99,106,24
12282,E02004597,2011,171,256000,220000,63,30,22,56,71,100,115,56
12283,E02004597,2012,144,266000,250000,66,31,24,23,36,108,120,24
12284,E02004597,2013,197,267000,250000,61,51,47,38,52,145,156,41
12285,E02004597,2014,68,239000,236000,17,20,13,18,8,60,51,17
12286,E02004598,2009,166,321000,244000,81,46,27,12,42,124,153,13
12287,E02004598,2010,156,333000,250000,71,42,39,4,28,128,151,5
12288,E02004598,2011,119,362000,285000,67,28,19,5,11,108,115,4
12289,E02004598,2012,135,326000,285000,62,45,24,4,6,129,130,5
12290,E02004598,2013,144,326000,282000,69,33,35,7,5,139,136,8
12291,E02004598,2014,67,355000,290000,27,16,21,3,0,67,65,2
12292,E02004599,2009,83,349000,310000,50,22,8,3,0,83,79,4
12293,E02004599,2010,88,400000,334000,56,17,14,1,2,86,87,1
12294,E02004599,2011,93,438000,330000,54,27,8,4,1,92,88,5
12295,E02004599,2012,74,436000,405000,45,18,10,1,5,69,74,0
12296,E02004599,2013,107,446000,377000,63,25,18,1,3,104,106,1
12297,E02004599,2014,29,452000,420000,19,5,4,1,0,29,28,1
12298,E02004675,2009,81,187000,180000,15,33,28,5,1,80,76,5
12299,E02004675,2010,70,203000,190000,12,25,29,4,0,70,66,4
12300,E02004675,2011,87,213000,200000,18,42,26,1,0,87,85,2
12301,E02004675,2012,98,224000,211000,20,42,35,1,4,94,94,4
12302,E02004675,2013,155,221000,217000,28,52,52,23,31,124,131,24
12303,E02004675,2014,66,241000,242000,23,21,17,5,19,47,60,6
12304,E02004676,2009,97,255000,235000,47,15,27,8,2,95,87,10
12305,E02004676,2010,104,296000,250000,52,21,28,3,2,102,98,6
12306,E02004676,2011,103,266000,241000,50,18,29,6,3,100,95,8
12307,E02004676,2012,86,292000,255000,34,22,27,3,5,81,83,3
12308,E02004676,2013,130,302000,252000,55,24,39,12,3,127,116,14
12309,E02004676,2014,43,287000,276000,17,14,10,2,1,42,41,2
12310,E02004677,2009,57,441000,368000,31,17,8,1,2,55,56,1
12311,E02004677,2010,92,496000,410000,62,12,16,2,13,79,90,2
12312,E02004677,2011,82,430000,335000,45,25,9,3,28,54,79,3
12313,E02004677,2012,81,407000,352000,44,19,13,5,21,60,76,5
12314,E02004677,2013,82,481000,422000,54,17,11,0,9,73,81,1
12315,E02004677,2014,21,670000,485000,12,5,3,1,0,21,19,2
12316,E02004678,2009,97,337000,245000,44,25,22,6,4,93,91,6
12317,E02004678,2010,104,335000,250000,42,31,28,3,10,94,100,4
12318,E02004678,2011,72,331000,224000,23,23,17,9,1,71,64,8
12319,E02004678,2012,89,384000,285000,47,18,19,5,1,88,83,6
12320,E02004678,2013,90,405000,255000,40,30,12,8,0,90,81,9
12321,E02004678,2014,36,328000,262000,14,8,9,5,0,36,31,5
12322,E02004679,2009,148,301000,236000,60,43,41,4,68,80,145,3
12323,E02004679,2010,145,292000,245000,58,32,36,19,61,84,131,14
12324,E02004679,2011,101,329000,270000,55,19,18,9,9,92,92,9
12325,E02004679,2012,89,392000,310000,44,24,15,6,1,88,84,5
12326,E02004679,2013,122,342000,289000,56,25,31,10,0,122,112,10
12327,E02004679,2014,49,332000,290000,18,17,11,3,0,49,46,3
12328,E02004680,2009,139,228000,205000,39,23,60,17,26,113,121,18
12329,E02004680,2010,185,252000,235000,56,48,69,12,55,130,173,12
12330,E02004680,2011,203,248000,227000,73,39,76,15,67,136,188,15
12331,E02004680,2012,236,241000,230000,56,45,93,42,109,127,200,36
12332,E02004680,2013,235,254000,240000,71,57,91,16,72,163,221,14
12333,E02004680,2014,80,271000,250000,24,11,36,9,20,60,72,8
12334,E02004681,2009,238,163000,148000,35,16,122,65,157,81,172,66
12335,E02004681,2010,247,193000,180000,62,30,103,52,149,98,194,53
12336,E02004681,2011,187,183000,175000,22,23,106,36,89,98,152,35
12337,E02004681,2012,175,175000,160000,15,11,93,56,66,109,120,55
12338,E02004681,2013,224,197000,200000,25,36,126,37,81,143,188,36
12339,E02004681,2014,70,177000,169000,6,7,33,24,10,60,47,23
12340,E02004682,2009,101,193000,175000,26,22,30,23,0,101,79,22
12341,E02004682,2010,118,227000,211000,40,25,31,22,0,118,94,24
12342,E02004682,2011,90,232000,230000,35,15,26,14,0,90,75,15
12343,E02004682,2012,118,240000,222000,42,17,38,21,0,118,96,22
12344,E02004682,2013,142,239000,232000,42,28,47,25,2,140,118,24
12345,E02004682,2014,56,243000,240000,22,3,14,17,6,50,38,18
12346,E02004683,2009,53,175000,170000,5,14,20,14,4,49,38,15
12347,E02004683,2010,57,182000,177000,1,19,26,11,1,56,46,11
12348,E02004683,2011,67,182000,175000,0,29,21,17,0,67,49,18
12349,E02004683,2012,80,174000,171000,2,29,22,27,5,75,52,28
12350,E02004683,2013,93,181000,185000,3,29,34,27,6,87,65,28
12351,E02004683,2014,34,203000,182000,1,13,10,10,0,34,24,10
12352,E02004684,2009,230,191000,194000,19,24,141,46,161,69,183,47
12353,E02004684,2010,202,195000,185000,31,16,98,57,124,78,145,57
12354,E02004684,2011,171,212000,215000,40,21,93,17,71,100,155,16
12355,E02004684,2012,152,211000,212000,26,37,68,21,43,109,133,19
12356,E02004684,2013,187,222000,220000,38,34,83,32,45,142,153,34
12357,E02004684,2014,66,227000,220000,7,15,38,6,8,58,61,5
12358,E02004685,2009,120,160000,155000,10,16,38,56,35,85,52,68
12359,E02004685,2010,147,173000,168000,6,14,38,89,65,82,45,102
12360,E02004685,2011,87,170000,167000,5,18,26,38,21,66,40,47
12361,E02004685,2012,97,177000,165000,12,18,30,37,10,87,48,49
12362,E02004685,2013,147,174000,162000,7,21,39,80,11,136,59,88
12363,E02004685,2014,68,187000,170000,5,5,16,42,9,59,24,44
12364,E02004686,2009,138,176000,172000,6,22,65,45,39,99,92,46
12365,E02004686,2010,195,169000,162000,8,22,69,96,95,100,99,96
12366,E02004686,2011,137,180000,164000,8,15,49,65,54,83,70,67
12367,E02004686,2012,98,199000,190000,10,20,43,25,3,95,70,28
12368,E02004686,2013,120,202000,192000,4,23,58,35,2,118,85,35
12369,E02004686,2014,43,204000,175000,4,2,19,18,3,40,26,17
12370,E02004687,2009,113,217000,206000,41,19,53,0,60,53,113,0
12371,E02004687,2010,64,227000,185000,19,13,25,7,12,52,57,7
12372,E02004687,2011,69,180000,158000,11,13,36,9,2,67,60,9
12373,E02004687,2012,83,194000,164000,18,11,44,10,2,81,74,9
12374,E02004687,2013,93,201000,170000,16,15,56,6,0,93,86,7
12375,E02004687,2014,27,187000,167000,2,4,16,5,0,27,21,6
12376,E02004688,2009,80,159000,155000,8,26,41,5,0,80,74,6
12377,E02004688,2010,70,176000,165000,9,19,35,7,0,70,61,9
12378,E02004688,2011,63,172000,165000,5,23,29,6,0,63,57,6
12379,E02004688,2012,67,177000,163000,7,20,35,5,0,67,61,6
12380,E02004688,2013,95,184000,175000,11,26,44,14,0,95,81,14
12381,E02004688,2014,34,198000,186000,3,11,16,4,0,34,30,4
12382,E02004689,2009,64,286000,258000,41,12,11,0,1,63,64,0
12383,E02004689,2010,72,310000,297000,40,22,9,1,5,67,71,1
12384,E02004689,2011,70,285000,250000,37,20,10,3,0,70,66,4
12385,E02004689,2012,81,316000,280000,41,25,14,1,6,75,80,1
12386,E02004689,2013,69,313000,320000,39,21,5,4,0,69,65,4
12387,E02004689,2014,25,317000,297000,17,2,5,1,0,25,24,1
12388,E02004690,2009,137,178000,165000,9,42,39,47,26,111,88,49
12389,E02004690,2010,131,197000,180000,10,38,51,32,42,89,99,32
12390,E02004690,2011,142,206000,176000,18,44,45,35,28,114,107,35
12391,E02004690,2012,102,211000,185000,14,39,36,13,5,97,89,13
12392,E02004690,2013,137,221000,197000,23,50,40,24,2,135,112,25
12393,E02004690,2014,44,212000,198000,6,10,17,11,0,44,33,11
12394,E02004691,2009,84,445000,382000,62,9,9,4,1,83,80,4
12395,E02004691,2010,88,488000,352000,52,23,10,3,4,84,85,3
12396,E02004691,2011,89,457000,380000,49,21,12,7,3,86,82,7
12397,E02004691,2012,76,423000,345000,51,13,9,3,8,68,73,3
12398,E02004691,2013,87,426000,350000,57,12,12,6,5,82,81,6
12399,E02004691,2014,36,492000,358000,20,9,2,5,2,34,31,5
12400,E02004692,2009,84,282000,246000,49,28,7,0,0,84,84,0
12401,E02004692,2010,88,283000,268000,57,21,8,2,1,87,85,3
12402,E02004692,2011,90,278000,256000,49,31,8,2,0,90,87,3
12403,E02004692,2012,111,283000,268000,66,33,11,1,6,105,109,2
12404,E02004692,2013,109,301000,285000,66,30,6,7,0,109,102,7
12405,E02004692,2014,44,334000,319000,26,14,4,0,0,44,44,0
12406,E02004693,2009,99,159000,156000,10,16,65,8,0,99,90,9
12407,E02004693,2010,69,184000,175000,14,15,33,7,0,69,61,8
12408,E02004693,2011,92,167000,165000,8,14,55,15,1,91,77,15
12409,E02004693,2012,90,186000,172000,16,14,57,3,2,88,87,3
12410,E02004693,2013,106,186000,178000,12,23,64,7,2,104,99,7
12411,E02004693,2014,63,189000,174000,4,3,34,22,24,39,41,22
12412,E02004694,2009,117,278000,240000,37,27,46,7,27,90,111,6
12413,E02004694,2010,65,345000,250000,27,17,17,4,4,61,61,4
12414,E02004694,2011,81,322000,250000,28,21,24,8,6,75,72,9
12415,E02004694,2012,96,323000,249000,26,31,32,7,2,94,88,8
12416,E02004694,2013,81,308000,260000,25,23,30,3,5,76,77,4
12417,E02004694,2014,34,341000,298000,12,8,12,2,0,34,31,3
12418,E02004695,2009,134,220000,222000,56,28,42,8,0,134,125,9
12419,E02004695,2010,139,241000,242000,57,27,52,3,0,139,134,5
12420,E02004695,2011,122,242000,247000,58,17,39,8,0,122,114,8
12421,E02004695,2012,124,251000,249000,63,16,39,6,0,124,118,6
12422,E02004695,2013,183,254000,243000,78,26,64,15,0,183,168,15
12423,E02004695,2014,70,259000,258000,27,12,24,7,0,70,63,7
12424,E02004696,2009,114,276000,278000,46,33,29,6,43,71,104,10
12425,E02004696,2010,95,295000,248000,31,30,24,10,23,72,83,12
12426,E02004696,2011,89,297000,232000,27,17,35,10,3,86,79,10
12427,E02004696,2012,57,331000,275000,23,17,12,5,0,57,52,5
12428,E02004696,2013,80,331000,297000,29,19,23,9,0,80,71,9
12429,E02004696,2014,19,476000,308000,9,3,5,2,0,19,17,2
12430,E02004697,2009,89,438000,340000,41,26,18,4,16,73,84,5
12431,E02004697,2010,79,437000,376000,45,22,10,2,5,74,77,2
12432,E02004697,2011,71,458000,405000,34,22,12,3,8,63,68,3
12433,E02004697,2012,73,471000,455000,35,23,12,3,3,70,70,3
12434,E02004697,2013,129,383000,280000,49,36,31,13,41,88,118,11
12435,E02004697,2014,30,448000,384000,14,3,9,4,7,23,25,5
12436,E02004698,2009,55,197000,165000,6,12,14,23,4,51,31,24
12437,E02004698,2010,61,237000,200000,10,16,11,24,5,56,37,24
12438,E02004698,2011,70,192000,180000,6,11,20,33,4,66,35,35
12439,E02004698,2012,77,191000,178000,5,17,21,34,2,75,42,35
12440,E02004698,2013,89,221000,202000,8,21,25,35,11,78,54,35
12441,E02004698,2014,38,214000,210000,1,11,10,16,2,36,22,16
12442,E02004699,2009,190,236000,215000,48,44,57,41,6,184,147,43
12443,E02004699,2010,171,260000,236000,45,34,49,43,5,166,124,47
12444,E02004699,2011,173,266000,245000,45,47,52,29,21,152,143,30
12445,E02004699,2012,165,252000,234000,38,44,49,34,9,156,131,34
12446,E02004699,2013,206,262000,240000,48,50,67,41,1,205,162,44
12447,E02004699,2014,78,273000,252000,19,25,20,14,0,78,63,15
12448,E02004700,2009,61,167000,152000,7,14,21,19,9,52,41,20
12449,E02004700,2010,58,254000,165000,12,12,23,11,3,55,46,12
12450,E02004700,2011,57,222000,160000,13,11,14,19,9,48,38,19
12451,E02004700,2012,46,302000,162000,11,8,16,11,5,41,35,11
12452,E02004700,2013,75,213000,175000,18,19,23,15,3,72,60,15
12453,E02004700,2014,26,249000,197000,6,6,9,5,0,26,22,4
12454,E02004702,2009,128,200000,185000,32,24,59,13,35,93,116,12
12455,E02004702,2010,102,202000,175000,26,21,50,5,1,101,97,5
12456,E02004702,2011,107,193000,172000,20,26,48,13,2,105,94,13
12457,E02004702,2012,121,203000,185000,29,23,51,18,5,116,103,18
12458,E02004702,2013,130,188000,177000,29,26,62,13,1,129,117,13
12459,E02004702,2014,47,198000,190000,11,11,21,4,0,47,43,4
12460,E02004703,2009,185,384000,322000,106,46,22,11,30,155,171,14
12461,E02004703,2010,173,437000,400000,126,27,17,3,20,153,170,3
12462,E02004703,2011,144,447000,384000,102,23,14,5,26,118,140,4
12463,E02004703,2012,168,462000,412000,118,27,17,6,32,136,162,6
12464,E02004703,2013,194,480000,400000,139,33,18,4,35,159,190,4
12465,E02004703,2014,63,501000,430000,45,10,7,1,10,53,61,2
12466,E02004704,2009,61,394000,255000,35,14,8,4,0,61,58,3
12467,E02004704,2010,69,337000,300000,37,12,18,2,0,69,67,2
12468,E02004704,2011,51,336000,250000,23,13,13,2,1,50,48,3
12469,E02004704,2012,68,319000,241000,27,15,25,1,0,68,67,1
12470,E02004704,2013,82,323000,279000,45,16,19,2,0,82,80,2
12471,E02004704,2014,31,365000,285000,17,7,6,1,0,31,31,0
12472,E02004705,2009,147,287000,254000,49,20,33,45,35,112,98,49
12473,E02004705,2010,149,367000,325000,63,26,27,33,35,114,108,41
12474,E02004705,2011,174,359000,319000,70,39,29,36,34,140,133,41
12475,E02004705,2012,123,359000,338000,53,26,15,29,15,108,94,29
12476,E02004705,2013,157,382000,302000,63,28,38,28,7,150,129,28
12477,E02004705,2014,69,421000,350000,34,10,15,10,2,67,59,10
12478,E02004706,2009,107,344000,265000,43,32,18,14,4,103,92,15
12479,E02004706,2010,105,333000,280000,48,30,15,12,4,101,92,13
12480,E02004706,2011,115,307000,260000,42,35,32,6,7,108,107,8
12481,E02004706,2012,119,357000,295000,49,32,26,12,8,111,106,13
12482,E02004706,2013,124,428000,315000,56,38,24,6,6,118,117,7
12483,E02004706,2014,30,433000,332000,14,10,2,4,3,27,26,4
12484,E02004707,2009,135,366000,320000,64,29,21,21,6,129,112,23
12485,E02004707,2010,153,408000,378000,80,26,35,12,3,150,140,13
12486,E02004707,2011,154,447000,375000,76,33,29,16,7,147,137,17
12487,E02004707,2012,149,400000,350000,67,33,30,19,8,141,129,20
12488,E02004707,2013,178,416000,373000,79,27,41,31,13,165,143,35
12489,E02004707,2014,63,507000,405000,31,16,13,3,0,63,59,4
12490,E02004708,2009,144,228000,195000,21,30,42,51,10,134,90,54
12491,E02004708,2010,134,270000,225000,24,22,46,42,3,131,91,43
12492,E02004708,2011,132,272000,228000,24,28,33,47,9,123,86,46
12493,E02004708,2012,142,254000,231000,20,30,51,41,3,139,101,41
12494,E02004708,2013,153,272000,242000,17,33,62,41,10,143,113,40
12495,E02004708,2014,70,266000,247000,4,15,27,24,3,67,47,23
12496,E02004709,2009,96,222000,210000,56,19,11,10,5,91,87,9
12497,E02004709,2010,92,253000,240000,53,24,6,9,0,92,83,9
12498,E02004709,2011,90,248000,238000,42,27,11,10,8,82,81,9
12499,E02004709,2012,120,249000,238000,59,37,10,14,11,109,106,14
12500,E02004709,2013,170,271000,250000,74,50,32,14,51,119,157,13
12501,E02004709,2014,52,259000,245000,25,13,4,10,11,41,42,10
12502,E02004710,2009,65,245000,231000,30,15,18,2,4,61,63,2
12503,E02004710,2010,92,293000,250000,49,22,21,0,9,83,92,0
12504,E02004710,2011,75,264000,244000,38,16,20,1,14,61,74,1
12505,E02004710,2012,89,263000,234000,46,25,17,1,15,74,88,1
12506,E02004710,2013,105,279000,248000,56,28,21,0,14,91,105,0
12507,E02004710,2014,38,327000,295000,30,5,3,0,1,37,38,0
12508,E02004719,2012,1,335000,335000,0,1,0,0,0,1,1,0
12509,E02004719,2013,1,201000,201000,0,1,0,0,0,1,1,0
12510,E02004751,2009,86,265000,225000,29,29,25,3,0,86,83,3
12511,E02004751,2010,97,267000,240000,24,34,34,5,0,97,92,5
12512,E02004751,2011,98,316000,250000,39,37,21,1,0,98,97,1
12513,E02004751,2012,85,290000,232000,22,27,35,1,5,80,84,1
12514,E02004751,2013,116,301000,257000,36,36,42,2,0,116,114,2
12515,E02004751,2014,43,302000,250000,8,14,21,0,0,43,43,0
12516,E02004752,2009,107,274000,227000,33,29,35,10,0,107,95,12
12517,E02004752,2010,115,312000,250000,35,43,32,5,0,115,111,4
12518,E02004752,2011,107,282000,238000,26,30,45,6,0,107,101,6
12519,E02004752,2012,100,309000,250000,33,32,33,2,0,100,98,2
12520,E02004752,2013,115,319000,250000,38,29,35,13,1,114,103,12
12521,E02004752,2014,36,371000,296000,13,6,14,3,0,36,33,3
12522,E02004753,2009,123,233000,200000,35,30,50,8,0,123,115,8
12523,E02004753,2010,108,253000,218000,32,20,43,13,0,108,95,13
12524,E02004753,2011,121,269000,244000,50,24,38,9,0,121,112,9
12525,E02004753,2012,118,262000,225000,38,22,49,9,0,118,109,9
12526,E02004753,2013,174,296000,248000,68,31,68,7,4,170,165,9
12527,E02004753,2014,60,308000,255000,21,11,25,3,5,55,57,3
12528,E02004754,2009,75,475000,378000,44,9,17,5,6,69,69,6
12529,E02004754,2010,81,365000,295000,29,13,27,12,0,81,68,13
12530,E02004754,2011,120,389000,346000,38,20,52,10,38,82,108,12
12531,E02004754,2012,87,434000,365000,35,20,28,4,22,65,83,4
12532,E02004754,2013,126,440000,372000,52,13,52,9,39,87,117,9
12533,E02004754,2014,27,353000,300000,5,6,12,4,0,27,22,5
12534,E02004755,2009,231,263000,235000,77,37,40,77,14,217,149,82
12535,E02004755,2010,251,285000,250000,76,50,47,78,2,249,166,85
12536,E02004755,2011,222,299000,250000,68,41,43,70,2,220,150,72
12537,E02004755,2012,206,315000,271000,62,25,62,57,0,206,151,55
12538,E02004755,2013,260,315000,265000,77,47,50,86,7,253,178,82
12539,E02004755,2014,104,279000,250000,20,16,23,45,3,101,57,47
12540,E02004756,2009,131,310000,295000,68,26,28,9,3,128,119,12
12541,E02004756,2010,117,332000,320000,63,18,32,4,0,117,110,7
12542,E02004756,2011,98,324000,290000,46,21,21,10,0,98,89,9
12543,E02004756,2012,115,321000,285000,57,23,28,7,1,114,104,11
12544,E02004756,2013,138,334000,300000,67,22,40,9,1,137,122,16
12545,E02004756,2014,46,375000,375000,25,12,8,1,0,46,43,3
12546,E02004757,2009,100,350000,316000,65,22,5,8,0,100,92,8
12547,E02004757,2010,113,351000,355000,72,25,7,9,0,113,104,9
12548,E02004757,2011,105,386000,360000,68,28,6,3,3,102,101,4
12549,E02004757,2012,128,367000,359000,78,31,10,9,10,118,119,9
12550,E02004757,2013,105,398000,375000,68,22,10,5,2,103,100,5
12551,E02004757,2014,45,401000,380000,29,6,7,3,1,44,42,3
12552,E02004758,2009,83,387000,315000,39,24,9,11,3,80,72,11
12553,E02004758,2010,95,405000,328000,44,26,18,7,1,94,86,9
12554,E02004758,2011,130,387000,346000,54,41,23,12,45,85,118,12
12555,E02004758,2012,133,413000,340000,66,27,29,11,37,96,122,11
12556,E02004758,2013,157,467000,420000,85,31,25,16,52,105,141,16
12557,E02004758,2014,37,422000,356000,18,9,5,5,4,33,32,5
12558,E02004759,2009,116,249000,240000,32,57,16,11,0,116,105,11
12559,E02004759,2010,141,290000,275000,48,61,19,13,0,141,126,15
12560,E02004759,2011,118,293000,281000,50,48,11,9,0,118,109,9
12561,E02004759,2012,106,309000,286000,40,46,12,8,6,100,98,8
12562,E02004759,2013,167,296000,273000,57,59,24,27,18,149,140,27
12563,E02004759,2014,44,318000,296000,18,14,7,5,1,43,38,6
12564,E02004760,2009,100,358000,295000,51,22,21,6,0,100,93,7
12565,E02004760,2010,113,377000,320000,61,20,28,4,0,113,107,6
12566,E02004760,2011,118,467000,388000,59,17,31,11,4,114,105,13
12567,E02004760,2012,122,472000,362000,69,7,42,4,21,101,117,5
12568,E02004760,2013,194,373000,348000,81,32,71,10,89,105,182,12
12569,E02004760,2014,68,397000,352000,26,21,18,3,15,53,64,4
12570,E02004761,2009,68,347000,279000,23,21,15,9,1,67,58,10
12571,E02004761,2010,71,443000,350000,36,8,21,6,1,70,64,7
12572,E02004761,2011,65,395000,352000,27,15,19,4,0,65,60,5
12573,E02004761,2012,57,468000,384000,28,11,13,5,0,57,52,5
12574,E02004761,2013,71,410000,355000,27,17,18,9,1,70,62,9
12575,E02004761,2014,22,513000,420000,11,7,3,1,0,22,21,1
12576,E02004764,2009,100,212000,204000,41,50,8,1,4,96,99,1
12577,E02004764,2010,80,235000,214000,38,31,10,1,4,76,79,1
12578,E02004764,2011,88,203000,196000,38,38,9,3,3,85,85,3
12579,E02004764,2012,113,206000,200000,40,46,11,16,16,97,99,14
12580,E02004764,2013,133,204000,200000,52,57,8,16,17,116,117,16
12581,E02004764,2014,41,217000,219000,18,21,1,1,1,40,40,1
12582,E02004765,2009,81,198000,180000,25,27,23,6,0,81,75,6
12583,E02004765,2010,84,219000,196000,29,30,18,7,2,82,77,7
12584,E02004765,2011,91,203000,175000,29,24,29,9,0,91,82,9
12585,E02004765,2012,85,213000,206000,33,24,16,12,0,85,74,11
12586,E02004765,2013,114,239000,238000,50,28,28,8,10,104,106,8
12587,E02004765,2014,49,224000,205000,16,14,15,4,5,44,44,5
12588,E02004766,2009,72,161000,158000,10,24,20,18,8,64,54,18
12589,E02004766,2010,63,177000,170000,9,22,23,9,2,61,54,9
12590,E02004766,2011,74,173000,164000,14,24,16,20,0,74,54,20
12591,E02004766,2012,72,181000,166000,17,24,20,11,2,70,61,11
12592,E02004766,2013,113,175000,172000,19,31,20,43,29,84,71,42
12593,E02004766,2014,43,174000,170000,7,11,13,12,6,37,32,11
12594,E02004767,2009,64,135000,124000,1,14,37,12,8,56,51,13
12595,E02004767,2010,57,143000,138000,0,11,33,13,19,38,46,11
12596,E02004767,2011,50,142000,140000,0,14,33,3,11,39,44,6
12597,E02004767,2012,50,143000,139000,0,10,28,12,11,39,39,11
12598,E02004767,2013,51,132000,133000,0,4,38,9,1,50,42,9
12599,E02004767,2014,14,148000,149000,0,1,13,0,0,14,14,0
12600,E02004768,2009,58,173000,148000,12,13,31,2,0,58,57,1
12601,E02004768,2010,60,193000,165000,14,20,25,1,1,59,59,1
12602,E02004768,2011,60,169000,154000,16,10,26,8,0,60,51,9
12603,E02004768,2012,60,179000,160000,16,10,28,6,0,60,54,6
12604,E02004768,2013,81,173000,160000,13,12,52,4,0,81,77,4
12605,E02004768,2014,27,184000,170000,4,5,16,2,0,27,25,2
12606,E02004769,2009,51,116000,120000,0,14,23,14,6,45,37,14
12607,E02004769,2010,40,124000,126000,0,15,19,6,1,39,35,5
12608,E02004769,2011,31,125000,127000,0,8,18,5,0,31,26,5
12609,E02004769,2012,49,131000,130000,0,9,37,3,0,49,46,3
12610,E02004769,2013,48,136000,132000,0,18,25,5,0,48,44,4
12611,E02004769,2014,20,136000,140000,0,9,8,3,0,20,18,2
12612,E02004770,2009,62,127000,129000,3,21,33,5,1,61,58,4
12613,E02004770,2010,53,130000,135000,1,15,32,5,0,53,47,6
12614,E02004770,2011,46,131000,132000,0,11,31,4,0,46,42,4
12615,E02004770,2012,50,134000,132000,0,13,32,5,0,50,45,5
12616,E02004770,2013,60,134000,138000,0,15,39,6,0,60,54,6
12617,E02004770,2014,24,159000,148000,1,7,14,2,3,21,22,2
12618,E02004771,2009,78,121000,115000,5,20,37,16,6,72,62,16
12619,E02004771,2010,61,134000,130000,2,18,26,15,6,55,46,15
12620,E02004771,2011,61,138000,134000,2,18,36,5,0,61,56,5
12621,E02004771,2012,51,138000,140000,1,19,30,1,0,51,50,1
12622,E02004771,2013,92,139000,136000,2,34,47,9,0,92,82,10
12623,E02004771,2014,26,148000,150000,1,8,14,3,0,26,22,4
12624,E02004772,2009,104,190000,175000,27,43,28,6,1,103,97,7
12625,E02004772,2010,127,203000,195000,35,51,29,12,4,123,115,12
12626,E02004772,2011,132,195000,192000,29,54,36,13,15,117,119,13
12627,E02004772,2012,121,204000,201000,32,49,25,15,13,108,106,15
12628,E02004772,2013,152,219000,215000,43,51,38,20,20,132,133,19
12629,E02004772,2014,64,230000,222000,17,25,19,3,9,55,61,3
12630,E02004774,2009,118,277000,240000,41,38,33,6,1,117,108,10
12631,E02004774,2010,179,303000,250000,74,38,30,37,17,162,141,38
12632,E02004774,2011,146,330000,249000,55,42,24,25,10,136,120,26
12633,E02004774,2012,138,326000,270000,50,32,33,23,15,123,111,27
12634,E02004774,2013,243,330000,290000,101,63,64,15,69,174,223,20
12635,E02004774,2014,64,344000,308000,27,16,11,10,11,53,54,10
12636,E02004775,2009,127,230000,205000,42,30,39,16,0,127,110,17
12637,E02004775,2010,120,253000,201000,43,23,30,24,0,120,96,24
12638,E02004775,2011,129,234000,204000,48,17,34,30,7,122,100,29
12639,E02004775,2012,120,230000,197000,41,17,29,33,10,110,88,32
12640,E02004775,2013,165,241000,217000,63,24,43,35,13,152,129,36
12641,E02004775,2014,55,248000,230000,20,11,14,10,4,51,46,9
12642,E02004776,2009,49,239000,225000,21,11,8,9,0,49,41,8
12643,E02004776,2010,75,297000,250000,42,19,8,6,2,73,69,6
12644,E02004776,2011,53,287000,245000,31,14,7,1,0,53,52,1
12645,E02004776,2012,51,270000,250000,26,16,6,3,0,51,48,3
12646,E02004776,2013,53,297000,250000,31,15,4,3,0,53,50,3
12647,E02004776,2014,19,302000,250000,10,6,3,0,0,19,19,0
12648,E02004777,2009,67,214000,210000,27,13,13,14,1,66,53,14
12649,E02004777,2010,52,242000,212000,25,16,2,9,1,51,43,9
12650,E02004777,2011,56,224000,212000,26,10,9,11,0,56,45,11
12651,E02004777,2012,69,212000,205000,28,14,9,18,3,66,52,17
12652,E02004777,2013,75,247000,225000,36,18,12,9,1,74,67,8
12653,E02004777,2014,28,277000,250000,13,6,5,4,0,28,24,4
12654,E02004778,2009,89,192000,180000,43,17,8,21,3,86,68,21
12655,E02004778,2010,115,237000,215000,61,19,6,29,6,109,85,30
12656,E02004778,2011,71,206000,195000,31,15,4,21,0,71,50,21
12657,E02004778,2012,94,210000,198000,42,21,7,24,0,94,71,23
12658,E02004778,2013,122,221000,218000,63,22,9,28,2,120,94,28
12659,E02004778,2014,60,240000,231000,36,9,4,11,0,60,49,11
12660,E02004802,2009,70,186000,170000,7,36,11,16,1,69,50,20
12661,E02004802,2010,68,216000,210000,8,34,16,10,0,68,58,10
12662,E02004802,2011,70,211000,200000,10,35,12,13,0,70,57,13
12663,E02004802,2012,72,199000,200000,7,29,20,16,0,72,57,15
12664,E02004802,2013,77,233000,218000,11,41,10,15,7,70,63,14
12665,E02004802,2014,25,231000,220000,3,8,9,5,1,24,21,4
12666,E02004803,2009,65,170000,160000,4,11,44,6,0,65,59,6
12667,E02004803,2010,62,178000,169000,1,23,35,3,0,62,59,3
12668,E02004803,2011,47,169000,160000,1,13,27,6,0,47,41,6
12669,E02004803,2012,63,171000,165000,2,11,41,9,2,61,54,9
12670,E02004803,2013,64,178000,168000,2,12,44,6,0,64,57,7
12671,E02004803,2014,18,199000,191000,0,4,14,0,0,18,17,1
12672,E02004804,2009,100,203000,198000,20,35,41,4,0,100,96,4
12673,E02004804,2010,97,207000,200000,11,32,50,4,0,97,92,5
12674,E02004804,2011,110,215000,210000,21,35,50,4,0,110,106,4
12675,E02004804,2012,92,197000,195000,8,27,51,6,1,91,86,6
12676,E02004804,2013,118,227000,235000,7,55,51,5,5,113,113,5
12677,E02004804,2014,39,240000,250000,4,16,18,1,0,39,38,1
12678,E02004805,2009,191,201000,175000,27,21,44,99,112,79,92,99
12679,E02004805,2010,227,230000,195000,52,31,30,114,115,112,113,114
12680,E02004805,2011,150,256000,236000,38,20,36,56,52,98,95,55
12681,E02004805,2012,109,272000,240000,30,19,27,33,14,95,76,33
12682,E02004805,2013,197,275000,250000,55,57,25,60,23,174,137,60
12683,E02004805,2014,59,289000,250000,17,8,14,20,3,56,39,20
12684,E02004806,2009,149,239000,225000,51,47,45,6,11,138,142,7
12685,E02004806,2010,124,261000,245000,47,47,26,4,0,124,118,6
12686,E02004806,2011,116,235000,228000,31,39,37,9,3,113,105,11
12687,E02004806,2012,87,250000,235000,21,35,25,6,0,87,81,6
12688,E02004806,2013,156,253000,247000,43,55,51,7,3,153,149,7
12689,E02004806,2014,52,258000,269000,11,13,21,7,1,51,45,7
12690,E02004807,2009,157,186000,175000,18,72,31,36,26,131,120,37
12691,E02004807,2010,148,213000,218000,18,62,40,28,12,136,119,29
12692,E02004807,2011,109,202000,195000,12,40,29,28,4,105,79,30
12693,E02004807,2012,128,201000,190000,12,50,33,33,0,128,95,33
12694,E02004807,2013,191,205000,195000,18,55,37,81,32,159,110,81
12695,E02004807,2014,65,206000,208000,2,16,18,29,9,56,36,29
12696,E02004808,2009,126,190000,177000,28,31,25,42,13,113,84,42
12697,E02004808,2010,154,226000,220000,36,37,41,40,19,135,115,39
12698,E02004808,2011,194,212000,210000,22,55,47,70,65,129,126,68
12699,E02004808,2012,187,219000,205000,28,27,68,64,79,108,123,64
12700,E02004808,2013,308,214000,202000,35,41,67,165,125,183,143,165
12701,E02004808,2014,59,194000,174000,5,10,12,32,3,56,28,31
12702,E02004809,2009,45,136000,129000,0,0,12,33,0,45,12,33
12703,E02004809,2010,48,147000,147000,0,2,13,33,0,48,15,33
12704,E02004809,2011,50,137000,130000,1,0,14,35,0,50,14,36
12705,E02004809,2012,64,139000,125000,0,2,17,45,10,54,19,45
12706,E02004809,2013,71,134000,137000,0,0,15,56,2,69,16,55
12707,E02004809,2014,27,148000,144000,0,0,6,21,0,27,6,21
12708,E02004810,2009,112,170000,170000,6,41,40,25,1,111,86,26
12709,E02004810,2010,101,193000,200000,9,35,36,21,0,101,80,21
12710,E02004810,2011,93,190000,190000,8,34,37,14,0,93,79,14
12711,E02004810,2012,114,192000,186000,11,48,37,18,0,114,95,19
12712,E02004810,2013,146,190000,190000,6,30,68,42,5,141,105,41
12713,E02004810,2014,48,204000,224000,3,17,14,14,0,48,34,14
12714,E02004811,2009,99,196000,175000,21,22,29,27,0,99,77,22
12715,E02004811,2010,94,217000,194000,12,22,31,29,3,91,65,29
12716,E02004811,2011,106,208000,189000,14,24,37,31,3,103,76,30
12717,E02004811,2012,111,218000,198000,22,23,41,25,1,110,85,26
12718,E02004811,2013,160,212000,193000,24,39,59,38,2,158,122,38
12719,E02004811,2014,59,193000,180000,3,10,16,30,5,54,29,30
12720,E02004812,2009,76,203000,195000,10,33,24,9,1,75,67,9
12721,E02004812,2010,80,238000,226000,25,30,16,9,4,76,70,10
12722,E02004812,2011,97,215000,219000,18,36,22,21,7,90,75,22
12723,E02004812,2012,85,240000,234000,24,29,17,15,7,78,69,16
12724,E02004812,2013,115,235000,232000,27,42,24,22,7,108,93,22
12725,E02004812,2014,41,239000,235000,8,10,15,8,2,39,33,8
12726,E02004813,2009,69,176000,169000,3,22,40,4,0,69,64,5
12727,E02004813,2010,53,188000,183000,3,18,26,6,0,53,47,6
12728,E02004813,2011,56,178000,177000,0,21,29,6,0,56,49,7
12729,E02004813,2012,67,185000,187000,1,29,31,6,1,66,61,6
12730,E02004813,2013,64,202000,200000,5,28,24,7,0,64,59,5
12731,E02004813,2014,24,214000,216000,4,5,12,3,0,24,20,4
12732,E02004814,2009,71,269000,210000,34,23,14,0,1,70,71,0
12733,E02004814,2010,71,307000,248000,44,16,11,0,0,71,71,0
12734,E02004814,2011,54,262000,232000,27,15,11,1,0,54,53,1
12735,E02004814,2012,60,310000,247000,36,11,12,1,0,60,59,1
12736,E02004814,2013,65,316000,260000,40,9,16,0,0,65,64,1
12737,E02004814,2014,31,262000,224000,17,6,7,1,0,31,29,2
12738,E02004815,2009,41,135000,122000,2,8,25,6,0,41,38,3
12739,E02004815,2010,47,135000,130000,2,5,34,6,0,47,43,4
12740,E02004815,2011,52,130000,122000,3,5,39,5,0,52,48,4
12741,E02004815,2012,58,133000,128000,2,9,44,3,0,58,55,3
12742,E02004815,2013,77,132000,130000,2,6,63,6,0,77,72,5
12743,E02004815,2014,20,150000,150000,1,5,12,2,0,20,18,2
12744,E02004816,2009,99,207000,165000,32,17,30,20,32,67,81,18
12745,E02004816,2010,166,227000,211000,71,32,39,24,93,73,143,23
12746,E02004816,2011,221,211000,200000,81,55,55,30,138,83,189,32
12747,E02004816,2012,232,227000,215000,86,58,64,24,139,93,215,17
12748,E02004816,2013,306,218000,210000,95,80,96,35,163,143,287,19
12749,E02004816,2014,78,212000,205000,21,19,21,17,37,41,63,15
12750,E02004817,2009,59,147000,137000,6,18,13,22,10,49,37,22
12751,E02004817,2010,44,165000,163000,3,19,17,5,2,42,39,5
12752,E02004817,2011,52,170000,166000,7,17,20,8,3,49,44,8
12753,E02004817,2012,58,158000,152000,1,18,25,14,4,54,44,14
12754,E02004817,2013,75,163000,156000,4,25,26,20,1,74,54,21
12755,E02004817,2014,29,171000,148000,4,4,10,11,0,29,18,11
12756,E02004819,2009,47,199000,161000,13,10,9,15,9,38,29,18
12757,E02004819,2010,29,216000,175000,10,4,8,7,1,28,22,7
12758,E02004819,2011,32,186000,160000,9,5,8,10,0,32,21,11
12759,E02004819,2012,37,201000,165000,9,9,10,9,1,36,26,11
12760,E02004819,2013,47,187000,175000,13,9,11,14,1,46,32,15
12761,E02004819,2014,17,192000,175000,4,4,3,6,0,17,11,6
12762,E02004821,2009,33,468000,460000,20,8,4,1,0,33,32,1
12763,E02004821,2010,37,441000,435000,17,16,4,0,0,37,37,0
12764,E02004821,2011,33,510000,425000,21,9,2,1,0,33,32,1
12765,E02004821,2012,27,557000,480000,20,7,0,0,0,27,27,0
12766,E02004821,2013,42,451000,355000,18,15,7,2,1,41,40,2
12767,E02004821,2014,11,415000,372000,6,4,1,0,1,10,11,0
12768,E02004829,2009,60,398000,306000,21,20,18,1,3,57,59,1
12769,E02004829,2010,81,394000,345000,32,33,16,0,18,63,80,1
12770,E02004829,2011,52,321000,295000,20,14,18,0,8,44,51,1
12771,E02004829,2012,56,335000,318000,27,16,8,5,4,52,51,5
12772,E02004829,2013,92,322000,294000,36,21,29,6,15,77,86,6
12773,E02004829,2014,25,364000,315000,9,6,8,2,2,23,23,2
12774,E02004830,2009,75,388000,295000,36,19,7,13,1,74,62,13
12775,E02004830,2010,81,402000,315000,39,20,14,8,1,80,73,8
12776,E02004830,2011,113,399000,320000,52,29,23,9,27,86,105,8
12777,E02004830,2012,92,403000,327000,44,24,18,6,11,81,85,7
12778,E02004830,2013,101,431000,340000,47,28,20,6,4,97,94,7
12779,E02004830,2014,44,437000,356000,23,8,10,3,5,39,40,4
12780,E02004831,2009,110,385000,309000,49,33,21,7,18,92,102,8
12781,E02004831,2010,122,438000,335000,52,36,28,6,12,110,115,7
12782,E02004831,2011,119,415000,330000,53,34,21,11,3,116,107,12
12783,E02004831,2012,124,406000,322000,55,43,15,11,7,117,113,11
12784,E02004831,2013,148,459000,411000,73,37,26,12,30,118,135,13
12785,E02004831,2014,51,407000,372000,20,11,13,7,5,46,44,7
12786,E02004832,2009,126,307000,279000,42,41,37,6,14,112,119,7
12787,E02004832,2010,118,337000,295000,43,28,39,8,6,112,107,11
12788,E02004832,2011,110,396000,318000,39,24,34,13,3,107,95,15
12789,E02004832,2012,106,404000,318000,55,20,24,7,0,106,99,7
12790,E02004832,2013,130,411000,341000,58,32,29,11,6,124,118,12
12791,E02004832,2014,53,334000,330000,20,12,16,5,12,41,47,6
12792,E02004833,2009,167,350000,300000,33,38,51,45,36,131,122,45
12793,E02004833,2010,155,421000,375000,46,49,41,19,22,133,135,20
12794,E02004833,2011,138,405000,328000,30,35,50,23,16,122,113,25
12795,E02004833,2012,105,362000,305000,21,21,34,29,13,92,73,32
12796,E02004833,2013,153,434000,375000,32,37,53,31,5,148,122,31
12797,E02004833,2014,54,500000,390000,13,8,20,13,9,45,39,15
12798,E02004834,2009,64,267000,224000,8,12,33,11,0,64,49,15
12799,E02004834,2010,73,303000,250000,7,16,37,13,0,73,58,15
12800,E02004834,2011,107,341000,288000,7,14,52,34,10,97,68,39
12801,E02004834,2012,93,342000,275000,7,22,42,22,12,81,66,27
12802,E02004834,2013,125,382000,300000,9,22,64,30,24,101,90,35
12803,E02004834,2014,30,292000,278000,2,4,13,11,2,28,18,12
12804,E02004835,2009,217,337000,278000,25,17,77,98,30,187,116,101
12805,E02004835,2010,256,365000,315000,16,23,103,114,52,204,141,115
12806,E02004835,2011,226,372000,310000,13,21,86,106,25,201,117,109
12807,E02004835,2012,202,400000,326000,14,15,78,95,34,168,106,96
12808,E02004835,2013,216,412000,350000,18,15,80,103,22,194,114,102
12809,E02004835,2014,73,448000,340000,3,5,32,33,11,62,40,33
12810,E02004836,2009,37,376000,230000,9,17,5,6,0,37,30,7
12811,E02004836,2010,47,352000,245000,8,21,6,12,6,41,35,12
12812,E02004836,2011,44,377000,229000,5,24,7,8,1,43,36,8
12813,E02004836,2012,37,396000,240000,9,12,8,8,0,37,29,8
12814,E02004836,2013,55,429000,250000,10,23,6,16,1,54,40,15
12815,E02004836,2014,16,348000,270000,0,10,3,3,1,15,13,3
12816,E02004837,2009,108,293000,235000,45,27,31,5,9,99,103,5
12817,E02004837,2010,89,335000,280000,39,13,28,9,0,89,82,7
12818,E02004837,2011,94,348000,296000,50,15,25,4,1,93,90,4
12819,E02004837,2012,90,391000,328000,51,18,18,3,5,85,87,3
12820,E02004837,2013,86,384000,326000,42,13,26,5,0,86,81,5
12821,E02004837,2014,49,326000,295000,17,10,21,1,0,49,47,2
12822,E02004838,2009,54,511000,360000,31,12,8,3,0,54,51,3
12823,E02004838,2010,31,550000,435000,18,7,5,1,2,29,29,2
12824,E02004838,2011,33,551000,405000,19,10,3,1,0,33,32,1
12825,E02004838,2012,37,569000,490000,20,10,6,1,2,35,36,1
12826,E02004838,2013,56,576000,472000,24,13,17,2,9,47,54,2
12827,E02004838,2014,8,673000,712000,5,2,1,0,0,8,8,0
12828,E02004839,2009,94,348000,312000,38,32,20,4,15,79,89,5
12829,E02004839,2010,85,470000,430000,49,27,8,1,0,85,84,1
12830,E02004839,2011,107,434000,400000,65,23,17,2,13,94,104,3
12831,E02004839,2012,107,413000,360000,56,24,21,6,14,93,98,9
12832,E02004839,2013,100,455000,398000,62,17,15,6,2,98,97,3
12833,E02004839,2014,32,550000,392000,18,4,10,0,0,32,32,0
12834,E02004840,2009,172,253000,209000,53,49,51,19,14,158,155,17
12835,E02004840,2010,144,266000,228000,48,30,40,26,9,135,116,28
12836,E02004840,2011,144,280000,240000,48,47,40,9,13,131,136,8
12837,E02004840,2012,154,258000,235000,55,37,46,16,9,145,138,16
12838,E02004840,2013,157,287000,244000,52,48,37,20,5,152,134,23
12839,E02004840,2014,50,285000,250000,15,14,13,8,0,50,42,8
12840,E02004841,2009,21,335000,305000,11,5,4,1,0,21,19,2
12841,E02004841,2010,20,329000,316000,9,8,2,1,0,20,18,2
12842,E02004841,2011,18,386000,392000,10,5,3,0,1,17,18,0
12843,E02004841,2012,14,410000,422000,8,4,2,0,0,14,14,0
12844,E02004841,2013,33,370000,285000,13,14,3,3,8,25,30,3
12845,E02004841,2014,14,321000,258000,4,5,3,2,1,13,12,2
12846,E02004842,2009,126,255000,211000,55,45,16,10,15,111,117,9
12847,E02004842,2010,160,267000,240000,55,57,33,15,43,117,146,14
12848,E02004842,2011,126,277000,245000,50,26,34,16,31,95,116,10
12849,E02004842,2012,105,281000,235000,43,39,15,8,19,86,99,6
12850,E02004842,2013,186,256000,229000,60,40,42,44,69,117,145,41
12851,E02004842,2014,41,248000,226000,9,16,12,4,5,36,39,2
12852,E02004843,2009,86,246000,225000,15,24,35,12,0,86,74,12
12853,E02004843,2010,84,275000,250000,16,28,29,11,0,84,73,11
12854,E02004843,2011,77,267000,240000,12,24,32,9,0,77,69,8
12855,E02004843,2012,78,273000,241000,12,22,32,12,2,76,66,12
12856,E02004843,2013,90,280000,258000,13,31,30,16,0,90,74,16
12857,E02004843,2014,25,293000,270000,4,8,8,5,0,25,20,5
12858,E02004844,2009,81,206000,195000,5,21,40,15,4,77,65,16
12859,E02004844,2010,100,210000,212000,5,35,44,16,3,97,84,16
12860,E02004844,2011,97,219000,215000,11,45,31,10,0,97,87,10
12861,E02004844,2012,86,225000,225000,8,33,34,11,1,85,75,11
12862,E02004844,2013,104,234000,229000,6,34,54,10,1,103,94,10
12863,E02004844,2014,37,225000,228000,5,8,16,8,0,37,29,8
12864,E02004845,2009,176,228000,175000,28,19,30,99,51,125,77,99
12865,E02004845,2010,177,244000,196000,23,37,36,81,49,128,97,80
12866,E02004845,2011,139,235000,180000,22,14,31,72,23,116,68,71
12867,E02004845,2012,126,233000,205000,19,25,29,53,1,125,73,53
12868,E02004845,2013,136,240000,189000,21,16,35,64,1,135,71,65
12869,E02004845,2014,79,213000,193000,4,12,16,47,0,79,32,47
12870,E02004846,2009,90,373000,355000,33,28,14,15,10,80,73,17
12871,E02004846,2010,90,409000,372000,32,19,19,20,4,86,70,20
12872,E02004846,2011,79,382000,358000,27,22,9,21,0,79,58,21
12873,E02004846,2012,95,407000,408000,41,14,16,24,8,87,71,24
12874,E02004846,2013,94,443000,428000,35,27,16,16,1,93,79,15
12875,E02004846,2014,32,438000,487000,15,8,2,7,0,32,25,7
12876,E02004847,2009,90,204000,188000,2,24,38,26,7,83,66,24
12877,E02004847,2010,182,214000,205000,10,41,54,77,68,114,102,80
12878,E02004847,2011,170,205000,194000,7,34,62,67,53,117,103,67
12879,E02004847,2012,171,236000,225000,15,34,77,45,48,123,126,45
12880,E02004847,2013,218,245000,230000,18,28,106,66,54,164,152,66
12881,E02004847,2014,56,254000,230000,5,12,19,20,4,52,36,20
12882,E02004848,2009,72,257000,248000,14,33,15,10,2,70,63,9
12883,E02004848,2010,89,300000,270000,18,36,23,12,12,77,76,13
12884,E02004848,2011,108,272000,250000,15,37,42,14,29,79,95,13
12885,E02004848,2012,126,267000,258000,17,28,61,20,43,83,109,17
12886,E02004848,2013,158,274000,260000,20,38,73,27,61,97,135,23
12887,E02004848,2014,34,279000,284000,5,9,12,8,10,24,26,8
12888,E02004849,2009,83,373000,334000,39,26,13,5,0,83,77,6
12889,E02004849,2010,84,401000,372000,37,29,14,4,1,83,78,6
12890,E02004849,2011,73,437000,367000,37,20,12,4,0,73,68,5
12891,E02004849,2012,64,399000,358000,34,19,9,2,1,63,61,3
12892,E02004849,2013,90,408000,369000,40,25,14,11,3,87,76,14
12893,E02004849,2014,47,412000,390000,20,17,8,2,0,47,45,2
12894,E02004850,2009,89,212000,210000,6,27,42,14,7,82,73,16
12895,E02004850,2010,106,217000,220000,4,42,43,17,1,105,90,16
12896,E02004850,2011,65,216000,225000,5,18,26,16,1,64,49,16
12897,E02004850,2012,72,226000,229000,9,22,25,16,0,72,57,15
12898,E02004850,2013,80,211000,221000,3,21,31,25,1,79,55,25
12899,E02004850,2014,43,237000,250000,3,14,18,8,0,43,35,8
12900,E02004851,2009,60,217000,198000,8,6,38,8,0,60,52,8
12901,E02004851,2010,73,223000,210000,11,6,45,11,2,71,61,12
12902,E02004851,2011,61,206000,200000,5,8,37,11,0,61,48,13
12903,E02004851,2012,82,213000,203000,7,8,52,15,0,82,66,16
12904,E02004851,2013,83,214000,216000,5,6,58,14,0,83,68,15
12905,E02004851,2014,31,225000,228000,3,1,19,8,0,31,23,8
12906,E02004852,2009,96,188000,194000,1,32,28,35,0,96,61,35
12907,E02004852,2010,101,204000,208000,5,29,32,35,0,101,66,35
12908,E02004852,2011,82,215000,212000,5,26,22,29,0,82,51,31
12909,E02004852,2012,91,224000,231000,8,33,29,21,0,91,67,24
12910,E02004852,2013,115,224000,235000,3,44,31,37,2,113,78,37
12911,E02004852,2014,39,235000,249000,3,7,17,12,0,39,27,12
12912,E02004853,2009,57,213000,200000,4,17,32,4,1,56,53,4
12913,E02004853,2010,58,223000,215000,5,21,21,11,0,58,47,11
12914,E02004853,2011,92,226000,223000,4,29,50,9,0,92,82,10
12915,E02004853,2012,65,237000,232000,7,18,35,5,0,65,60,5
12916,E02004853,2013,81,256000,237000,12,21,40,8,2,79,73,8
12917,E02004853,2014,21,271000,277000,3,7,7,4,0,21,17,4
12918,E02004854,2009,90,189000,191000,5,19,32,34,10,80,55,35
12919,E02004854,2010,120,202000,206000,6,36,39,39,17,103,79,41
12920,E02004854,2011,93,213000,220000,3,27,41,22,2,91,71,22
12921,E02004854,2012,87,211000,215000,3,25,35,24,1,86,63,24
12922,E02004854,2013,98,217000,225000,8,25,36,29,0,98,69,29
12923,E02004854,2014,45,220000,230000,1,10,16,18,0,45,27,18
12924,E02004855,2009,67,155000,156000,2,5,16,44,16,51,22,45
12925,E02004855,2010,68,180000,178000,1,8,32,27,6,62,40,28
12926,E02004855,2011,79,167000,171000,0,6,28,45,23,56,33,46
12927,E02004855,2012,67,182000,185000,1,6,34,26,0,67,41,26
12928,E02004855,2013,78,190000,197000,0,8,43,27,0,78,51,27
12929,E02004855,2014,32,200000,215000,0,0,20,12,0,32,20,12
12930,E02004856,2009,63,260000,230000,11,19,30,3,0,63,60,3
12931,E02004856,2010,94,298000,236000,18,26,42,8,1,93,87,7
12932,E02004856,2011,68,339000,254000,17,16,28,7,0,68,61,7
12933,E02004856,2012,83,356000,250000,17,23,34,9,3,80,74,9
12934,E02004856,2013,92,332000,266000,13,27,44,8,6,86,84,8
12935,E02004856,2014,33,460000,340000,12,8,11,2,2,31,31,2
12936,E02004857,2009,84,286000,228000,15,18,36,15,1,83,67,17
12937,E02004857,2010,110,310000,290000,24,27,48,11,0,110,99,11
12938,E02004857,2011,84,279000,249000,11,22,35,16,0,84,67,17
12939,E02004857,2012,97,342000,318000,18,27,42,10,9,88,86,11
12940,E02004857,2013,117,346000,315000,28,23,50,16,5,112,99,18
12941,E02004857,2014,52,353000,319000,10,7,21,14,6,46,39,13
12942,E02004858,2009,57,278000,245000,16,15,25,1,0,57,55,2
12943,E02004858,2010,70,317000,269000,23,21,24,2,0,70,67,3
12944,E02004858,2011,68,267000,242000,11,21,34,2,0,68,66,2
12945,E02004858,2012,73,254000,225000,9,17,42,5,0,73,68,5
12946,E02004858,2013,90,314000,268000,24,22,41,3,0,90,85,5
12947,E02004858,2014,38,301000,250000,7,13,17,1,0,38,37,1
12948,E02004859,2009,63,447000,345000,28,13,17,5,0,63,55,8
12949,E02004859,2010,73,412000,375000,29,22,15,7,0,73,64,9
12950,E02004859,2011,76,391000,293000,28,11,27,10,3,73,63,13
12951,E02004859,2012,77,426000,400000,35,16,19,7,2,75,67,10
12952,E02004859,2013,78,534000,434000,35,15,22,6,3,75,72,6
12953,E02004859,2014,24,466000,470000,13,3,7,1,0,24,22,2
12954,E02004860,2009,87,160000,167000,5,14,26,42,0,87,44,43
12955,E02004860,2010,64,164000,153000,3,14,15,32,0,64,32,32
12956,E02004860,2011,60,167000,184000,4,11,18,27,0,60,33,27
12957,E02004860,2012,78,176000,178000,11,9,23,35,0,78,43,35
12958,E02004860,2013,96,208000,204000,10,23,21,42,21,75,54,42
12959,E02004860,2014,37,210000,210000,3,5,13,16,3,34,21,16
12960,E02004861,2009,71,459000,300000,31,13,22,5,2,69,66,5
12961,E02004861,2010,114,559000,390000,54,31,22,7,3,111,106,8
12962,E02004861,2011,87,530000,385000,37,13,31,6,4,83,81,6
12963,E02004861,2012,83,627000,485000,42,17,20,4,2,81,79,4
12964,E02004861,2013,97,502000,333000,35,26,22,14,0,97,81,16
12965,E02004861,2014,32,437000,406000,14,6,8,4,0,32,28,4
12966,E02004862,2009,72,157000,160000,2,10,44,16,0,72,58,14
12967,E02004862,2010,63,161000,170000,1,8,41,13,0,63,49,14
12968,E02004862,2011,61,177000,177000,3,8,41,9,1,60,52,9
12969,E02004862,2012,79,172000,178000,2,6,55,16,4,75,64,15
12970,E02004862,2013,84,194000,190000,6,8,59,11,10,74,74,10
12971,E02004862,2014,26,181000,193000,0,0,18,8,0,26,18,8
12972,E02004863,2009,59,158000,160000,2,5,33,19,1,58,40,19
12973,E02004863,2010,68,161000,165000,4,6,33,25,7,61,43,25
12974,E02004863,2011,53,186000,178000,2,14,25,12,3,50,41,12
12975,E02004863,2012,62,183000,180000,5,11,33,13,2,60,48,14
12976,E02004863,2013,77,181000,186000,2,12,40,23,0,77,54,23
12977,E02004863,2014,33,201000,190000,2,4,14,13,0,33,21,12
12978,E02004864,2009,118,392000,303000,29,28,36,25,0,118,89,29
12979,E02004864,2010,143,375000,295000,30,27,41,45,1,142,95,48
12980,E02004864,2011,155,397000,290000,30,29,50,46,21,134,106,49
12981,E02004864,2012,141,430000,365000,33,25,47,36,13,128,101,40
12982,E02004864,2013,140,424000,338000,32,21,53,34,6,134,106,34
12983,E02004864,2014,56,411000,389000,6,11,24,15,0,56,40,16
12984,E02004865,2009,71,218000,193000,8,14,36,13,0,71,57,14
12985,E02004865,2010,75,226000,209000,10,12,38,15,0,75,60,15
12986,E02004865,2011,63,213000,200000,5,11,31,16,0,63,48,15
12987,E02004865,2012,57,219000,198000,6,6,34,11,0,57,46,11
12988,E02004865,2013,102,237000,220000,10,17,54,21,7,95,80,22
12989,E02004865,2014,29,236000,220000,2,4,13,10,3,26,19,10
12990,E02004866,2009,73,214000,184000,12,11,46,4,1,72,70,3
12991,E02004866,2010,59,243000,206000,15,8,27,9,0,59,51,8
12992,E02004866,2011,72,219000,195000,9,14,43,6,0,72,65,7
12993,E02004866,2012,69,221000,202000,7,12,45,5,0,69,65,4
12994,E02004866,2013,89,242000,217000,15,14,52,8,1,88,80,9
12995,E02004866,2014,22,257000,227000,4,2,14,2,0,22,20,2
12996,E02004867,2009,137,418000,350000,34,33,43,27,49,88,110,27
12997,E02004867,2010,94,441000,330000,28,25,14,27,14,80,67,27
12998,E02004867,2011,97,509000,440000,28,31,18,20,2,95,77,20
12999,E02004867,2012,105,481000,433000,32,31,22,20,6,99,82,23
13000,E02004867,2013,98,486000,400000,34,25,12,27,5,93,71,27
13001,E02004867,2014,37,529000,470000,15,8,5,9,2,35,28,9
13002,E02004868,2009,40,202000,192000,5,10,17,8,1,39,31,9
13003,E02004868,2010,69,218000,211000,7,23,20,19,0,69,48,21
13004,E02004868,2011,56,245000,222000,12,16,18,10,0,56,46,10
13005,E02004868,2012,54,240000,230000,6,22,17,9,1,53,45,9
13006,E02004868,2013,77,258000,240000,14,26,28,9,0,77,68,9
13007,E02004868,2014,23,294000,280000,3,10,8,2,0,23,21,2
13008,E02004869,2009,98,366000,318000,19,25,34,20,1,97,78,20
13009,E02004869,2010,107,422000,375000,24,24,33,26,2,105,81,26
13010,E02004869,2011,90,432000,366000,24,13,31,22,0,90,68,22
13011,E02004869,2012,98,419000,340000,19,18,41,20,1,97,78,20
13012,E02004869,2013,138,447000,395000,29,28,43,38,11,127,100,38
13013,E02004869,2014,33,529000,490000,6,6,17,4,0,33,29,4
13014,E02004870,2009,122,212000,192000,15,28,33,46,28,94,75,47
13015,E02004870,2010,183,221000,213000,10,44,44,85,56,127,98,85
13016,E02004870,2011,252,201000,186000,10,31,41,170,130,122,81,171
13017,E02004870,2012,211,213000,195000,12,28,50,121,40,171,89,122
13018,E02004870,2013,260,208000,195000,15,21,58,166,72,188,94,166
13019,E02004870,2014,70,208000,202000,3,5,22,40,0,70,30,40
13020,E02004871,2009,40,187000,174000,1,10,22,7,0,40,32,8
13021,E02004871,2010,54,232000,210000,5,13,31,5,0,54,48,6
13022,E02004871,2011,59,236000,220000,5,20,26,8,0,59,50,9
13023,E02004871,2012,58,232000,214000,6,12,31,9,0,58,49,9
13024,E02004871,2013,65,242000,225000,9,12,35,9,0,65,56,9
13025,E02004871,2014,26,257000,232000,4,3,16,3,0,26,24,2
13026,E02004872,2009,58,250000,212000,18,10,20,10,2,56,48,10
13027,E02004872,2010,78,329000,288000,29,17,17,15,8,70,63,15
13028,E02004872,2011,76,306000,238000,24,16,25,11,3,73,65,11
13029,E02004872,2012,98,302000,270000,31,27,29,11,2,96,87,11
13030,E02004872,2013,128,309000,272000,39,25,45,19,26,102,109,19
13031,E02004872,2014,40,311000,328000,17,6,9,8,7,33,33,7
13032,E02004873,2009,179,249000,232000,26,49,46,58,10,169,121,58
13033,E02004873,2010,201,275000,250000,34,46,52,69,17,184,130,71
13034,E02004873,2011,206,257000,232000,29,38,59,80,34,172,124,82
13035,E02004873,2012,197,265000,235000,32,32,55,78,11,186,118,79
13036,E02004873,2013,236,295000,264000,41,42,80,73,25,211,163,73
13037,E02004873,2014,80,315000,262000,13,18,23,26,2,78,53,27
13038,E02004874,2009,60,211000,216000,10,28,14,8,0,60,52,8
13039,E02004874,2010,63,223000,215000,12,24,17,10,1,62,52,11
13040,E02004874,2011,66,218000,215000,12,19,22,13,0,66,52,14
13041,E02004874,2012,85,229000,218000,16,29,35,5,0,85,80,5
13042,E02004874,2013,78,232000,227000,17,24,22,15,2,76,63,15
13043,E02004874,2014,27,261000,250000,9,7,6,5,0,27,22,5
13044,E02004875,2009,89,219000,185000,11,32,32,14,1,88,75,14
13045,E02004875,2010,99,240000,225000,15,35,36,13,0,99,85,14
13046,E02004875,2011,104,263000,234000,11,24,53,16,23,81,87,17
13047,E02004875,2012,124,284000,277000,13,27,75,9,42,82,112,12
13048,E02004875,2013,152,263000,235000,20,31,60,41,27,125,109,43
13049,E02004875,2014,30,289000,242000,4,7,12,7,1,29,23,7
13050,E02004876,2009,100,479000,346000,41,22,28,9,1,99,90,10
13051,E02004876,2010,115,556000,428000,56,25,18,16,0,115,99,16
13052,E02004876,2011,118,471000,344000,45,35,24,14,1,117,105,13
13053,E02004876,2012,108,529000,400000,56,26,16,10,3,105,97,11
13054,E02004876,2013,102,501000,385000,49,13,27,13,5,97,88,14
13055,E02004876,2014,40,558000,510000,19,10,8,3,0,40,37,3
13056,E02004877,2009,61,372000,310000,28,16,9,8,4,57,54,7
13057,E02004877,2010,67,350000,317000,20,26,5,16,2,65,51,16
13058,E02004877,2011,82,374000,332000,28,27,17,10,4,78,71,11
13059,E02004877,2012,56,370000,310000,21,11,12,12,0,56,43,13
13060,E02004877,2013,100,390000,338000,36,31,18,15,1,99,84,16
13061,E02004877,2014,37,478000,478000,19,8,5,5,0,37,31,6
13062,E02004878,2009,65,268000,238000,18,16,24,7,4,61,58,7
13063,E02004878,2010,102,296000,262000,25,32,39,6,9,93,97,5
13064,E02004878,2011,102,348000,299000,39,29,28,6,19,83,97,5
13065,E02004878,2012,107,315000,261000,30,21,54,2,37,70,105,2
13066,E02004878,2013,148,336000,304000,48,36,62,2,48,100,146,2
13067,E02004878,2014,51,392000,340000,24,8,18,1,4,47,50,1
13068,E02004879,2009,68,361000,297000,21,17,24,6,4,64,62,6
13069,E02004879,2010,94,412000,360000,47,26,17,4,7,87,88,6
13070,E02004879,2011,72,436000,354000,32,19,17,4,6,66,68,4
13071,E02004879,2012,75,458000,365000,39,15,18,3,2,73,71,4
13072,E02004879,2013,90,483000,424000,51,13,18,8,1,89,80,10
13073,E02004879,2014,36,417000,312000,14,9,10,3,0,36,33,3
13074,E02004880,2009,129,355000,300000,62,27,30,10,10,119,114,15
13075,E02004880,2010,142,378000,342000,70,28,25,19,1,141,123,19
13076,E02004880,2011,152,347000,298000,65,30,37,20,1,151,130,22
13077,E02004880,2012,139,435000,371000,75,26,24,14,12,127,123,16
13078,E02004880,2013,146,409000,366000,74,22,38,12,17,129,132,14
13079,E02004880,2014,36,489000,390000,21,6,8,1,3,33,34,2
13080,E02004881,2009,196,229000,195000,29,34,16,117,71,125,79,117
13081,E02004881,2010,124,252000,196000,26,28,20,50,22,102,76,48
13082,E02004881,2011,104,294000,246000,28,17,21,38,6,98,65,39
13083,E02004881,2012,100,280000,241000,16,25,26,33,4,96,68,32
13084,E02004881,2013,147,278000,245000,31,30,44,42,10,137,105,42
13085,E02004881,2014,48,309000,291000,14,9,10,15,2,46,33,15
13086,E02004882,2009,93,273000,230000,16,39,26,12,7,86,80,13
13087,E02004882,2010,88,338000,271000,32,26,25,5,0,88,83,5
13088,E02004882,2011,78,304000,242000,15,29,20,14,1,77,64,14
13089,E02004882,2012,126,277000,226000,26,26,17,57,39,87,69,57
13090,E02004882,2013,148,288000,246000,23,43,34,48,31,117,100,48
13091,E02004882,2014,31,293000,270000,5,11,5,10,0,31,21,10
13092,E02004883,2009,65,329000,248000,16,25,15,9,0,65,54,11
13093,E02004883,2010,70,370000,294000,23,17,22,8,0,70,60,10
13094,E02004883,2011,65,338000,250000,23,14,20,8,0,65,56,9
13095,E02004883,2012,74,299000,275000,16,19,26,13,2,72,60,14
13096,E02004883,2013,75,334000,250000,14,18,32,11,0,75,63,12
13097,E02004883,2014,34,406000,285000,7,11,9,7,0,34,27,7
13098,E02004884,2009,162,201000,180000,20,49,42,51,27,135,111,51
13099,E02004884,2010,145,226000,215000,26,42,51,26,3,142,117,28
13100,E02004884,2011,136,247000,226000,36,36,45,19,0,136,117,19
13101,E02004884,2012,130,229000,214000,26,35,46,23,0,130,107,23
13102,E02004884,2013,215,238000,225000,43,53,81,38,15,200,177,38
13103,E02004884,2014,60,238000,240000,8,13,22,17,1,59,42,18
13104,E02004885,2009,105,272000,248000,43,24,29,9,4,101,97,8
13105,E02004885,2010,134,329000,275000,65,33,29,7,0,134,125,9
13106,E02004885,2011,117,335000,285000,54,26,28,9,0,117,107,10
13107,E02004885,2012,127,313000,273000,53,40,26,8,0,127,119,8
13108,E02004885,2013,115,298000,270000,44,29,28,14,0,115,101,14
13109,E02004885,2014,42,337000,340000,24,7,6,5,0,42,37,5
13110,E02004886,2009,63,436000,295000,22,24,15,2,3,60,62,1
13111,E02004886,2010,55,525000,412000,29,12,14,0,1,54,54,1
13112,E02004886,2011,58,433000,351000,17,22,17,2,2,56,56,2
13113,E02004886,2012,59,515000,400000,26,18,15,0,3,56,59,0
13114,E02004886,2013,63,504000,395000,24,18,20,1,9,54,62,1
13115,E02004886,2014,26,529000,442000,9,6,9,2,0,26,24,2
13116,E02004887,2009,68,460000,355000,25,16,16,11,0,68,55,13
13117,E02004887,2010,73,473000,320000,27,15,17,14,0,73,58,15
13118,E02004887,2011,79,508000,388000,33,21,22,3,2,77,75,4
13119,E02004887,2012,74,421000,340000,26,13,28,7,7,67,65,9
13120,E02004887,2013,126,458000,384000,46,32,34,14,35,91,112,14
13121,E02004887,2014,33,662000,385000,10,5,13,5,9,24,29,4
13122,E02004888,2009,103,271000,245000,29,29,20,25,3,100,79,24
13123,E02004888,2010,147,333000,280000,44,48,32,23,7,140,122,25
13124,E02004888,2011,120,328000,280000,36,32,29,23,14,106,97,23
13125,E02004888,2012,157,292000,269000,46,47,44,20,15,142,138,19
13126,E02004888,2013,162,325000,302000,54,47,36,25,24,138,134,28
13127,E02004888,2014,54,301000,272000,14,10,14,16,5,49,37,17
13128,E02004889,2009,143,217000,214000,5,50,44,44,4,139,99,44
13129,E02004889,2010,147,258000,231000,12,47,42,46,0,147,99,48
13130,E02004889,2011,144,249000,236000,16,43,45,40,1,143,104,40
13131,E02004889,2012,183,253000,235000,15,46,60,62,30,153,113,70
13132,E02004889,2013,246,271000,264000,13,79,86,68,46,200,169,77
13133,E02004889,2014,58,258000,246000,4,14,19,21,1,57,36,22
13134,E02004890,2009,132,238000,210000,24,24,32,52,14,118,76,56
13135,E02004890,2010,162,240000,220000,19,23,46,74,24,138,85,77
13136,E02004890,2011,138,244000,216000,16,23,34,65,21,117,73,65
13137,E02004890,2012,140,240000,216000,15,29,41,55,0,140,85,55
13138,E02004890,2013,166,243000,226000,12,30,47,77,0,166,88,78
13139,E02004890,2014,63,291000,245000,14,9,15,25,0,63,37,26
13140,E02004891,2009,127,340000,260000,20,35,52,20,8,119,106,21
13141,E02004891,2010,125,330000,280000,22,34,50,19,1,124,107,18
13142,E02004891,2011,151,344000,280000,25,32,74,20,4,147,132,19
13143,E02004891,2012,197,332000,302000,25,57,87,28,56,141,167,30
13144,E02004891,2013,148,365000,306000,24,30,63,31,6,142,114,34
13145,E02004891,2014,48,378000,288000,6,11,19,12,1,47,36,12
13146,E02004892,2009,71,279000,195000,6,15,35,15,1,70,53,18
13147,E02004892,2010,74,270000,223000,9,24,29,12,0,74,59,15
13148,E02004892,2011,71,279000,228000,6,26,32,7,1,70,59,12
13149,E02004892,2012,65,310000,220000,9,15,28,13,0,65,52,13
13150,E02004892,2013,73,276000,230000,6,9,43,15,0,73,57,16
13151,E02004892,2014,25,273000,240000,6,4,8,7,0,25,17,8
13152,E02004893,2009,83,250000,232000,16,24,34,9,0,83,75,8
13153,E02004893,2010,103,266000,230000,17,31,46,9,0,103,94,9
13154,E02004893,2011,95,282000,240000,23,19,41,12,0,95,82,13
13155,E02004893,2012,103,273000,240000,17,25,50,11,0,103,90,13
13156,E02004893,2013,126,304000,272000,22,35,50,19,12,114,105,21
13157,E02004893,2014,40,344000,312000,8,8,16,8,6,34,31,9
13158,E02004894,2009,152,279000,228000,11,21,57,63,40,112,86,66
13159,E02004894,2010,242,270000,228000,25,27,60,130,69,173,110,132
13160,E02004894,2011,200,304000,250000,22,19,49,110,46,154,89,111
13161,E02004894,2012,190,318000,248000,15,16,67,92,33,157,95,95
13162,E02004894,2013,214,318000,248000,28,23,62,101,12,202,108,106
13163,E02004894,2014,91,383000,281000,13,9,23,46,4,87,45,46
13164,E02004895,2009,150,278000,210000,24,29,43,54,35,115,93,57
13165,E02004895,2010,115,338000,310000,40,27,35,13,9,106,100,15
13166,E02004895,2011,105,320000,275000,28,25,37,15,1,104,87,18
13167,E02004895,2012,88,328000,250000,25,21,22,20,0,88,67,21
13168,E02004895,2013,157,357000,288000,38,29,55,35,0,157,121,36
13169,E02004895,2014,38,354000,295000,6,13,10,9,0,38,29,9
13170,E02004896,2009,101,330000,308000,37,23,14,27,6,95,74,27
13171,E02004896,2010,107,331000,300000,26,35,20,26,0,107,77,30
13172,E02004896,2011,85,350000,335000,24,30,6,25,0,85,60,25
13173,E02004896,2012,109,367000,330000,27,45,13,24,0,109,83,26
13174,E02004896,2013,129,369000,320000,39,41,12,37,0,129,90,39
13175,E02004896,2014,72,440000,415000,24,20,5,23,12,60,48,24
13176,E02004897,2009,72,287000,288000,8,48,6,10,0,72,61,11
13177,E02004897,2010,83,309000,302000,8,53,4,18,0,83,64,19
13178,E02004897,2011,83,306000,312000,9,56,4,14,0,83,69,14
13179,E02004897,2012,77,301000,310000,5,45,3,24,5,72,53,24
13180,E02004897,2013,92,342000,350000,12,60,4,16,0,92,76,16
13181,E02004897,2014,36,342000,350000,3,22,3,8,0,36,28,8
13182,E02004898,2009,64,217000,220000,3,27,14,20,0,64,44,20
13183,E02004898,2010,88,274000,250000,7,37,25,19,0,88,67,21
13184,E02004898,2011,59,259000,247000,5,24,16,14,3,56,45,14
13185,E02004898,2012,73,281000,275000,3,37,11,22,0,73,51,22
13186,E02004898,2013,82,290000,279000,5,41,13,23,0,82,59,23
13187,E02004898,2014,35,298000,300000,4,12,9,10,0,35,24,11
13188,E02004899,2009,61,357000,290000,24,15,16,6,0,61,53,8
13189,E02004899,2010,83,428000,330000,33,22,24,4,0,83,76,7
13190,E02004899,2011,64,415000,347000,20,20,19,5,2,62,57,7
13191,E02004899,2012,86,389000,354000,30,20,31,5,2,84,80,6
13192,E02004899,2013,88,447000,401000,22,28,25,13,11,77,76,12
13193,E02004899,2014,24,496000,477000,6,5,12,1,1,23,23,1
13194,E02004900,2009,96,702000,560000,60,14,7,15,1,95,79,17
13195,E02004900,2010,133,802000,655000,81,22,11,19,1,132,112,21
13196,E02004900,2011,109,709000,530000,46,25,12,26,4,105,83,26
13197,E02004900,2012,101,771000,520000,46,18,11,26,0,101,75,26
13198,E02004900,2013,126,798000,650000,61,16,10,39,15,111,87,39
13199,E02004900,2014,46,878000,665000,26,6,4,10,1,45,36,10
13200,E02004901,2009,45,220000,220000,2,16,14,13,0,45,32,13
13201,E02004901,2010,72,227000,236000,0,32,24,16,0,72,55,17
13202,E02004901,2011,96,231000,199000,2,30,14,50,37,59,45,51
13203,E02004901,2012,126,247000,226000,2,26,43,55,57,69,69,57
13204,E02004901,2013,97,266000,250000,5,27,44,21,9,88,75,22
13205,E02004901,2014,34,280000,262000,1,9,17,7,0,34,27,7
13206,E02004902,2009,86,238000,225000,8,18,46,14,2,84,72,14
13207,E02004902,2010,93,239000,221000,3,15,45,30,1,92,62,31
13208,E02004902,2011,80,258000,237000,5,15,45,15,0,80,64,16
13209,E02004902,2012,76,245000,232000,3,10,48,15,1,75,61,15
13210,E02004902,2013,98,293000,260000,11,20,48,19,0,98,79,19
13211,E02004902,2014,36,272000,266000,0,4,19,13,0,36,23,13
13212,E02004903,2009,54,241000,230000,6,25,13,10,0,54,44,10
13213,E02004903,2010,76,265000,222000,6,21,16,33,18,58,43,33
13214,E02004903,2011,96,273000,236000,10,17,28,41,37,59,55,41
13215,E02004903,2012,75,296000,285000,8,35,10,22,14,61,53,22
13216,E02004903,2013,152,346000,317000,32,42,51,27,63,89,124,28
13217,E02004903,2014,30,338000,332000,5,10,7,8,2,28,22,8
13218,E02004904,2009,56,205000,205000,3,8,35,10,0,56,45,11
13219,E02004904,2010,68,230000,217000,4,12,34,18,0,68,49,19
13220,E02004904,2011,78,230000,229000,9,14,32,23,0,78,56,22
13221,E02004904,2012,79,262000,245000,5,19,42,13,5,74,66,13
13222,E02004904,2013,96,255000,244000,4,20,57,15,0,96,82,14
13223,E02004904,2014,30,261000,250000,1,6,15,8,0,30,22,8
13224,E02004905,2009,87,555000,410000,24,17,14,32,13,74,54,33
13225,E02004905,2010,83,490000,375000,30,16,16,21,0,83,60,23
13226,E02004905,2011,81,584000,565000,32,9,14,26,0,81,54,27
13227,E02004905,2012,82,555000,408000,23,12,21,26,0,82,55,27
13228,E02004905,2013,152,509000,300000,27,10,27,88,50,102,64,88
13229,E02004905,2014,31,498000,415000,8,6,11,6,0,31,25,6
13230,E02004906,2009,152,210000,193000,2,28,29,93,85,67,58,94
13231,E02004906,2010,126,280000,250000,7,50,42,27,4,122,99,27
13232,E02004906,2011,106,270000,250000,8,37,37,24,0,106,81,25
13233,E02004906,2012,142,289000,250000,4,46,48,44,19,123,98,44
13234,E02004906,2013,131,291000,283000,5,51,48,27,0,131,102,29
13235,E02004906,2014,61,308000,293000,1,16,22,22,1,60,39,22
13236,E02004907,2009,151,308000,280000,25,44,43,39,12,139,109,42
13237,E02004907,2010,145,367000,322000,34,32,37,42,15,130,104,41
13238,E02004907,2011,138,347000,302000,23,25,41,49,22,116,87,51
13239,E02004907,2012,155,346000,320000,32,24,45,54,28,127,99,56
13240,E02004907,2013,166,394000,325000,25,39,46,56,26,140,109,57
13241,E02004907,2014,78,384000,348000,11,13,15,39,22,56,39,39
13242,E02004908,2009,127,360000,265000,32,28,16,51,13,114,78,49
13243,E02004908,2010,135,405000,350000,41,35,23,36,0,135,98,37
13244,E02004908,2011,139,375000,315000,33,25,25,56,7,132,84,55
13245,E02004908,2012,107,418000,350000,30,26,22,29,5,102,77,30
13246,E02004908,2013,145,423000,352000,40,30,22,53,2,143,90,55
13247,E02004908,2014,51,492000,430000,12,12,14,13,1,50,38,13
13248,E02004909,2009,72,178000,168000,9,17,29,17,2,70,55,17
13249,E02004909,2010,66,191000,175000,15,13,23,15,1,65,50,16
13250,E02004909,2011,64,193000,173000,14,12,23,15,0,64,49,15
13251,E02004909,2012,106,211000,202000,18,19,40,29,23,83,76,30
13252,E02004909,2013,116,204000,190000,15,26,39,36,9,107,80,36
13253,E02004909,2014,32,220000,195000,4,5,15,8,0,32,24,8
13254,E02004910,2009,160,221000,190000,37,53,48,22,14,146,137,23
13255,E02004910,2010,157,249000,218000,51,44,47,15,0,157,141,16
13256,E02004910,2011,175,237000,207000,52,49,41,33,0,175,140,35
13257,E02004910,2012,201,263000,222000,54,48,54,45,30,171,156,45
13258,E02004910,2013,254,275000,220000,82,53,85,34,30,224,217,37
13259,E02004910,2014,98,302000,237000,35,19,20,24,16,82,74,24
13260,E02004911,2009,87,189000,166000,7,20,44,16,21,66,69,18
13261,E02004911,2010,59,177000,170000,2,14,37,6,6,53,51,8
13262,E02004911,2011,77,189000,175000,5,25,39,8,0,77,66,11
13263,E02004911,2012,71,200000,180000,7,18,32,14,0,71,57,14
13264,E02004911,2013,74,187000,178000,2,20,39,13,0,74,59,15
13265,E02004911,2014,30,170000,176000,0,5,16,9,1,29,19,11
13266,E02004912,2009,130,203000,175000,15,33,46,36,10,120,92,38
13267,E02004912,2010,143,225000,190000,24,56,40,23,19,124,116,27
13268,E02004912,2011,174,205000,179000,13,44,62,55,36,138,119,55
13269,E02004912,2012,163,235000,217000,26,55,59,23,18,145,138,25
13270,E02004912,2013,188,226000,200000,27,47,75,39,21,167,145,43
13271,E02004912,2014,53,238000,232000,9,17,15,12,1,52,37,16
13272,E02004913,2009,266,266000,225000,80,62,98,26,74,192,238,28
13273,E02004913,2010,240,317000,248000,83,74,62,21,27,213,218,22
13274,E02004913,2011,192,323000,250000,72,43,66,11,1,191,181,11
13275,E02004913,2012,187,337000,261000,61,44,70,12,2,185,174,13
13276,E02004913,2013,239,331000,248000,76,62,82,19,8,231,217,22
13277,E02004913,2014,83,317000,290000,25,22,24,12,2,81,72,11
13278,E02004914,2009,121,216000,195000,20,30,50,21,25,96,51,70
13279,E02004914,2010,126,217000,182000,10,34,42,40,62,64,33,93
13280,E02004914,2011,106,231000,235000,14,22,46,24,31,75,47,59
13281,E02004914,2012,138,218000,192000,16,23,57,42,48,90,47,91
13282,E02004914,2013,131,228000,216000,17,25,48,41,42,89,42,89
13283,E02004914,2014,47,242000,223000,8,7,20,12,0,47,20,27
13284,E02004915,2009,48,167000,161000,1,11,25,11,0,48,18,30
13285,E02004915,2010,78,188000,178000,10,21,29,18,9,69,33,45
13286,E02004915,2011,99,192000,178000,10,17,42,30,41,58,22,77
13287,E02004915,2012,75,202000,195000,7,21,32,15,22,53,21,54
13288,E02004915,2013,87,178000,170000,3,30,30,24,0,87,40,47
13289,E02004915,2014,27,176000,172000,2,4,11,10,0,27,8,19
13290,E02004916,2009,82,280000,244000,27,19,15,21,0,82,46,36
13291,E02004916,2010,85,365000,340000,43,18,14,10,0,85,58,27
13292,E02004916,2011,88,342000,308000,32,30,8,18,1,87,55,33
13293,E02004916,2012,79,356000,315000,35,18,10,16,1,78,47,32
13294,E02004916,2013,131,324000,240000,45,17,17,52,23,108,60,71
13295,E02004916,2014,28,434000,338000,11,10,2,5,0,28,16,12
13296,E02004917,2009,73,214000,197000,25,8,32,8,0,73,44,29
13297,E02004917,2010,61,219000,175000,19,4,27,11,1,60,32,29
13298,E02004917,2011,49,202000,175000,11,2,32,4,0,49,34,15
13299,E02004917,2012,58,213000,179000,19,2,28,9,0,58,31,27
13300,E02004917,2013,61,256000,173000,18,6,29,8,0,61,37,24
13301,E02004917,2014,17,212000,170000,3,2,9,3,0,17,10,7
13302,E02004918,2009,159,195000,175000,8,36,50,65,33,126,94,65
13303,E02004918,2010,183,224000,218000,12,43,53,75,42,141,108,75
13304,E02004918,2011,130,220000,210000,7,28,39,56,21,109,74,56
13305,E02004918,2012,155,238000,225000,10,40,55,50,13,142,103,52
13306,E02004918,2013,167,235000,220000,8,36,59,64,10,157,100,67
13307,E02004918,2014,53,238000,215000,2,6,19,26,1,52,27,26
13308,E02004919,2009,91,202000,185000,13,36,36,6,0,91,86,5
13309,E02004919,2010,84,225000,218000,6,42,34,2,0,84,81,3
13310,E02004919,2011,79,225000,210000,9,39,27,4,1,78,74,5
13311,E02004919,2012,94,221000,220000,12,49,25,8,0,94,85,9
13312,E02004919,2013,104,241000,232000,11,41,46,6,4,100,96,8
13313,E02004919,2014,36,268000,246000,2,22,9,3,1,35,32,4
13314,E02004920,2009,199,231000,196000,41,31,29,98,62,137,100,99
13315,E02004920,2010,150,259000,215000,34,35,33,48,18,132,100,50
13316,E02004920,2011,186,258000,214000,30,44,28,84,45,141,95,91
13317,E02004920,2012,152,279000,219000,39,28,29,56,20,132,91,61
13318,E02004920,2013,201,290000,249000,42,60,49,50,6,195,151,50
13319,E02004920,2014,74,284000,254000,16,13,17,28,8,66,45,29
13320,E02004921,2009,130,250000,230000,30,31,38,31,13,117,98,32
13321,E02004921,2010,120,296000,247000,25,36,26,33,12,108,86,34
13322,E02004921,2011,142,278000,250000,24,65,29,24,3,139,118,24
13323,E02004921,2012,117,289000,247000,20,39,24,34,3,114,83,34
13324,E02004921,2013,174,297000,250000,27,54,31,62,29,145,112,62
13325,E02004921,2014,43,378000,300000,10,14,7,12,0,43,32,11
13326,E02004922,2009,80,307000,268000,34,27,17,2,4,76,77,3
13327,E02004922,2010,101,384000,304000,46,21,29,5,3,98,95,6
13328,E02004922,2011,99,377000,300000,39,28,26,6,0,99,93,6
13329,E02004922,2012,80,389000,327000,39,23,17,1,1,79,79,1
13330,E02004922,2013,117,401000,290000,45,29,34,9,5,112,106,11
13331,E02004922,2014,35,389000,385000,17,10,5,3,3,32,31,4
13332,E02004923,2009,136,319000,260000,43,38,40,15,4,132,120,16
13333,E02004923,2010,146,357000,280000,51,34,43,18,3,143,125,21
13334,E02004923,2011,158,381000,275000,52,46,45,15,4,154,144,14
13335,E02004923,2012,146,358000,295000,41,38,44,23,8,138,123,23
13336,E02004923,2013,152,360000,285000,47,43,41,21,2,150,131,21
13337,E02004923,2014,54,447000,325000,23,11,15,5,0,54,48,6
13338,E02004924,2009,130,461000,409000,49,46,17,18,2,128,111,19
13339,E02004924,2010,125,481000,460000,45,47,22,11,0,125,114,11
13340,E02004924,2011,117,498000,495000,44,36,19,18,0,117,99,18
13341,E02004924,2012,127,530000,500000,54,37,19,17,3,124,110,17
13342,E02004924,2013,129,553000,510000,50,28,27,24,10,119,105,24
13343,E02004924,2014,44,578000,520000,13,15,8,8,6,38,36,8
13344,E02004925,2009,109,394000,325000,36,37,22,14,3,106,95,14
13345,E02004925,2010,140,493000,382000,44,47,25,24,3,137,115,25
13346,E02004925,2011,125,488000,366000,28,46,36,15,2,123,108,17
13347,E02004925,2012,105,495000,394000,28,42,23,12,1,104,93,12
13348,E02004925,2013,127,524000,445000,33,44,28,22,5,122,104,23
13349,E02004925,2014,46,506000,435000,13,11,16,6,3,43,39,7
13350,E02004926,2009,130,669000,500000,45,38,11,36,4,126,94,36
13351,E02004926,2010,171,589000,535000,53,49,20,49,4,167,119,52
13352,E02004926,2011,126,656000,552000,45,37,16,28,1,125,96,30
13353,E02004926,2012,144,694000,590000,36,30,15,63,24,120,78,66
13354,E02004926,2013,159,746000,620000,43,46,22,48,6,153,111,48
13355,E02004926,2014,61,811000,670000,20,15,6,20,9,52,41,20
13356,E02004927,2009,83,398000,355000,40,21,9,13,7,76,70,13
13357,E02004927,2010,111,465000,405000,45,29,24,13,5,106,95,16
13358,E02004927,2011,103,473000,425000,46,26,21,10,21,82,94,9
13359,E02004927,2012,87,393000,355000,26,32,18,11,13,74,76,11
13360,E02004927,2013,102,440000,376000,31,30,30,11,4,98,92,10
13361,E02004927,2014,27,573000,550000,13,11,2,1,0,27,26,1
13362,E02004928,2009,96,526000,375000,45,25,20,6,1,95,89,7
13363,E02004928,2010,128,634000,436000,64,41,17,6,3,125,120,8
13364,E02004928,2011,106,636000,386000,45,25,27,9,0,106,97,9
13365,E02004928,2012,109,653000,413000,42,36,23,8,5,104,102,7
13366,E02004928,2013,116,680000,450000,47,29,27,13,4,112,102,14
13367,E02004928,2014,36,704000,546000,18,6,5,7,0,36,29,7
13368,E02004929,2009,88,371000,307000,32,26,20,10,7,81,79,9
13369,E02004929,2010,105,401000,365000,43,18,28,16,2,103,90,15
13370,E02004929,2011,99,425000,340000,33,32,20,14,2,97,85,14
13371,E02004929,2012,78,410000,322000,19,15,35,9,1,77,68,10
13372,E02004929,2013,110,492000,392000,39,29,29,13,1,109,98,12
13373,E02004929,2014,24,555000,365000,7,4,9,4,2,22,20,4
13374,E02004930,2009,98,300000,234000,25,27,29,17,1,97,81,17
13375,E02004930,2010,112,320000,250000,29,22,33,28,1,111,82,30
13376,E02004930,2011,105,341000,288000,33,21,37,14,0,105,87,18
13377,E02004930,2012,98,367000,264000,22,19,41,16,0,98,80,18
13378,E02004930,2013,148,362000,311000,31,42,54,21,3,145,125,23
13379,E02004930,2014,41,329000,250000,5,4,18,14,0,41,24,17
13380,E02004931,2009,89,312000,280000,6,45,11,27,0,89,62,27
13381,E02004931,2010,100,370000,365000,17,40,11,32,0,100,68,32
13382,E02004931,2011,82,354000,312000,6,40,14,22,0,82,58,24
13383,E02004931,2012,83,392000,360000,12,35,12,24,0,83,59,24
13384,E02004931,2013,100,391000,354000,12,49,8,31,1,99,68,32
13385,E02004931,2014,40,422000,377000,3,21,7,9,0,40,31,9
13386,E02004932,2009,103,364000,305000,15,38,42,8,7,96,94,9
13387,E02004932,2010,134,366000,340000,15,45,60,14,0,134,118,16
13388,E02004932,2011,108,370000,352000,9,35,55,9,0,108,100,8
13389,E02004932,2012,108,371000,341000,10,50,38,10,0,108,96,12
13390,E02004932,2013,126,399000,370000,16,42,57,11,2,124,113,13
13391,E02004932,2014,43,433000,380000,8,13,14,8,0,43,36,7
13392,E02004933,2009,93,445000,370000,24,24,35,10,9,84,84,9
13393,E02004933,2010,112,585000,422000,34,21,46,11,0,112,100,12
13394,E02004933,2011,109,552000,468000,38,26,39,6,0,109,103,6
13395,E02004933,2012,102,628000,534000,31,30,31,10,0,102,93,9
13396,E02004933,2013,106,608000,517000,39,25,29,13,0,106,94,12
13397,E02004933,2014,45,630000,535000,13,9,23,0,1,44,45,0
13398,E02004934,2009,136,319000,250000,13,20,33,70,12,124,67,69
13399,E02004934,2010,223,376000,280000,28,25,52,118,21,202,108,115
13400,E02004934,2011,231,344000,280000,15,23,40,153,18,213,78,153
13401,E02004934,2012,140,408000,329000,14,24,35,67,15,125,73,67
13402,E02004934,2013,171,445000,312000,33,17,38,83,10,161,90,81
13403,E02004934,2014,63,401000,300000,9,4,7,43,1,62,20,43
13404,E02004935,2009,165,310000,280000,8,36,65,56,9,156,110,55
13405,E02004935,2010,160,366000,318000,10,28,71,51,5,155,108,52
13406,E02004935,2011,239,334000,285000,12,33,65,129,56,183,109,130
13407,E02004935,2012,229,344000,289000,5,28,77,119,56,173,110,119
13408,E02004935,2013,406,331000,295000,14,31,96,265,160,246,141,265
13409,E02004935,2014,75,379000,344000,1,10,23,41,7,68,34,41
13410,E02004936,2009,88,293000,274000,13,32,27,16,2,86,72,16
13411,E02004936,2010,92,329000,322000,10,40,30,12,2,90,80,12
13412,E02004936,2011,121,325000,304000,9,43,43,26,16,105,96,25
13413,E02004936,2012,118,357000,350000,18,35,44,21,8,110,96,22
13414,E02004936,2013,130,354000,350000,11,41,44,34,14,116,95,35
13415,E02004936,2014,38,404000,394000,6,12,13,7,0,38,31,7
13416,E02004937,2009,96,390000,345000,21,13,48,14,12,84,83,13
13417,E02004937,2010,100,508000,462000,38,16,35,11,0,100,89,11
13418,E02004937,2011,119,472000,415000,37,20,48,14,2,117,103,16
13419,E02004937,2012,140,513000,478000,31,31,53,25,28,112,113,27
13420,E02004937,2013,204,557000,526000,50,41,77,36,76,128,162,42
13421,E02004937,2014,59,534000,478000,13,19,24,3,22,37,55,4
13422,E02004938,2009,80,336000,312000,31,27,16,6,0,80,74,6
13423,E02004938,2010,96,379000,348000,34,29,26,7,10,86,88,8
13424,E02004938,2011,84,388000,372000,34,28,12,10,13,71,74,10
13425,E02004938,2012,55,383000,401000,21,21,7,6,1,54,47,8
13426,E02004938,2013,79,380000,355000,23,29,12,15,0,79,64,15
13427,E02004938,2014,28,421000,388000,10,7,8,3,0,28,25,3
13428,E02004939,2009,62,316000,233000,10,13,22,17,0,62,41,21
13429,E02004939,2010,73,391000,305000,21,18,16,18,0,73,53,20
13430,E02004939,2011,67,370000,300000,13,20,20,14,0,67,53,14
13431,E02004939,2012,62,371000,293000,12,19,18,13,0,62,48,14
13432,E02004939,2013,93,360000,295000,14,27,29,23,2,91,68,25
13433,E02004939,2014,27,420000,356000,4,13,4,6,1,26,18,9
13434,E02004940,2009,90,272000,250000,5,30,34,21,0,90,67,23
13435,E02004940,2010,107,316000,282000,9,24,45,29,0,107,78,29
13436,E02004940,2011,91,326000,280000,6,29,32,24,0,91,67,24
13437,E02004940,2012,117,313000,308000,4,33,46,34,0,117,82,35
13438,E02004940,2013,102,309000,279000,1,30,35,36,0,102,65,37
13439,E02004940,2014,35,288000,250000,2,6,12,15,3,32,19,16
13440,E02004941,2009,88,242000,218000,8,25,30,25,1,87,61,27
13441,E02004941,2010,119,264000,245000,12,23,50,34,0,119,81,38
13442,E02004941,2011,111,272000,242000,19,21,44,27,1,110,82,29
13443,E02004941,2012,137,260000,240000,14,26,56,41,7,130,96,41
13444,E02004941,2013,145,278000,250000,17,26,53,49,12,133,96,49
13445,E02004941,2014,68,281000,257000,6,16,14,32,19,49,36,32
13446,E02004942,2009,117,301000,305000,33,32,28,24,52,65,94,23
13447,E02004942,2010,103,333000,321000,30,25,28,20,28,75,86,17
13448,E02004942,2011,70,349000,332000,24,20,20,6,3,67,64,6
13449,E02004942,2012,74,388000,331000,18,27,21,8,4,70,66,8
13450,E02004942,2013,88,329000,315000,28,19,28,13,2,86,75,13
13451,E02004942,2014,28,389000,361000,9,9,5,5,0,28,23,5
13452,E02004943,2009,95,365000,360000,41,42,6,6,0,95,90,5
13453,E02004943,2010,110,433000,392000,58,33,10,9,3,107,102,8
13454,E02004943,2011,83,399000,375000,35,35,7,6,0,83,77,6
13455,E02004943,2012,107,420000,392000,48,41,7,11,3,104,97,10
13456,E02004943,2013,130,420000,412000,60,42,12,16,5,125,114,16
13457,E02004943,2014,44,456000,472000,23,14,1,6,4,40,38,6
13458,E02004944,2009,43,136000,145000,0,2,35,6,0,43,36,7
13459,E02004944,2010,90,172000,162000,8,9,46,27,42,48,63,27
13460,E02004944,2011,73,205000,167000,13,16,28,16,35,38,57,16
13461,E02004944,2012,89,173000,155000,5,10,49,25,42,47,64,25
13462,E02004944,2013,104,189000,170000,3,20,58,23,39,65,81,23
13463,E02004944,2014,37,194000,177000,7,3,20,7,13,24,30,7
13464,E02004945,2009,142,218000,180000,24,42,31,45,38,104,96,46
13465,E02004945,2010,181,223000,182000,34,34,46,67,62,119,112,69
13466,E02004945,2011,190,216000,175000,26,44,53,67,50,140,124,66
13467,E02004945,2012,171,240000,196000,42,30,51,48,33,138,121,50
13468,E02004945,2013,152,242000,220000,33,38,44,37,2,150,114,38
13469,E02004945,2014,62,274000,228000,15,7,28,12,0,62,49,13
13470,E02004946,2009,43,167000,167000,2,7,29,5,0,43,38,5
13471,E02004946,2010,51,170000,165000,2,6,33,10,0,51,41,10
13472,E02004946,2011,58,172000,170000,5,8,37,8,0,58,50,8
13473,E02004946,2012,54,173000,170000,5,3,36,10,0,54,45,9
13474,E02004946,2013,82,178000,170000,11,4,52,15,0,82,67,15
13475,E02004946,2014,18,178000,182000,2,0,11,5,0,18,13,5
13476,E02004947,2009,92,180000,170000,19,30,41,2,0,92,91,1
13477,E02004947,2010,98,211000,196000,33,33,28,4,0,98,95,3
13478,E02004947,2011,88,216000,199000,26,28,34,0,0,88,88,0
13479,E02004947,2012,85,197000,183000,16,25,43,1,0,85,85,0
13480,E02004947,2013,94,206000,190000,24,22,48,0,0,94,94,0
13481,E02004947,2014,42,212000,204000,9,9,24,0,0,42,42,0
13482,E02004948,2009,49,165000,150000,7,4,21,17,0,49,32,17
13483,E02004948,2010,60,165000,162000,3,9,30,18,0,60,42,18
13484,E02004948,2011,60,166000,167000,4,6,36,14,0,60,46,14
13485,E02004948,2012,52,168000,170000,1,10,27,14,2,50,38,14
13486,E02004948,2013,62,172000,164000,5,4,31,22,0,62,40,22
13487,E02004948,2014,18,180000,190000,0,4,9,5,0,18,13,5
13488,E02004949,2009,81,156000,158000,1,12,42,26,8,73,54,27
13489,E02004949,2010,122,160000,157000,3,8,39,72,44,78,49,73
13490,E02004949,2011,113,168000,155000,3,14,46,50,44,69,62,51
13491,E02004949,2012,67,166000,160000,3,6,38,20,6,61,47,20
13492,E02004949,2013,89,175000,173000,3,13,53,20,3,86,67,22
13493,E02004949,2014,38,171000,174000,0,6,15,17,0,38,21,17
13494,E02004950,2009,32,152000,148000,1,6,23,2,0,32,31,1
13495,E02004950,2010,48,164000,158000,4,6,30,8,0,48,39,9
13496,E02004950,2011,61,168000,161000,6,7,40,8,0,61,52,9
13497,E02004950,2012,69,169000,158000,5,8,51,5,0,69,64,5
13498,E02004950,2013,94,177000,168000,10,9,65,10,0,94,82,12
13499,E02004950,2014,36,188000,180000,1,5,26,4,0,36,31,5
13500,E02004951,2009,40,153000,155000,1,4,21,14,0,40,27,13
13501,E02004951,2010,56,151000,155000,0,7,30,19,0,56,37,19
13502,E02004951,2011,66,150000,149000,2,2,39,23,0,66,43,23
13503,E02004951,2012,65,154000,156000,3,7,40,15,0,65,49,16
13504,E02004951,2013,57,139000,151000,1,7,27,22,1,56,35,22
13505,E02004951,2014,31,173000,165000,2,2,22,5,0,31,27,4
13506,E02004952,2009,54,171000,151000,11,8,27,8,0,54,47,7
13507,E02004952,2010,77,185000,165000,16,8,42,11,0,77,65,12
13508,E02004952,2011,76,179000,160000,14,5,41,16,0,76,61,15
13509,E02004952,2012,73,185000,163000,16,4,47,6,0,73,67,6
13510,E02004952,2013,90,190000,168000,15,10,49,16,6,84,75,15
13511,E02004952,2014,22,184000,183000,1,4,15,2,0,22,20,2
13512,E02004953,2009,51,156000,148000,1,11,37,2,0,51,49,2
13513,E02004953,2010,47,166000,155000,1,12,32,2,0,47,45,2
13514,E02004953,2011,60,182000,167000,8,13,38,1,9,51,59,1
13515,E02004953,2012,48,172000,160000,1,12,32,3,1,47,45,3
13516,E02004953,2013,71,168000,160000,1,11,55,4,1,70,67,4
13517,E02004953,2014,18,179000,172000,1,6,10,1,0,18,17,1
13518,E02004954,2009,61,181000,160000,1,14,41,5,0,61,56,5
13519,E02004954,2010,62,179000,162000,6,13,38,5,0,62,57,5
13520,E02004954,2011,55,175000,161000,7,7,33,8,1,54,48,7
13521,E02004954,2012,51,195000,175000,7,9,30,5,3,48,46,5
13522,E02004954,2013,80,198000,181000,9,16,45,10,17,63,70,10
13523,E02004954,2014,42,200000,182000,5,8,23,6,0,42,36,6
13524,E02004955,2009,67,185000,170000,6,6,45,10,13,54,57,10
13525,E02004955,2010,72,217000,216000,9,10,46,7,34,38,64,8
13526,E02004955,2011,54,211000,183000,10,7,36,1,1,53,53,1
13527,E02004955,2012,66,204000,188000,14,6,43,3,0,66,64,2
13528,E02004955,2013,66,208000,187000,10,5,46,5,0,66,63,3
13529,E02004955,2014,20,212000,191000,5,1,11,3,0,20,17,3
13530,E02004956,2009,84,284000,242000,16,24,22,22,7,77,61,23
13531,E02004956,2010,111,306000,265000,20,31,25,35,0,111,75,36
13532,E02004956,2011,150,300000,250000,28,52,36,34,2,148,114,36
13533,E02004956,2012,111,314000,265000,25,34,27,25,1,110,85,26
13534,E02004956,2013,134,341000,298000,35,43,27,29,0,134,105,29
13535,E02004956,2014,52,377000,357000,13,17,14,8,1,51,43,9
13536,E02004957,2009,97,250000,235000,19,29,29,20,2,95,73,24
13537,E02004957,2010,103,287000,250000,20,30,40,13,0,103,91,12
13538,E02004957,2011,124,277000,250000,17,42,50,15,13,111,105,19
13539,E02004957,2012,133,276000,248000,26,25,63,19,0,133,113,20
13540,E02004957,2013,145,298000,270000,28,40,58,19,20,125,126,19
13541,E02004957,2014,77,359000,365000,16,29,23,9,25,52,68,9
13542,E02004958,2009,89,374000,300000,23,26,18,22,22,67,67,22
13543,E02004958,2010,99,407000,392000,23,58,15,3,10,89,97,2
13544,E02004958,2011,112,380000,362000,29,47,21,15,31,81,97,15
13545,E02004958,2012,136,458000,400000,49,64,15,8,35,101,129,7
13546,E02004958,2013,136,472000,402000,31,74,16,15,14,122,121,15
13547,E02004958,2014,43,444000,415000,14,15,10,4,0,43,38,5
13548,E02004959,2009,94,592000,495000,59,5,3,27,2,92,65,29
13549,E02004959,2010,100,588000,426000,52,4,4,40,1,99,56,44
13550,E02004959,2011,117,572000,378000,53,4,5,55,21,96,57,60
13551,E02004959,2012,138,549000,395000,52,11,8,67,30,108,66,72
13552,E02004959,2013,124,637000,548000,70,8,9,37,3,121,84,40
13553,E02004959,2014,32,821000,565000,18,2,0,12,2,30,19,13
13554,E02004960,2009,85,518000,450000,38,19,5,23,12,73,62,23
13555,E02004960,2010,90,567000,535000,46,19,8,17,7,83,73,17
13556,E02004960,2011,94,490000,470000,38,24,7,25,5,89,67,27
13557,E02004960,2012,88,652000,625000,52,17,6,13,4,84,74,14
13558,E02004960,2013,95,573000,500000,42,19,9,25,1,94,70,25
13559,E02004960,2014,34,629000,616000,16,9,4,5,1,33,28,6
13560,E02004961,2009,134,287000,265000,12,51,42,29,18,116,104,30
13561,E02004961,2010,153,352000,320000,23,80,35,15,10,143,135,18
13562,E02004961,2011,148,344000,325000,21,60,45,22,15,133,126,22
13563,E02004961,2012,155,374000,327000,31,71,34,19,21,134,136,19
13564,E02004961,2013,174,427000,369000,35,85,38,16,13,161,158,16
13565,E02004961,2014,48,456000,376000,7,16,19,6,2,46,42,6
13566,E02004962,2009,137,330000,283000,33,38,41,25,7,130,112,25
13567,E02004962,2010,130,371000,305000,39,30,35,26,0,130,103,27
13568,E02004962,2011,125,359000,305000,26,35,35,29,0,125,94,31
13569,E02004962,2012,112,378000,314000,29,35,22,26,4,108,86,26
13570,E02004962,2013,159,410000,342000,43,29,42,45,20,139,112,47
13571,E02004962,2014,40,405000,310000,9,5,11,15,1,39,25,15
13572,E02004963,2009,68,239000,199000,8,25,31,4,1,67,64,4
13573,E02004963,2010,70,255000,218000,5,40,25,0,0,70,70,0
13574,E02004963,2011,59,327000,225000,13,23,21,2,2,57,57,2
13575,E02004963,2012,68,258000,221000,9,27,27,5,0,68,63,5
13576,E02004963,2013,77,288000,243000,7,38,23,9,0,77,68,9
13577,E02004963,2014,25,285000,255000,4,9,9,3,0,25,22,3
13578,E02004964,2009,82,261000,245000,6,34,34,8,23,59,75,7
13579,E02004964,2010,65,313000,250000,15,31,14,5,0,65,59,6
13580,E02004964,2011,60,257000,245000,2,35,12,11,2,58,49,11
13581,E02004964,2012,75,283000,248000,5,28,36,6,13,62,69,6
13582,E02004964,2013,82,306000,287000,11,40,19,12,0,82,70,12
13583,E02004964,2014,32,287000,273000,4,9,8,11,1,31,21,11
13584,E02004965,2009,73,232000,232000,8,45,19,1,2,71,72,1
13585,E02004965,2010,86,260000,250000,22,37,17,10,0,86,75,11
13586,E02004965,2011,102,262000,250000,18,51,19,14,0,102,86,16
13587,E02004965,2012,59,261000,250000,11,30,13,5,0,59,54,5
13588,E02004965,2013,108,294000,276000,20,57,19,12,0,108,95,13
13589,E02004965,2014,28,303000,305000,4,15,4,5,1,27,22,6
13590,E02004966,2009,69,720000,660000,43,10,4,12,3,66,57,12
13591,E02004966,2010,81,815000,675000,54,9,1,17,4,77,64,17
13592,E02004966,2011,72,777000,690000,43,15,1,13,1,71,59,13
13593,E02004966,2012,62,890000,795000,46,5,2,9,6,56,53,9
13594,E02004966,2013,67,1026000,868000,40,6,4,17,15,52,50,17
13595,E02004966,2014,31,784000,775000,18,2,3,8,1,30,23,8
13596,E02004967,2009,64,171000,171000,0,14,35,15,0,64,48,16
13597,E02004967,2010,70,191000,189000,2,23,32,13,0,70,58,12
13598,E02004967,2011,71,189000,190000,0,21,36,14,0,71,58,13
13599,E02004967,2012,66,200000,200000,3,17,34,12,0,66,53,13
13600,E02004967,2013,83,203000,214000,0,14,51,18,0,83,65,18
13601,E02004967,2014,31,217000,240000,0,11,13,7,0,31,24,7
13602,E02004968,2009,78,198000,189000,6,28,14,30,0,78,48,30
13603,E02004968,2010,87,246000,240000,11,25,30,21,18,69,67,20
13604,E02004968,2011,81,231000,225000,7,25,20,29,1,80,52,29
13605,E02004968,2012,90,242000,228000,10,30,22,28,2,88,61,29
13606,E02004968,2013,111,248000,245000,3,24,45,39,17,94,72,39
13607,E02004968,2014,42,266000,250000,5,8,15,14,4,38,28,14
13608,E02004969,2009,77,234000,220000,3,39,17,18,13,64,59,18
13609,E02004969,2010,93,252000,245000,13,40,17,23,10,83,69,24
13610,E02004969,2011,79,262000,245000,15,32,20,12,2,77,67,12
13611,E02004969,2012,75,263000,250000,12,27,20,16,1,74,60,15
13612,E02004969,2013,96,280000,258000,20,36,26,14,1,95,81,15
13613,E02004969,2014,33,287000,284000,7,12,9,5,0,33,28,5
13614,E02004970,2009,86,209000,215000,2,27,27,30,16,70,56,30
13615,E02004970,2010,121,202000,200000,5,20,15,81,46,75,40,81
13616,E02004970,2011,113,200000,205000,4,24,17,68,43,70,44,69
13617,E02004970,2012,168,203000,203000,1,35,20,112,72,96,56,112
13618,E02004970,2013,83,217000,215000,3,21,17,42,15,68,41,42
13619,E02004970,2014,36,228000,221000,1,10,8,17,0,36,18,18
13620,E02004971,2009,82,201000,202000,7,33,18,24,1,81,57,25
13621,E02004971,2010,63,217000,230000,4,30,12,17,0,63,45,18
13622,E02004971,2011,125,215000,200000,6,38,28,53,46,79,68,57
13623,E02004971,2012,125,237000,237000,6,38,37,44,54,71,80,45
13624,E02004971,2013,162,219000,204000,5,38,32,87,75,87,73,89
13625,E02004971,2014,46,230000,229000,5,11,9,21,0,46,23,23
13626,E02004972,2009,63,236000,232000,1,39,8,15,0,63,48,15
13627,E02004972,2010,74,252000,250000,1,39,11,23,0,74,51,23
13628,E02004972,2011,77,262000,275000,1,43,12,21,0,77,54,23
13629,E02004972,2012,82,267000,275000,3,51,9,19,0,82,63,19
13630,E02004972,2013,75,279000,290000,1,44,6,24,0,75,51,24
13631,E02004972,2014,27,302000,320000,1,16,2,8,0,27,19,8
13632,E02004973,2009,134,184000,185000,0,12,99,23,3,131,113,21
13633,E02004973,2010,132,201000,205000,0,12,92,28,7,125,105,27
13634,E02004973,2011,142,193000,199000,0,6,108,28,2,140,112,30
13635,E02004973,2012,142,205000,210000,1,9,108,24,4,138,118,24
13636,E02004973,2013,156,215000,222000,0,16,108,32,4,152,123,33
13637,E02004973,2014,46,229000,244000,1,5,28,12,1,45,34,12
13638,E02004974,2009,162,277000,232000,37,14,21,90,55,107,69,93
13639,E02004974,2010,165,305000,240000,28,19,32,86,48,117,78,87
13640,E02004974,2011,132,325000,255000,26,13,28,65,26,106,66,66
13641,E02004974,2012,190,346000,300000,30,15,48,97,70,120,93,97
13642,E02004974,2013,215,372000,295000,38,26,37,114,79,136,100,115
13643,E02004974,2014,59,347000,248000,7,10,6,36,17,42,23,36
13644,E02004975,2009,126,401000,372000,43,26,13,44,28,98,81,45
13645,E02004975,2010,141,377000,285000,39,28,7,67,38,103,74,67
13646,E02004975,2011,105,446000,430000,42,21,5,37,8,97,67,38
13647,E02004975,2012,77,465000,475000,33,11,6,27,2,75,50,27
13648,E02004975,2013,127,467000,490000,50,26,4,47,2,125,80,47
13649,E02004975,2014,51,400000,270000,14,7,4,26,0,51,25,26
13650,E02004976,2009,165,174000,170000,1,7,52,105,59,106,59,106
13651,E02004976,2010,231,190000,195000,2,12,64,153,100,131,79,152
13652,E02004976,2011,202,189000,193000,0,9,63,130,77,125,71,131
13653,E02004976,2012,181,201000,195000,0,7,73,101,44,137,76,105
13654,E02004976,2013,179,194000,200000,1,8,67,103,15,164,77,102
13655,E02004976,2014,63,223000,225000,0,1,27,35,2,61,27,36
13656,E02004977,2009,89,194000,185000,1,6,71,11,0,89,76,13
13657,E02004977,2010,77,203000,207000,0,6,63,8,0,77,69,8
13658,E02004977,2011,101,206000,205000,2,5,83,11,0,101,90,11
13659,E02004977,2012,84,218000,216000,1,7,69,7,1,83,76,8
13660,E02004977,2013,103,230000,224000,3,10,77,13,0,103,89,14
13661,E02004977,2014,35,235000,248000,0,2,29,4,0,35,32,3
13662,E02004978,2009,67,182000,175000,1,11,19,36,4,63,30,37
13663,E02004978,2010,86,188000,180000,2,16,24,44,2,84,40,46
13664,E02004978,2011,86,194000,188000,3,8,33,42,9,77,41,45
13665,E02004978,2012,92,210000,205000,0,12,38,42,13,79,48,44
13666,E02004978,2013,127,210000,208000,3,19,28,77,26,101,49,78
13667,E02004978,2014,54,216000,228000,0,7,7,40,19,35,13,41
13668,E02004979,2009,72,283000,235000,10,21,36,5,1,71,68,4
13669,E02004979,2010,105,334000,280000,21,29,36,19,3,102,85,20
13670,E02004979,2011,80,317000,250000,15,20,29,16,0,80,64,16
13671,E02004979,2012,124,350000,255000,26,24,36,38,22,102,85,39
13672,E02004979,2013,123,329000,250000,17,18,39,49,25,98,74,49
13673,E02004979,2014,40,337000,292000,8,9,15,8,0,40,32,8
13674,E02004980,2009,89,426000,385000,51,19,12,7,1,88,83,6
13675,E02004980,2010,86,547000,427000,54,13,14,5,1,85,81,5
13676,E02004980,2011,87,517000,468000,60,11,12,4,1,86,83,4
13677,E02004980,2012,76,475000,412000,42,16,11,7,7,69,69,7
13678,E02004980,2013,98,469000,460000,64,19,7,8,7,91,90,8
13679,E02004980,2014,46,413000,405000,24,7,8,7,1,45,40,6
13680,E02004981,2009,101,308000,275000,32,18,36,15,8,93,86,15
13681,E02004981,2010,102,371000,285000,30,26,28,18,12,90,86,16
13682,E02004981,2011,106,348000,276000,19,31,47,9,28,78,97,9
13683,E02004981,2012,99,341000,275000,24,27,34,14,1,98,84,15
13684,E02004981,2013,123,361000,315000,30,27,49,17,6,117,106,17
13685,E02004981,2014,39,370000,325000,11,7,8,13,0,39,26,13
13686,E02004982,2009,75,310000,239000,18,19,33,5,4,71,54,21
13687,E02004982,2010,50,335000,294000,16,13,16,5,1,49,31,19
13688,E02004982,2011,60,345000,280000,16,12,29,3,0,60,42,18
13689,E02004982,2012,60,321000,250000,11,10,32,7,1,59,43,17
13690,E02004982,2013,104,362000,276000,28,21,40,15,0,104,71,33
13691,E02004982,2014,25,386000,330000,5,7,12,1,0,25,19,6
13692,E02004983,2009,58,189000,185000,2,10,31,15,0,58,39,19
13693,E02004983,2010,51,201000,215000,2,11,26,12,0,51,36,15
13694,E02004983,2011,58,209000,212000,1,6,40,11,0,58,44,14
13695,E02004983,2012,61,200000,200000,2,9,34,16,0,61,43,18
13696,E02004983,2013,70,214000,220000,1,9,43,17,0,70,50,20
13697,E02004983,2014,30,230000,238000,1,3,16,10,0,30,19,11
13698,E02004984,2009,79,204000,187000,14,11,33,21,1,78,60,19
13699,E02004984,2010,89,200000,193000,10,12,34,33,0,89,59,30
13700,E02004984,2011,85,220000,200000,20,12,29,24,0,85,62,23
13701,E02004984,2012,86,219000,194000,19,10,33,24,0,86,62,24
13702,E02004984,2013,93,235000,200000,22,9,36,26,0,93,66,27
13703,E02004984,2014,43,239000,235000,7,6,19,11,0,43,32,11
13704,E02004985,2009,99,302000,275000,13,24,31,31,14,85,41,58
13705,E02004985,2010,90,333000,305000,15,26,22,27,7,83,31,59
13706,E02004985,2011,78,377000,360000,14,24,22,18,1,77,36,42
13707,E02004985,2012,72,381000,322000,12,17,28,15,1,71,35,37
13708,E02004985,2013,83,387000,390000,4,32,32,15,8,75,37,46
13709,E02004985,2014,46,374000,316000,9,9,8,20,1,45,17,29
13710,E02004986,2009,73,168000,170000,3,12,34,24,0,73,45,28
13711,E02004986,2010,62,186000,187000,0,16,35,11,0,62,50,12
13712,E02004986,2011,64,198000,200000,2,11,38,13,7,57,49,15
13713,E02004986,2012,104,196000,192000,1,21,38,44,48,56,58,46
13714,E02004986,2013,121,210000,202000,0,21,55,45,53,68,74,47
13715,E02004986,2014,74,199000,202000,1,5,13,55,49,25,19,55
13716,E02004987,2009,71,198000,190000,4,21,43,3,3,68,63,8
13717,E02004987,2010,68,250000,218000,11,20,36,1,0,68,63,5
13718,E02004987,2011,73,247000,229000,13,18,42,0,0,73,64,9
13719,E02004987,2012,73,247000,223000,10,18,44,1,1,72,64,9
13720,E02004987,2013,98,256000,236000,12,20,55,11,23,75,79,19
13721,E02004987,2014,30,278000,255000,2,7,19,2,1,29,23,7
13722,E02004988,2009,81,200000,187000,3,15,43,20,0,81,56,25
13723,E02004988,2010,90,221000,215000,2,25,38,25,0,90,62,28
13724,E02004988,2011,88,211000,198000,2,16,46,24,0,88,60,28
13725,E02004988,2012,91,218000,212000,0,23,40,28,0,91,61,30
13726,E02004988,2013,101,244000,230000,4,24,46,27,0,101,70,31
13727,E02004988,2014,47,235000,215000,1,8,20,18,0,47,29,18
13728,E02004989,2009,83,211000,195000,6,26,29,22,2,81,62,21
13729,E02004989,2010,124,224000,185000,13,26,32,53,22,102,71,53
13730,E02004989,2011,149,240000,218000,10,26,65,48,81,68,99,50
13731,E02004989,2012,88,233000,218000,5,28,31,24,5,83,63,25
13732,E02004989,2013,85,238000,207000,7,17,33,28,0,85,58,27
13733,E02004989,2014,33,262000,250000,3,12,11,7,0,33,25,8
13734,E02004990,2009,70,320000,225000,13,10,32,15,9,61,47,23
13735,E02004990,2010,90,324000,250000,16,14,40,20,20,70,66,24
13736,E02004990,2011,71,309000,247000,13,11,30,17,8,63,52,19
13737,E02004990,2012,77,332000,250000,17,18,28,14,12,65,59,18
13738,E02004990,2013,80,284000,226000,10,12,30,28,4,76,48,32
13739,E02004990,2014,35,270000,250000,4,8,16,7,0,35,28,7
13740,E02004991,2009,66,168000,160000,3,9,28,26,10,56,38,28
13741,E02004991,2010,68,174000,172000,3,7,31,27,18,50,39,29
13742,E02004991,2011,51,186000,188000,2,7,27,15,0,51,35,16
13743,E02004991,2012,52,187000,192000,2,7,26,17,1,51,37,15
13744,E02004991,2013,92,213000,207000,8,11,49,24,21,71,65,27
13745,E02004991,2014,33,201000,208000,2,7,14,10,6,27,23,10
13746,E02004992,2009,51,173000,172000,2,9,34,6,0,51,45,6
13747,E02004992,2010,76,184000,185000,4,7,52,13,0,76,63,13
13748,E02004992,2011,87,185000,186000,1,16,52,18,0,87,68,19
13749,E02004992,2012,59,182000,189000,3,8,38,10,0,59,49,10
13750,E02004992,2013,81,194000,190000,4,11,56,10,0,81,69,12
13751,E02004992,2014,41,204000,198000,1,2,35,3,0,41,37,4
13752,E02004993,2009,44,233000,218000,3,12,23,6,0,44,37,7
13753,E02004993,2010,64,286000,240000,14,15,25,10,0,64,52,12
13754,E02004993,2011,56,253000,242000,4,24,21,7,0,56,48,8
13755,E02004993,2012,48,251000,232000,3,14,22,9,0,48,39,9
13756,E02004993,2013,71,265000,241000,12,13,32,14,1,70,57,14
13757,E02004993,2014,25,264000,250000,5,5,11,4,1,24,21,4
13758,E02004994,2009,79,565000,495000,38,21,7,13,3,76,66,13
13759,E02004994,2010,70,648000,560000,40,21,3,6,0,70,64,6
13760,E02004994,2011,72,578000,488000,29,28,3,12,6,66,60,12
13761,E02004994,2012,87,524000,440000,28,26,7,26,16,71,61,26
13762,E02004994,2013,98,621000,520000,39,36,9,14,2,96,84,14
13763,E02004994,2014,35,680000,667000,17,13,0,5,0,35,30,5
13764,E02004995,2009,60,693000,474000,45,10,2,3,2,58,56,4
13765,E02004995,2010,83,562000,480000,64,13,1,5,0,83,75,8
13766,E02004995,2011,68,585000,453000,47,14,2,5,0,68,61,7
13767,E02004995,2012,82,543000,478000,58,10,6,8,0,82,74,8
13768,E02004995,2013,83,538000,490000,49,11,3,20,10,73,63,20
13769,E02004995,2014,42,575000,495000,28,4,2,8,2,40,34,8
13770,E02004996,2009,118,251000,208000,41,36,29,12,11,107,106,12
13771,E02004996,2010,141,284000,238000,55,36,45,5,8,133,131,10
13772,E02004996,2011,88,292000,250000,36,23,26,3,5,83,80,8
13773,E02004996,2012,109,285000,260000,51,24,27,7,6,103,99,10
13774,E02004996,2013,133,316000,250000,61,28,39,5,4,129,120,13
13775,E02004996,2014,34,313000,268000,12,8,11,3,3,31,31,3
13776,E02004997,2009,87,330000,280000,46,26,12,3,1,86,83,4
13777,E02004997,2010,96,336000,312000,48,26,18,4,1,95,92,4
13778,E02004997,2011,76,328000,262000,39,25,10,2,0,76,74,2
13779,E02004997,2012,77,354000,280000,42,16,16,3,0,77,74,3
13780,E02004997,2013,95,350000,300000,51,21,16,7,0,95,89,6
13781,E02004997,2014,38,334000,262000,18,12,7,1,0,38,37,1
13782,E02004998,2009,76,217000,181000,29,40,5,2,0,76,74,2
13783,E02004998,2010,86,247000,218000,40,33,12,1,0,86,83,3
13784,E02004998,2011,79,214000,180000,29,41,8,1,0,79,76,3
13785,E02004998,2012,83,212000,198000,31,33,15,4,5,78,77,6
13786,E02004998,2013,125,232000,215000,51,52,17,5,4,121,120,5
13787,E02004998,2014,37,242000,208000,13,16,5,3,0,37,34,3
13788,E02004999,2009,137,180000,163000,40,40,39,18,4,133,119,18
13789,E02004999,2010,216,181000,165000,45,57,63,51,58,158,164,52
13790,E02004999,2011,233,174000,160000,51,69,71,42,56,177,186,47
13791,E02004999,2012,244,180000,170000,54,59,79,52,89,155,192,52
13792,E02004999,2013,246,188000,170000,46,66,98,36,41,205,209,37
13793,E02004999,2014,97,187000,165000,17,25,35,20,12,85,77,20
13794,E02005000,2009,117,142000,141000,13,44,51,9,2,115,108,9
13795,E02005000,2010,129,151000,142000,7,35,46,41,38,91,85,44
13796,E02005000,2011,228,142000,132000,10,38,102,78,101,127,150,78
13797,E02005000,2012,180,164000,155000,17,36,92,35,78,102,144,36
13798,E02005000,2013,159,169000,165000,17,42,91,9,37,122,149,10
13799,E02005000,2014,57,156000,152000,3,14,32,8,0,57,48,9
13800,E02005001,2009,113,176000,168000,29,44,35,5,2,111,107,6
13801,E02005001,2010,114,179000,175000,25,50,32,7,6,108,107,7
13802,E02005001,2011,110,202000,184000,35,41,31,3,18,92,107,3
13803,E02005001,2012,121,202000,185000,36,58,26,1,16,105,120,1
13804,E02005001,2013,108,193000,173000,29,42,30,7,0,108,101,7
13805,E02005001,2014,46,202000,196000,13,17,14,2,0,46,44,2
13806,E02005002,2009,145,147000,138000,15,47,65,18,19,126,122,23
13807,E02005002,2010,130,159000,155000,9,53,63,5,17,113,123,7
13808,E02005002,2011,104,145000,137000,10,34,46,14,2,102,87,17
13809,E02005002,2012,103,149000,142000,13,34,46,10,0,103,92,11
13810,E02005002,2013,135,147000,137000,14,45,63,13,0,135,120,15
13811,E02005002,2014,35,147000,142000,2,11,16,6,0,35,28,7
13812,E02005003,2009,101,136000,129000,9,35,38,19,21,80,82,19
13813,E02005003,2010,138,158000,146000,19,39,57,23,42,96,112,26
13814,E02005003,2011,161,147000,142000,13,52,75,21,42,119,136,25
13815,E02005003,2012,89,146000,132000,7,36,25,21,20,69,68,21
13816,E02005003,2013,89,179000,159000,23,32,32,2,0,89,85,4
13817,E02005003,2014,42,185000,164000,9,18,14,1,0,42,39,3
13818,E02005004,2009,187,180000,175000,73,39,60,15,35,152,167,20
13819,E02005004,2010,161,187000,175000,59,41,49,12,13,148,143,18
13820,E02005004,2011,147,181000,172000,50,37,51,9,0,147,132,15
13821,E02005004,2012,134,191000,182000,61,25,42,6,1,133,127,7
13822,E02005004,2013,179,197000,180000,71,45,55,8,0,179,170,9
13823,E02005004,2014,68,212000,215000,22,15,20,11,1,67,58,10
13824,E02005005,2009,130,266000,197000,59,40,28,3,62,68,129,1
13825,E02005005,2010,203,255000,232000,102,48,49,4,113,90,199,4
13826,E02005005,2011,180,269000,233000,85,45,44,6,79,101,175,5
13827,E02005005,2012,87,278000,250000,42,16,21,8,17,70,77,10
13828,E02005005,2013,99,337000,300000,73,16,10,0,3,96,98,1
13829,E02005005,2014,31,293000,294000,21,4,6,0,0,31,31,0
13830,E02005006,2009,53,383000,280000,27,14,12,0,0,53,53,0
13831,E02005006,2010,44,370000,275000,20,15,8,1,0,44,43,1
13832,E02005006,2011,57,468000,315000,32,18,7,0,0,57,56,1
13833,E02005006,2012,52,314000,255000,27,13,10,2,0,52,50,2
13834,E02005006,2013,65,384000,310000,35,12,17,1,0,65,63,2
13835,E02005006,2014,22,369000,217000,9,6,6,1,0,22,20,2
13836,E02005007,2009,130,256000,213000,63,38,24,5,13,117,122,8
13837,E02005007,2010,132,266000,218000,56,27,41,8,26,106,123,9
13838,E02005007,2011,108,230000,196000,42,42,20,4,2,106,101,7
13839,E02005007,2012,102,264000,212000,46,27,27,2,0,102,98,4
13840,E02005007,2013,148,271000,222000,68,34,38,8,3,145,140,8
13841,E02005007,2014,60,209000,190000,16,19,20,5,0,60,55,5
13842,E02005008,2009,112,271000,225000,45,24,27,16,3,109,96,16
13843,E02005008,2010,131,320000,275000,58,26,32,15,6,125,113,18
13844,E02005008,2011,93,317000,255000,33,30,22,8,1,92,81,12
13845,E02005008,2012,124,344000,275000,68,21,26,9,0,124,115,9
13846,E02005008,2013,158,325000,274000,71,40,33,14,0,158,143,15
13847,E02005008,2014,52,289000,261000,24,8,10,10,0,52,42,10
13848,E02005009,2009,62,285000,201000,27,24,11,0,0,62,62,0
13849,E02005009,2010,68,354000,272000,32,24,12,0,1,67,68,0
13850,E02005009,2011,57,323000,250000,24,20,13,0,1,56,57,0
13851,E02005009,2012,50,367000,310000,27,13,10,0,1,49,50,0
13852,E02005009,2013,91,311000,250000,39,32,18,2,0,91,89,2
13853,E02005009,2014,28,347000,295000,14,9,5,0,0,28,28,0
13854,E02005010,2009,100,151000,130000,19,14,17,50,5,95,51,49
13855,E02005010,2010,110,171000,151000,21,17,29,43,0,110,65,45
13856,E02005010,2011,112,156000,145000,20,18,24,50,0,112,63,49
13857,E02005010,2012,118,161000,142000,20,15,27,56,1,117,61,57
13858,E02005010,2013,140,180000,158000,22,20,39,59,1,139,80,60
13859,E02005010,2014,53,169000,154000,7,10,15,21,0,53,31,22
13860,E02005011,2009,98,193000,190000,45,32,17,4,8,90,91,7
13861,E02005011,2010,112,218000,218000,60,28,19,5,9,103,106,6
13862,E02005011,2011,108,218000,212000,54,26,24,4,19,89,103,5
13863,E02005011,2012,115,228000,225000,78,21,13,3,2,113,110,5
13864,E02005011,2013,143,236000,230000,92,29,18,4,1,142,136,7
13865,E02005011,2014,46,244000,248000,31,10,3,2,0,46,43,3
13866,E02005012,2009,132,179000,165000,46,52,25,9,14,118,125,7
13867,E02005012,2010,123,185000,173000,40,45,23,15,3,120,108,15
13868,E02005012,2011,106,187000,178000,48,35,16,7,0,106,98,8
13869,E02005012,2012,116,191000,175000,57,36,18,5,4,112,112,4
13870,E02005012,2013,150,204000,190000,82,40,19,9,1,149,142,8
13871,E02005012,2014,54,185000,184000,13,22,12,7,0,54,47,7
13872,E02005013,2009,111,187000,168000,43,42,14,12,11,100,99,12
13873,E02005013,2010,137,189000,176000,62,41,22,12,6,131,127,10
13874,E02005013,2011,124,181000,175000,60,45,15,4,1,123,120,4
13875,E02005013,2012,124,201000,180000,65,43,13,3,7,117,121,3
13876,E02005013,2013,177,192000,175000,88,55,23,11,2,175,167,10
13877,E02005013,2014,46,194000,182000,15,26,5,0,0,46,46,0
13878,E02005014,2009,166,235000,200000,68,57,21,20,6,160,145,21
13879,E02005014,2010,131,298000,250000,77,43,1,10,0,131,123,8
13880,E02005014,2011,148,256000,226000,70,53,8,17,0,148,133,15
13881,E02005014,2012,164,266000,245000,92,44,10,18,2,162,148,16
13882,E02005014,2013,189,278000,240000,92,62,14,21,1,188,167,22
13883,E02005014,2014,74,304000,282000,40,26,1,7,0,74,68,6
13884,E02005015,2009,130,178000,170000,39,44,27,20,30,100,109,21
13885,E02005015,2010,163,187000,170000,58,52,28,25,39,124,138,25
13886,E02005015,2011,121,188000,178000,41,51,22,7,16,105,116,5
13887,E02005015,2012,137,201000,190000,53,55,22,7,18,119,130,7
13888,E02005015,2013,209,199000,185000,67,60,55,27,43,166,182,27
13889,E02005015,2014,75,213000,195000,24,31,17,3,11,64,71,4
13890,E02005016,2009,114,215000,206000,40,42,20,12,1,113,100,14
13891,E02005016,2010,107,242000,216000,39,36,17,15,0,107,93,14
13892,E02005016,2011,130,258000,235000,55,41,22,12,7,123,118,12
13893,E02005016,2012,147,254000,222000,53,39,24,31,21,126,116,31
13894,E02005016,2013,167,249000,220000,51,61,18,37,20,147,130,37
13895,E02005016,2014,61,251000,225000,17,25,10,9,2,59,52,9
13896,E02005017,2009,180,200000,180000,22,31,96,31,4,176,148,32
13897,E02005017,2010,201,247000,224000,31,38,104,28,19,182,173,28
13898,E02005017,2011,194,235000,220000,37,30,98,29,7,187,165,29
13899,E02005017,2012,159,239000,207000,20,26,77,36,4,155,122,37
13900,E02005017,2013,209,242000,230000,39,39,91,40,1,208,169,40
13901,E02005017,2014,104,249000,230000,8,22,50,24,8,96,79,25
13902,E02005018,2009,111,239000,210000,59,38,10,4,1,110,105,6
13903,E02005018,2010,95,252000,237000,50,35,10,0,2,93,93,2
13904,E02005018,2011,148,219000,200000,66,30,37,15,42,106,137,11
13905,E02005018,2012,175,230000,215000,79,48,34,14,29,146,159,16
13906,E02005018,2013,161,267000,222000,71,60,11,19,25,136,142,19
13907,E02005018,2014,78,256000,232000,31,32,7,8,8,70,71,7
13908,E02005019,2009,61,246000,200000,26,14,17,4,5,56,56,5
13909,E02005019,2010,72,308000,256000,30,22,18,2,11,61,70,2
13910,E02005019,2011,60,276000,212000,29,17,11,3,2,58,57,3
13911,E02005019,2012,82,286000,220000,28,28,22,4,4,78,78,4
13912,E02005019,2013,82,246000,234000,31,28,18,5,0,82,77,5
13913,E02005019,2014,29,283000,250000,10,13,6,0,0,29,29,0
13914,E02005020,2009,71,195000,160000,12,45,14,0,0,71,71,0
13915,E02005020,2010,77,195000,165000,12,48,12,5,0,77,72,5
13916,E02005020,2011,67,198000,163000,9,43,13,2,1,66,65,2
13917,E02005020,2012,83,207000,168000,18,51,13,1,3,80,82,1
13918,E02005020,2013,91,223000,178000,20,56,13,2,5,86,89,2
13919,E02005020,2014,32,217000,176000,3,14,12,3,1,31,28,4
13920,E02005021,2009,65,274000,235000,29,26,8,2,0,65,63,2
13921,E02005021,2010,71,270000,245000,23,34,14,0,0,71,71,0
13922,E02005021,2011,103,285000,250000,38,48,8,9,1,102,95,8
13923,E02005021,2012,71,256000,245000,23,32,14,2,0,71,69,2
13924,E02005021,2013,80,322000,260000,35,32,8,5,1,79,75,5
13925,E02005021,2014,37,286000,279000,15,12,8,2,1,36,35,2
13926,E02005022,2009,77,195000,189000,10,21,36,10,0,77,66,11
13927,E02005022,2010,71,229000,220000,20,19,24,8,0,71,62,9
13928,E02005022,2011,84,223000,215000,15,29,30,10,0,84,74,10
13929,E02005022,2012,70,276000,246000,30,18,14,8,0,70,62,8
13930,E02005022,2013,59,247000,225000,15,16,20,8,1,58,51,8
13931,E02005022,2014,33,270000,245000,8,5,16,4,0,33,29,4
13932,E02005023,2009,76,180000,165000,2,17,30,27,17,59,47,29
13933,E02005023,2010,83,179000,165000,1,23,29,30,13,70,51,32
13934,E02005023,2011,82,216000,178000,5,24,35,18,18,64,62,20
13935,E02005023,2012,103,227000,196000,1,12,46,44,43,60,58,45
13936,E02005023,2013,114,210000,202000,3,20,41,50,37,77,64,50
13937,E02005023,2014,30,201000,193000,0,6,11,13,7,23,17,13
13938,E02005025,2009,122,221000,193000,28,32,30,32,11,111,88,34
13939,E02005025,2010,104,286000,250000,31,31,22,20,3,101,84,20
13940,E02005025,2011,114,261000,220000,20,43,31,20,0,114,92,22
13941,E02005025,2012,122,255000,250000,32,31,31,28,20,102,93,29
13942,E02005025,2013,163,286000,250000,38,41,46,38,26,137,125,38
13943,E02005025,2014,56,237000,220000,12,8,15,21,3,53,35,21
13944,E02005026,2009,96,224000,189000,31,26,22,17,3,93,79,17
13945,E02005026,2010,105,276000,216000,42,29,25,9,0,105,96,9
13946,E02005026,2011,102,233000,202000,38,33,22,9,0,102,93,9
13947,E02005026,2012,111,260000,212000,39,33,33,6,1,110,106,5
13948,E02005026,2013,142,305000,245000,55,35,45,7,23,119,135,7
13949,E02005026,2014,49,262000,215000,18,8,16,7,2,47,42,7
13950,E02005027,2009,56,272000,220000,25,20,8,3,0,56,51,5
13951,E02005027,2010,47,333000,308000,26,15,3,3,0,47,44,3
13952,E02005027,2011,66,290000,220000,27,22,9,8,0,66,56,10
13953,E02005027,2012,68,338000,270000,31,25,11,1,1,67,66,2
13954,E02005027,2013,66,309000,285000,27,23,13,3,1,65,63,3
13955,E02005027,2014,33,281000,235000,12,12,5,4,1,32,29,4
13956,E02005028,2009,64,155000,160000,0,13,27,24,29,35,37,27
13957,E02005028,2010,56,162000,162000,1,8,30,17,17,39,36,20
13958,E02005028,2011,119,184000,182000,0,12,72,35,74,45,83,36
13959,E02005028,2012,139,172000,172000,2,17,74,46,76,63,93,46
13960,E02005028,2013,212,194000,193000,2,27,142,41,144,68,171,41
13961,E02005028,2014,69,176000,160000,1,7,27,34,39,30,35,34
13962,E02005029,2009,120,161000,156000,9,24,39,48,39,81,69,51
13963,E02005029,2010,187,197000,178000,20,38,48,81,64,123,107,80
13964,E02005029,2011,278,181000,180000,12,32,68,166,131,147,108,170
13965,E02005029,2012,144,211000,196000,12,32,59,41,4,140,102,42
13966,E02005029,2013,172,201000,187000,19,33,65,55,1,171,116,56
13967,E02005029,2014,80,201000,184000,7,11,24,38,0,80,42,38
13968,E02005030,2009,135,172000,173000,9,19,72,35,24,111,98,37
13969,E02005030,2010,140,201000,188000,12,33,67,28,23,117,112,28
13970,E02005030,2011,145,203000,187000,10,25,83,27,34,111,119,26
13971,E02005030,2012,157,210000,198000,17,33,75,32,30,127,128,29
13972,E02005030,2013,147,204000,186000,14,27,73,33,12,135,114,33
13973,E02005030,2014,44,195000,192000,1,6,23,14,0,44,31,13
13974,E02005031,2009,99,166000,160000,2,10,30,57,42,57,40,59
13975,E02005031,2010,97,171000,163000,1,11,45,40,25,72,57,40
13976,E02005031,2011,100,177000,158000,8,14,48,30,16,84,71,29
13977,E02005031,2012,99,189000,162000,16,7,42,34,24,75,65,34
13978,E02005031,2013,103,176000,164000,3,18,58,24,4,99,80,23
13979,E02005031,2014,39,196000,195000,0,3,25,11,4,35,28,11
13980,E02005032,2009,121,146000,148000,2,23,75,21,0,121,99,22
13981,E02005032,2010,126,155000,155000,3,29,69,25,0,126,100,26
13982,E02005032,2011,129,153000,154000,2,27,79,21,1,128,108,21
13983,E02005032,2012,108,154000,154000,5,10,67,26,0,108,82,26
13984,E02005032,2013,136,160000,160000,3,20,89,24,1,135,112,24
13985,E02005032,2014,64,162000,160000,1,8,32,23,1,63,41,23
13986,E02005033,2009,93,151000,160000,5,11,32,45,29,64,48,45
13987,E02005033,2010,60,157000,160000,3,14,24,19,0,60,41,19
13988,E02005033,2011,81,161000,158000,4,21,33,23,1,80,58,23
13989,E02005033,2012,146,205000,190000,4,16,51,75,57,89,66,80
13990,E02005033,2013,223,216000,200000,5,16,72,130,111,112,70,153
13991,E02005033,2014,55,173000,172000,0,6,18,31,14,41,22,33
13992,E02005034,2009,64,210000,200000,7,30,23,4,0,64,61,3
13993,E02005034,2010,86,231000,225000,11,50,24,1,7,79,85,1
13994,E02005034,2011,87,223000,222000,8,43,30,6,4,83,79,8
13995,E02005034,2012,86,234000,230000,10,45,24,7,1,85,77,9
13996,E02005034,2013,100,234000,232000,12,40,42,6,0,100,94,6
13997,E02005034,2014,38,254000,250000,7,15,11,5,1,37,33,5
13998,E02005035,2009,99,187000,182000,8,28,39,24,33,66,76,23
13999,E02005035,2010,72,190000,191000,9,27,21,15,4,68,57,15
14000,E02005035,2011,80,186000,191000,6,36,20,18,2,78,62,18
14001,E02005035,2012,72,206000,199000,8,29,26,9,0,72,63,9
14002,E02005035,2013,113,214000,210000,17,37,42,17,2,111,95,18
14003,E02005035,2014,36,235000,232000,6,16,9,5,0,36,31,5
14004,E02005036,2009,43,161000,150000,2,10,29,2,2,41,38,5
14005,E02005036,2010,56,195000,176000,3,24,26,3,0,56,51,5
14006,E02005036,2011,50,172000,164000,2,12,26,10,0,50,40,10
14007,E02005036,2012,54,195000,178000,1,20,30,3,0,54,51,3
14008,E02005036,2013,58,198000,182000,4,13,38,3,4,54,55,3
14009,E02005036,2014,25,201000,190000,1,3,18,3,0,25,22,3
14010,E02005037,2009,61,295000,250000,11,32,17,1,0,61,60,1
14011,E02005037,2010,97,309000,270000,20,40,32,5,0,97,92,5
14012,E02005037,2011,81,291000,270000,20,27,32,2,0,81,79,2
14013,E02005037,2012,80,316000,274000,22,33,20,5,0,80,75,5
14014,E02005037,2013,124,324000,290000,31,33,53,7,10,114,117,7
14015,E02005037,2014,28,331000,320000,7,12,4,5,0,28,23,5
14016,E02005038,2009,57,250000,222000,13,26,15,3,0,57,54,3
14017,E02005038,2010,56,289000,250000,23,16,14,3,0,56,53,3
14018,E02005038,2011,65,245000,232000,19,28,17,1,0,65,62,3
14019,E02005038,2012,89,334000,250000,36,29,20,4,12,77,84,5
14020,E02005038,2013,76,273000,242000,20,37,16,3,0,76,74,2
14021,E02005038,2014,27,280000,250000,10,9,5,3,0,27,24,3
14022,E02005039,2009,38,184000,181000,3,17,17,1,0,38,37,1
14023,E02005039,2010,64,204000,190000,6,31,24,3,0,64,60,4
14024,E02005039,2011,60,214000,192000,6,35,18,1,0,60,58,2
14025,E02005039,2012,49,201000,193000,2,22,23,2,0,49,47,2
14026,E02005039,2013,87,226000,200000,12,42,30,3,1,86,85,2
14027,E02005039,2014,33,227000,225000,4,19,8,2,0,33,31,2
14028,E02005040,2009,51,314000,298000,23,18,7,3,0,51,48,3
14029,E02005040,2010,72,334000,295000,38,20,12,2,0,72,70,2
14030,E02005040,2011,66,363000,360000,44,12,7,3,0,66,63,3
14031,E02005040,2012,95,343000,325000,52,31,5,7,24,71,88,7
14032,E02005040,2013,130,325000,324000,65,25,12,28,60,70,100,30
14033,E02005040,2014,19,352000,331000,11,1,5,2,1,18,17,2
14034,E02005041,2009,38,267000,244000,15,12,11,0,7,31,36,2
14035,E02005041,2010,44,373000,291000,24,9,8,3,4,40,41,3
14036,E02005041,2011,40,233000,190000,12,18,8,2,1,39,37,3
14037,E02005041,2012,40,257000,202000,11,17,10,2,0,40,38,2
14038,E02005041,2013,53,309000,250000,24,13,15,1,0,53,52,1
14039,E02005041,2014,18,279000,226000,8,6,4,0,0,18,18,0
14040,E02005046,2009,34,140000,119000,1,22,11,0,0,34,34,0
14041,E02005046,2010,34,134000,120000,3,15,14,2,0,34,32,2
14042,E02005046,2011,29,121000,120000,0,13,16,0,0,29,29,0
14043,E02005046,2012,42,131000,125000,1,16,24,1,3,39,41,1
14044,E02005046,2013,36,133000,125000,1,18,16,1,0,36,35,1
14045,E02005046,2014,13,145000,148000,1,5,7,0,0,13,13,0
14046,E02005048,2009,2,330000,330000,1,1,0,0,0,2,2,0
14047,E02005048,2010,3,452000,385000,2,0,1,0,0,3,3,0
14048,E02005048,2011,2,281000,281000,1,1,0,0,0,2,2,0
14049,E02005048,2012,2,432000,432000,2,0,0,0,0,2,2,0
14050,E02005048,2013,4,488000,462000,4,0,0,0,0,4,4,0
14051,E02005055,2009,58,137000,135000,3,11,34,10,3,55,48,10
14052,E02005055,2010,79,141000,138000,4,14,41,20,11,68,57,22
14053,E02005055,2011,67,135000,124000,4,8,38,17,5,62,50,17
14054,E02005055,2012,63,136000,128000,1,8,41,13,0,63,49,14
14055,E02005055,2013,69,144000,137000,2,6,48,13,0,69,56,13
14056,E02005055,2014,34,150000,136000,0,5,20,9,0,34,25,9
14057,E02005056,2009,98,154000,140000,1,16,38,43,10,88,55,43
14058,E02005056,2010,91,148000,136000,4,14,32,41,0,91,48,43
14059,E02005056,2011,73,152000,140000,3,8,27,35,0,73,37,36
14060,E02005056,2012,76,155000,136000,2,12,26,36,2,74,41,35
14061,E02005056,2013,107,158000,147000,5,11,40,51,0,107,57,50
14062,E02005056,2014,47,160000,125000,1,4,13,29,0,47,17,30
14063,E02005057,2009,189,132000,122000,3,27,48,111,79,110,79,110
14064,E02005057,2010,130,149000,135000,9,30,38,53,21,109,78,52
14065,E02005057,2011,86,154000,139000,8,17,43,18,0,86,67,19
14066,E02005057,2012,92,162000,150000,8,20,50,14,0,92,79,13
14067,E02005057,2013,106,167000,158000,10,26,46,24,0,106,82,24
14068,E02005057,2014,51,185000,169000,7,9,30,5,0,51,46,5
14069,E02005058,2009,84,159000,149000,4,6,70,4,22,62,80,4
14070,E02005058,2010,69,151000,145000,4,16,46,3,0,69,66,3
14071,E02005058,2011,75,150000,141000,2,11,60,2,2,73,72,3
14072,E02005058,2012,82,162000,151000,9,8,62,3,1,81,79,3
14073,E02005058,2013,89,163000,158000,8,4,71,6,0,89,83,6
14074,E02005058,2014,42,165000,163000,0,6,34,2,0,42,40,2
14075,E02005059,2009,119,195000,180000,9,32,58,20,0,119,99,20
14076,E02005059,2010,97,211000,195000,10,18,52,17,0,97,79,18
14077,E02005059,2011,110,217000,197000,4,25,55,26,0,110,83,27
14078,E02005059,2012,96,210000,190000,11,19,58,8,0,96,88,8
14079,E02005059,2013,129,217000,200000,15,36,72,6,0,129,123,6
14080,E02005059,2014,49,217000,196000,6,9,27,7,0,49,42,7
14081,E02005060,2009,103,172000,170000,10,36,22,35,21,82,68,35
14082,E02005060,2010,82,194000,183000,5,34,30,13,29,53,69,13
14083,E02005060,2011,91,210000,215000,7,39,39,6,21,70,86,5
14084,E02005060,2012,100,187000,178000,3,35,34,28,39,61,72,28
14085,E02005060,2013,70,192000,180000,9,35,19,7,1,69,63,7
14086,E02005060,2014,30,199000,203000,3,19,6,2,0,30,28,2
14087,E02005061,2009,55,151000,152000,5,35,10,5,0,55,47,8
14088,E02005061,2010,54,162000,165000,2,30,15,7,1,53,46,8
14089,E02005061,2011,52,165000,160000,5,23,19,5,0,52,47,5
14090,E02005061,2012,65,177000,170000,7,33,23,2,0,65,63,2
14091,E02005061,2013,61,173000,171000,4,34,14,9,4,57,52,9
14092,E02005061,2014,40,198000,196000,5,20,12,3,1,39,36,4
14093,E02005062,2009,61,174000,175000,2,30,27,2,0,61,59,2
14094,E02005062,2010,63,180000,184000,1,39,20,3,0,63,60,3
14095,E02005062,2011,75,182000,175000,2,39,28,6,0,75,70,5
14096,E02005062,2012,62,209000,197000,2,37,21,2,0,62,60,2
14097,E02005062,2013,75,196000,197000,0,38,32,5,0,75,70,5
14098,E02005062,2014,26,219000,220000,2,16,7,1,0,26,25,1
14099,E02005063,2009,47,202000,175000,6,18,18,5,6,41,42,5
14100,E02005063,2010,64,231000,186000,16,33,15,0,1,63,64,0
14101,E02005063,2011,54,204000,182000,9,24,16,5,4,50,46,8
14102,E02005063,2012,80,247000,212000,29,21,27,3,9,71,78,2
14103,E02005063,2013,105,232000,200000,23,23,47,12,28,77,93,12
14104,E02005063,2014,29,243000,240000,6,9,10,4,3,26,25,4
14105,E02005064,2009,51,300000,235000,22,18,11,0,0,51,51,0
14106,E02005064,2010,70,341000,242000,31,28,11,0,0,70,70,0
14107,E02005064,2011,86,307000,262000,42,32,12,0,3,83,86,0
14108,E02005064,2012,79,265000,240000,29,33,16,1,3,76,78,1
14109,E02005064,2013,101,338000,275000,43,38,16,4,8,93,97,4
14110,E02005064,2014,28,298000,255000,9,15,4,0,0,28,28,0
14111,E02005065,2009,57,162000,145000,3,19,32,3,0,57,52,5
14112,E02005065,2010,66,169000,154000,4,20,37,5,1,65,60,6
14113,E02005065,2011,105,166000,166000,4,20,71,10,24,81,96,9
14114,E02005065,2012,133,171000,165000,4,27,83,19,65,68,112,21
14115,E02005065,2013,111,175000,170000,4,23,78,6,28,83,100,11
14116,E02005065,2014,31,185000,177000,1,7,21,2,0,31,27,4
14117,E02005066,2009,96,285000,249000,39,51,4,2,1,95,94,2
14118,E02005066,2010,94,292000,268000,31,55,6,2,1,93,92,2
14119,E02005066,2011,80,283000,258000,29,41,7,3,0,80,77,3
14120,E02005066,2012,88,277000,250000,29,47,8,4,0,88,84,4
14121,E02005066,2013,121,304000,272000,44,65,7,5,0,121,116,5
14122,E02005066,2014,39,313000,290000,21,12,4,2,1,38,37,2
14123,E02005067,2009,60,307000,260000,27,16,16,1,5,55,60,0
14124,E02005067,2010,73,371000,342000,45,9,19,0,0,73,73,0
14125,E02005067,2011,64,340000,325000,29,14,20,1,0,64,63,1
14126,E02005067,2012,64,365000,309000,40,4,20,0,1,63,64,0
14127,E02005067,2013,76,358000,305000,43,10,23,0,0,76,76,0
14128,E02005067,2014,29,321000,250000,12,4,13,0,0,29,29,0
14129,E02005068,2009,99,210000,192000,33,29,32,5,6,93,94,5
14130,E02005068,2010,67,249000,200000,26,12,26,3,1,66,65,2
14131,E02005068,2011,79,218000,188000,26,20,30,3,0,79,76,3
14132,E02005068,2012,82,227000,210000,33,18,30,1,1,81,81,1
14133,E02005068,2013,119,252000,196000,41,23,52,3,8,111,116,3
14134,E02005068,2014,48,242000,234000,24,5,16,3,0,48,45,3
14135,E02005069,2009,126,198000,185000,24,46,44,12,5,121,113,13
14136,E02005069,2010,123,238000,225000,30,46,34,13,10,113,108,15
14137,E02005069,2011,124,220000,200000,35,36,33,20,9,115,103,21
14138,E02005069,2012,155,218000,200000,31,49,56,19,9,146,134,21
14139,E02005069,2013,151,230000,215000,31,45,62,13,2,149,138,13
14140,E02005069,2014,38,212000,197000,6,8,17,7,0,38,31,7
14141,E02005070,2009,129,214000,200000,26,76,10,17,12,117,112,17
14142,E02005070,2010,100,236000,226000,24,55,14,7,1,99,93,7
14143,E02005070,2011,121,218000,202000,27,66,25,3,5,116,118,3
14144,E02005070,2012,128,242000,225000,32,77,16,3,2,126,126,2
14145,E02005070,2013,153,245000,225000,44,77,25,7,1,152,146,7
14146,E02005070,2014,48,245000,240000,14,24,8,2,1,47,46,2
14147,E02005071,2009,111,139000,135000,2,15,57,37,9,102,75,36
14148,E02005071,2010,142,148000,140000,2,13,62,65,18,124,76,66
14149,E02005071,2011,155,148000,150000,3,13,70,69,28,127,86,69
14150,E02005071,2012,121,148000,140000,2,14,51,54,21,100,66,55
14151,E02005071,2013,154,147000,141000,2,17,70,65,11,143,88,66
14152,E02005071,2014,88,166000,162000,1,10,47,30,11,77,59,29
14153,E02005072,2009,135,237000,230000,48,46,31,10,6,129,123,12
14154,E02005072,2010,95,274000,250000,41,37,13,4,3,92,90,5
14155,E02005072,2011,102,271000,242000,38,38,19,7,3,99,94,8
14156,E02005072,2012,105,252000,235000,36,40,11,18,4,101,88,17
14157,E02005072,2013,143,277000,250000,55,54,21,13,10,133,129,14
14158,E02005072,2014,33,287000,250000,10,13,8,2,0,33,31,2
14159,E02005073,2009,247,146000,135000,11,29,61,146,119,128,101,146
14160,E02005073,2010,158,181000,158000,8,23,47,80,41,117,77,81
14161,E02005073,2011,205,164000,150000,15,28,50,112,75,130,91,114
14162,E02005073,2012,180,178000,157000,16,21,55,88,48,132,94,86
14163,E02005073,2013,222,175000,150000,17,28,67,110,24,198,112,110
14164,E02005073,2014,94,174000,158000,6,6,35,47,1,93,48,46
14165,E02005074,2009,142,245000,208000,43,72,22,5,0,142,139,3
14166,E02005074,2010,141,270000,230000,44,64,28,5,8,133,134,7
14167,E02005074,2011,142,274000,240000,52,57,25,8,11,131,132,10
14168,E02005074,2012,137,285000,230000,44,55,31,7,4,133,129,8
14169,E02005074,2013,150,268000,236000,41,71,29,9,6,144,140,10
14170,E02005074,2014,52,311000,244000,16,23,13,0,0,52,52,0
14171,E02005075,2009,132,190000,175000,24,37,51,20,14,118,108,24
14172,E02005075,2010,105,214000,208000,17,26,45,17,9,96,86,19
14173,E02005075,2011,129,222000,210000,32,34,48,15,5,124,114,15
14174,E02005075,2012,115,197000,180000,13,31,51,20,5,110,95,20
14175,E02005075,2013,146,208000,205000,18,40,68,20,11,135,126,20
14176,E02005075,2014,65,208000,200000,3,18,27,17,8,57,48,17
14177,E02005076,2009,126,165000,154000,7,40,62,17,21,105,110,16
14178,E02005076,2010,99,174000,156000,5,25,55,14,8,91,85,14
14179,E02005076,2011,95,152000,150000,7,26,45,17,9,86,77,18
14180,E02005076,2012,96,161000,154000,6,23,62,5,0,96,92,4
14181,E02005076,2013,121,174000,171000,6,32,74,9,0,121,112,9
14182,E02005076,2014,75,185000,180000,5,19,45,6,6,69,69,6
14183,E02005077,2009,72,157000,160000,6,33,25,8,13,59,58,14
14184,E02005077,2010,98,184000,175000,9,44,37,8,19,79,76,22
14185,E02005077,2011,79,208000,195000,10,40,19,10,6,73,69,10
14186,E02005077,2012,78,201000,179000,6,38,25,9,17,61,65,13
14187,E02005077,2013,106,197000,181000,9,55,28,14,8,98,87,19
14188,E02005077,2014,29,218000,210000,4,15,3,7,2,27,22,7
14189,E02005078,2009,80,309000,243000,38,22,14,6,0,80,71,9
14190,E02005078,2010,90,346000,260000,48,20,18,4,1,89,84,6
14191,E02005078,2011,87,298000,215000,26,38,17,6,0,87,76,11
14192,E02005078,2012,79,277000,218000,23,25,21,10,4,75,68,11
14193,E02005078,2013,129,302000,265000,54,28,31,16,28,101,112,17
14194,E02005078,2014,48,347000,306000,31,8,8,1,9,39,45,3
14195,E02005079,2009,110,248000,223000,36,40,19,15,19,91,91,19
14196,E02005079,2010,103,239000,221000,27,37,25,14,28,75,89,14
14197,E02005079,2011,134,236000,215000,41,45,41,7,41,93,126,8
14198,E02005079,2012,145,231000,222000,50,50,29,16,45,100,126,19
14199,E02005079,2013,116,244000,220000,37,45,20,14,12,104,102,14
14200,E02005079,2014,43,262000,242000,15,21,4,3,1,42,40,3
14201,E02005080,2009,55,144000,145000,0,23,28,4,6,49,51,4
14202,E02005080,2010,88,164000,159000,5,48,30,5,17,71,80,8
14203,E02005080,2011,117,168000,170000,9,38,64,6,18,99,112,5
14204,E02005080,2012,124,191000,179000,27,47,45,5,43,81,118,6
14205,E02005080,2013,137,178000,170000,15,44,55,23,44,93,113,24
14206,E02005080,2014,33,184000,173000,4,10,16,3,3,30,30,3
14207,E02005081,2009,73,285000,215000,24,21,21,7,0,73,62,11
14208,E02005081,2010,79,311000,250000,22,36,17,4,1,78,73,6
14209,E02005081,2011,58,288000,247000,17,25,12,4,1,57,54,4
14210,E02005081,2012,88,297000,266000,26,30,26,6,5,83,79,9
14211,E02005081,2013,69,287000,250000,21,30,14,4,1,68,65,4
14212,E02005081,2014,35,285000,225000,8,14,9,4,0,35,31,4
14213,E02005082,2009,154,224000,205000,43,46,53,12,61,93,139,15
14214,E02005082,2010,185,230000,205000,51,40,74,20,84,101,164,21
14215,E02005082,2011,125,262000,215000,48,41,27,9,8,117,114,11
14216,E02005082,2012,121,258000,218000,53,33,30,5,8,113,114,7
14217,E02005082,2013,142,246000,217000,51,49,33,9,4,138,133,9
14218,E02005082,2014,72,266000,242000,25,18,23,6,0,72,66,6
14219,E02005083,2009,103,205000,185000,22,42,24,15,31,72,82,21
14220,E02005083,2010,105,242000,210000,28,43,29,5,23,82,100,5
14221,E02005083,2011,122,224000,204000,33,57,27,5,25,97,113,9
14222,E02005083,2012,110,256000,230000,33,49,22,6,26,84,104,6
14223,E02005083,2013,111,273000,240000,44,44,16,7,5,106,102,9
14224,E02005083,2014,33,269000,230000,8,13,9,3,0,33,30,3
14225,E02005084,2009,73,345000,255000,37,23,13,0,5,68,72,1
14226,E02005084,2010,78,351000,295000,35,28,14,1,1,77,77,1
14227,E02005084,2011,78,325000,275000,27,21,17,13,19,59,63,15
14228,E02005084,2012,84,290000,270000,29,21,25,9,27,57,75,9
14229,E02005084,2013,80,318000,254000,34,29,10,7,5,75,73,7
14230,E02005084,2014,26,359000,327000,10,10,5,1,1,25,25,1
14231,E02005085,2009,68,332000,265000,20,18,20,10,9,59,58,10
14232,E02005085,2010,62,349000,278000,18,22,16,6,6,56,56,6
14233,E02005085,2011,78,300000,242000,21,27,27,3,2,76,73,5
14234,E02005085,2012,77,350000,280000,22,29,24,2,0,77,72,5
14235,E02005085,2013,75,365000,275000,25,23,22,5,3,72,67,8
14236,E02005085,2014,23,339000,315000,7,7,5,4,2,21,19,4
14237,E02005086,2009,74,257000,224000,29,22,21,2,3,71,73,1
14238,E02005086,2010,73,244000,212000,13,38,20,2,0,73,71,2
14239,E02005086,2011,63,243000,214000,14,27,21,1,1,62,61,2
14240,E02005086,2012,76,245000,210000,19,27,29,1,2,74,74,2
14241,E02005086,2013,91,263000,230000,22,46,21,2,8,83,88,3
14242,E02005086,2014,34,257000,231000,4,16,13,1,0,34,33,1
14243,E02005087,2009,72,220000,199000,12,34,23,3,0,72,68,4
14244,E02005087,2010,74,220000,206000,11,30,26,7,4,70,67,7
14245,E02005087,2011,81,219000,195000,16,28,15,22,19,62,59,22
14246,E02005087,2012,99,260000,230000,29,39,26,5,0,99,94,5
14247,E02005087,2013,109,248000,230000,19,47,38,5,0,109,105,4
14248,E02005087,2014,29,259000,250000,11,11,5,2,0,29,26,3
14249,E02005088,2009,58,177000,168000,5,27,22,4,0,58,51,7
14250,E02005088,2010,92,171000,172000,6,33,36,17,7,85,69,23
14251,E02005088,2011,94,181000,172000,8,33,35,18,12,82,74,20
14252,E02005088,2012,84,191000,178000,9,31,30,14,4,80,69,15
14253,E02005088,2013,96,172000,174000,2,28,45,21,0,96,74,22
14254,E02005088,2014,34,195000,188000,3,10,18,3,0,34,30,4
14255,E02005089,2009,43,248000,197000,4,21,15,3,0,43,40,3
14256,E02005089,2010,67,228000,204000,9,26,26,6,0,67,60,7
14257,E02005089,2011,73,238000,224000,10,31,25,7,0,73,66,7
14258,E02005089,2012,50,252000,218000,8,19,19,4,0,50,46,4
14259,E02005089,2013,67,255000,225000,11,29,22,5,0,67,62,5
14260,E02005089,2014,24,267000,240000,4,7,8,5,1,23,19,5
14261,E02005090,2009,48,400000,370000,32,12,4,0,3,45,47,1
14262,E02005090,2010,64,382000,360000,39,16,7,2,1,63,62,2
14263,E02005090,2011,62,369000,333000,36,18,7,1,1,61,62,0
14264,E02005090,2012,60,410000,384000,42,12,6,0,0,60,60,0
14265,E02005090,2013,74,341000,332000,33,21,18,2,3,71,72,2
14266,E02005090,2014,24,398000,403000,15,7,2,0,0,24,24,0
14267,E02005091,2009,162,225000,174000,18,16,25,103,88,74,58,104
14268,E02005091,2010,156,218000,179000,18,16,35,87,80,76,67,89
14269,E02005091,2011,94,264000,210000,23,14,30,27,9,85,63,31
14270,E02005091,2012,76,324000,239000,19,15,20,22,4,72,51,25
14271,E02005091,2013,136,277000,228000,27,24,42,43,2,134,89,47
14272,E02005091,2014,46,315000,226000,10,6,13,17,2,44,28,18
14273,E02005093,2009,46,292000,232000,17,21,7,1,2,44,45,1
14274,E02005093,2010,68,343000,247000,27,29,9,3,0,68,65,3
14275,E02005093,2011,62,301000,258000,29,26,7,0,1,61,61,1
14276,E02005093,2012,52,321000,263000,25,19,8,0,0,52,52,0
14277,E02005093,2013,76,340000,284000,42,23,9,2,0,76,74,2
14278,E02005093,2014,26,358000,308000,14,6,5,1,1,25,25,1
14279,E02005094,2009,121,326000,267000,37,30,38,16,12,109,102,19
14280,E02005094,2010,117,425000,315000,38,38,29,12,10,107,104,13
14281,E02005094,2011,123,426000,315000,53,27,26,17,9,114,105,18
14282,E02005094,2012,104,384000,344000,37,25,33,9,5,99,95,9
14283,E02005094,2013,180,380000,305000,47,29,69,35,39,141,144,36
14284,E02005094,2014,46,416000,372000,18,15,10,3,0,46,42,4
14285,E02005095,2009,114,452000,384000,55,36,17,6,20,94,103,11
14286,E02005095,2010,117,466000,395000,65,34,16,2,11,106,111,6
14287,E02005095,2011,76,425000,321000,33,24,19,0,7,69,74,2
14288,E02005095,2012,104,471000,374000,51,38,14,1,7,97,102,2
14289,E02005095,2013,110,420000,373000,40,50,16,4,2,108,106,4
14290,E02005095,2014,32,562000,414000,14,15,3,0,0,32,32,0
14291,E02005096,2009,125,328000,260000,26,47,36,16,5,120,108,17
14292,E02005096,2010,160,355000,271000,30,64,45,21,0,160,136,24
14293,E02005096,2011,153,360000,250000,30,41,53,29,3,150,122,31
14294,E02005096,2012,115,366000,280000,25,43,26,21,1,114,93,22
14295,E02005096,2013,148,394000,314000,31,49,56,12,4,144,132,16
14296,E02005096,2014,51,372000,313000,7,18,19,7,0,51,44,7
14297,E02005097,2009,111,593000,500000,74,17,16,4,5,106,105,6
14298,E02005097,2010,136,640000,500000,84,36,8,8,0,136,128,8
14299,E02005097,2011,137,654000,492000,88,22,20,7,7,130,129,8
14300,E02005097,2012,132,635000,500000,78,36,14,4,5,127,128,4
14301,E02005097,2013,129,738000,601000,80,24,21,4,5,124,125,4
14302,E02005097,2014,45,691000,720000,27,11,6,1,0,45,43,2
14303,E02005098,2009,146,592000,415000,74,16,15,41,22,124,102,44
14304,E02005098,2010,138,620000,432000,66,20,18,34,2,136,103,35
14305,E02005098,2011,160,714000,548000,74,25,33,28,18,142,129,31
14306,E02005098,2012,138,651000,496000,47,17,25,49,12,126,89,49
14307,E02005098,2013,151,712000,565000,65,21,25,40,11,140,111,40
14308,E02005098,2014,49,636000,485000,21,6,8,14,0,49,33,16
14309,E02005099,2009,112,463000,325000,41,29,30,12,23,89,98,14
14310,E02005099,2010,108,490000,375000,41,27,35,5,6,102,101,7
14311,E02005099,2011,95,461000,310000,28,35,24,8,2,93,86,9
14312,E02005099,2012,104,506000,356000,41,31,28,4,0,104,98,6
14313,E02005099,2013,125,486000,349000,44,32,40,9,16,109,116,9
14314,E02005099,2014,29,375000,325000,5,6,14,4,1,28,24,5
14315,E02005100,2009,98,221000,200000,14,28,43,13,18,80,83,15
14316,E02005100,2010,119,283000,218000,29,24,47,19,9,110,96,23
14317,E02005100,2011,109,282000,245000,28,30,37,14,8,101,92,17
14318,E02005100,2012,106,272000,248000,28,21,45,12,7,99,93,13
14319,E02005100,2013,165,262000,240000,36,33,65,31,22,143,133,32
14320,E02005100,2014,49,263000,218000,9,9,20,11,2,47,38,11
14321,E02005101,2009,60,470000,411000,33,13,10,4,1,59,55,5
14322,E02005101,2010,72,585000,546000,40,10,9,13,8,64,59,13
14323,E02005101,2011,76,568000,518000,31,17,16,12,9,67,64,12
14324,E02005101,2012,66,488000,430000,23,19,9,15,6,60,50,16
14325,E02005101,2013,62,536000,458000,29,9,15,9,5,57,53,9
14326,E02005101,2014,28,582000,375000,5,9,13,1,3,25,27,1
14327,E02005102,2009,67,250000,220000,35,17,9,6,1,66,60,7
14328,E02005102,2010,75,304000,257000,38,26,7,4,0,75,68,7
14329,E02005102,2011,77,258000,226000,39,28,7,3,0,77,74,3
14330,E02005102,2012,77,301000,248000,44,21,9,3,5,72,74,3
14331,E02005102,2013,89,296000,240000,44,28,11,6,1,88,83,6
14332,E02005102,2014,26,233000,240000,11,12,1,2,0,26,24,2
14333,E02005103,2009,17,159000,135000,1,11,4,1,0,17,16,1
14334,E02005103,2010,15,206000,151000,6,6,1,2,5,10,12,3
14335,E02005103,2011,35,209000,195000,17,12,6,0,17,18,35,0
14336,E02005103,2012,24,192000,165000,9,10,3,2,11,13,22,2
14337,E02005103,2013,46,172000,158000,4,28,11,3,16,30,43,3
14338,E02005103,2014,18,176000,158000,2,9,6,1,6,12,17,1
14339,E02005106,2009,21,171000,169000,4,11,6,0,0,21,21,0
14340,E02005106,2010,23,175000,180000,4,12,6,1,0,23,23,0
14341,E02005106,2011,21,159000,160000,1,15,5,0,0,21,21,0
14342,E02005106,2012,20,168000,156000,2,9,9,0,0,20,20,0
14343,E02005106,2013,31,185000,176000,4,23,4,0,5,26,31,0
14344,E02005106,2014,4,184000,169000,1,2,1,0,0,4,4,0
14345,E02005109,2009,106,306000,254000,49,28,11,18,12,94,87,19
14346,E02005109,2010,128,306000,265000,64,30,6,28,18,110,101,27
14347,E02005109,2011,100,304000,264000,50,32,4,14,3,97,85,15
14348,E02005109,2012,130,289000,250000,67,23,24,16,4,126,110,20
14349,E02005109,2013,169,305000,280000,80,34,14,41,17,152,127,42
14350,E02005109,2014,43,352000,260000,23,7,5,8,2,41,34,9
14351,E02005110,2009,98,218000,190000,58,36,4,0,2,96,98,0
14352,E02005110,2010,92,239000,215000,49,37,5,1,0,92,91,1
14353,E02005110,2011,87,219000,200000,51,30,6,0,0,87,87,0
14354,E02005110,2012,92,258000,239000,60,22,9,1,0,92,91,1
14355,E02005110,2013,111,262000,230000,67,37,7,0,0,111,111,0
14356,E02005110,2014,31,240000,225000,16,13,2,0,0,31,29,2
14357,E02005111,2009,121,191000,172000,18,45,36,22,1,120,98,23
14358,E02005111,2010,127,192000,185000,12,33,41,41,3,124,87,40
14359,E02005111,2011,121,195000,180000,17,28,41,35,0,121,86,35
14360,E02005111,2012,129,210000,190000,17,26,44,42,5,124,87,42
14361,E02005111,2013,151,191000,175000,21,38,58,34,1,150,116,35
14362,E02005111,2014,54,198000,187000,5,8,26,15,2,52,38,16
14363,E02005112,2009,106,184000,162000,42,50,11,3,0,106,104,2
14364,E02005112,2010,80,211000,180000,28,44,6,2,0,80,78,2
14365,E02005112,2011,85,207000,173000,36,39,7,3,0,85,81,4
14366,E02005112,2012,87,197000,170000,39,42,5,1,0,87,86,1
14367,E02005112,2013,111,198000,170000,38,57,10,6,1,110,105,6
14368,E02005112,2014,42,190000,176000,18,15,9,0,4,38,42,0
14369,E02005113,2009,129,193000,185000,63,29,16,21,0,129,108,21
14370,E02005113,2010,104,222000,210000,54,30,11,9,2,102,95,9
14371,E02005113,2011,112,203000,194000,60,22,16,14,5,107,95,17
14372,E02005113,2012,101,212000,193000,58,19,14,10,2,99,88,13
14373,E02005113,2013,148,221000,210000,72,27,31,18,3,145,130,18
14374,E02005113,2014,47,208000,192000,21,12,9,5,0,47,42,5
14375,E02005114,2009,71,169000,165000,27,33,11,0,0,71,71,0
14376,E02005114,2010,78,174000,163000,33,31,12,2,1,77,76,2
14377,E02005114,2011,85,171000,160000,36,35,12,2,0,85,84,1
14378,E02005114,2012,72,162000,155000,23,34,15,0,0,72,71,1
14379,E02005114,2013,98,174000,168000,38,37,22,1,0,98,97,1
14380,E02005114,2014,27,188000,161000,9,11,6,1,0,27,27,0
14381,E02005115,2009,54,97000,92000,0,9,42,3,0,54,52,2
14382,E02005115,2010,62,106000,100000,5,1,52,4,1,61,58,4
14383,E02005115,2011,54,97000,92000,1,10,36,7,1,53,48,6
14384,E02005115,2012,63,106000,98000,2,7,52,2,2,61,61,2
14385,E02005115,2013,75,108000,100000,1,11,57,6,3,72,69,6
14386,E02005115,2014,34,130000,124000,3,4,23,4,3,31,31,3
14387,E02005116,2009,41,101000,107000,0,17,16,8,2,39,32,9
14388,E02005116,2010,47,105000,103000,2,15,23,7,0,47,41,6
14389,E02005116,2011,43,103000,100000,1,14,22,6,0,43,37,6
14390,E02005116,2012,44,124000,112000,0,17,25,2,0,44,42,2
14391,E02005116,2013,61,111000,115000,2,18,31,10,0,61,51,10
14392,E02005116,2014,23,131000,125000,1,8,14,0,0,23,23,0
14393,E02005117,2009,56,173000,162000,25,19,10,2,11,45,53,3
14394,E02005117,2010,85,185000,180000,45,28,9,3,21,64,81,4
14395,E02005117,2011,81,181000,166000,48,27,6,0,9,72,79,2
14396,E02005117,2012,94,180000,170000,54,26,9,5,16,78,89,5
14397,E02005117,2013,102,185000,182000,54,29,7,12,11,91,91,11
14398,E02005117,2014,43,206000,200000,25,14,4,0,0,43,43,0
14399,E02005118,2009,198,156000,155000,34,86,72,6,97,101,190,8
14400,E02005118,2010,168,164000,164000,34,52,76,6,83,85,160,8
14401,E02005118,2011,153,155000,155000,49,38,53,13,52,101,138,15
14402,E02005118,2012,131,146000,136000,42,31,36,22,37,94,111,20
14403,E02005118,2013,128,158000,150000,30,42,48,8,17,111,119,9
14404,E02005118,2014,54,172000,172000,17,7,21,9,14,40,45,9
14405,E02005119,2009,53,148000,132000,18,22,13,0,2,51,53,0
14406,E02005119,2010,52,148000,134000,12,20,19,1,8,44,52,0
14407,E02005119,2011,64,150000,135000,20,26,17,1,5,59,63,1
14408,E02005119,2012,67,160000,145000,21,25,20,1,7,60,66,1
14409,E02005119,2013,82,147000,132000,18,30,33,1,9,73,81,1
14410,E02005119,2014,25,161000,150000,3,11,10,1,7,18,24,1
14411,E02005120,2009,83,162000,136000,42,22,17,2,5,78,82,1
14412,E02005120,2010,94,175000,136000,45,25,21,3,1,93,91,3
14413,E02005120,2011,93,179000,155000,58,15,17,3,4,89,89,4
14414,E02005120,2012,92,178000,140000,46,21,22,3,7,85,89,3
14415,E02005120,2013,109,175000,150000,62,27,16,4,7,102,105,4
14416,E02005120,2014,41,175000,165000,24,8,9,0,3,38,40,1
14417,E02005121,2009,143,163000,155000,39,53,41,10,5,138,132,11
14418,E02005121,2010,148,169000,156000,40,43,51,14,12,136,134,14
14419,E02005121,2011,161,173000,166000,49,47,52,13,15,146,149,12
14420,E02005121,2012,199,169000,164000,57,59,74,9,14,185,187,12
14421,E02005121,2013,202,190000,180000,66,71,55,10,46,156,192,10
14422,E02005121,2014,61,177000,170000,16,21,21,3,5,56,59,2
14423,E02005122,2009,68,221000,184000,17,30,20,1,0,68,66,2
14424,E02005122,2010,75,223000,185000,24,24,25,2,0,75,73,2
14425,E02005122,2011,48,215000,182000,12,21,15,0,1,47,48,0
14426,E02005122,2012,80,226000,200000,33,20,24,3,0,80,77,3
14427,E02005122,2013,102,262000,239000,46,26,27,3,11,91,98,4
14428,E02005122,2014,38,233000,182000,10,8,20,0,0,38,38,0
14429,E02005123,2009,113,180000,158000,32,43,28,10,3,110,101,12
14430,E02005123,2010,162,182000,160000,43,52,47,20,12,150,139,23
14431,E02005123,2011,116,195000,154000,36,30,43,7,5,111,108,8
14432,E02005123,2012,163,176000,168000,39,59,48,17,22,141,143,20
14433,E02005123,2013,190,199000,174000,61,58,59,12,15,175,178,12
14434,E02005123,2014,82,206000,185000,24,18,38,2,16,66,80,2
14435,E02005124,2009,78,122000,116000,2,19,47,10,1,77,68,10
14436,E02005124,2010,81,120000,118000,5,20,31,25,0,81,56,25
14437,E02005124,2011,87,111000,110000,1,11,44,31,0,87,55,32
14438,E02005124,2012,83,118000,118000,1,14,46,22,0,83,61,22
14439,E02005124,2013,124,124000,120000,5,14,72,33,1,123,92,32
14440,E02005124,2014,29,134000,125000,3,3,12,11,0,29,18,11
14441,E02005125,2009,79,136000,135000,7,20,49,3,18,61,76,3
14442,E02005125,2010,112,139000,132000,7,28,57,20,46,66,91,21
14443,E02005125,2011,136,146000,143000,9,25,86,16,53,83,119,17
14444,E02005125,2012,122,142000,140000,9,32,73,8,43,79,114,8
14445,E02005125,2013,144,150000,145000,11,32,83,18,45,99,127,17
14446,E02005125,2014,31,155000,148000,2,7,21,1,0,31,30,1
14447,E02005126,2009,96,174000,160000,14,58,20,4,0,96,92,4
14448,E02005126,2010,90,177000,170000,11,55,22,2,0,90,87,3
14449,E02005126,2011,103,171000,165000,11,63,26,3,0,103,99,4
14450,E02005126,2012,86,178000,168000,18,43,24,1,0,86,85,1
14451,E02005126,2013,111,183000,175000,15,56,37,3,0,111,108,3
14452,E02005126,2014,50,186000,179000,5,30,15,0,0,50,50,0
14453,E02005127,2009,121,219000,205000,39,51,19,12,19,102,109,12
14454,E02005127,2010,131,239000,215000,46,39,25,21,24,107,110,21
14455,E02005127,2011,126,255000,212000,41,40,39,6,10,116,120,6
14456,E02005127,2012,98,249000,222000,45,32,17,4,3,95,96,2
14457,E02005127,2013,103,250000,228000,41,38,17,7,0,103,96,7
14458,E02005127,2014,48,235000,218000,16,16,9,7,0,48,41,7
14459,E02005128,2009,125,167000,160000,16,57,43,9,6,119,116,9
14460,E02005128,2010,112,187000,174000,15,39,46,12,7,105,100,12
14461,E02005128,2011,112,180000,158000,14,33,58,7,1,111,103,9
14462,E02005128,2012,100,189000,169000,18,36,39,7,0,100,93,7
14463,E02005128,2013,142,208000,193000,18,41,74,9,24,118,133,9
14464,E02005128,2014,44,227000,209000,9,13,19,3,4,40,42,2
14465,E02005129,2009,308,158000,146000,9,45,140,114,161,147,193,115
14466,E02005129,2010,156,183000,158000,12,23,83,38,17,139,119,37
14467,E02005129,2011,155,186000,165000,6,30,94,25,9,146,131,24
14468,E02005129,2012,185,184000,161000,12,28,99,46,12,173,141,44
14469,E02005129,2013,230,198000,172000,14,33,116,67,12,218,160,70
14470,E02005129,2014,77,196000,175000,4,8,36,29,5,72,49,28
14471,E02005130,2009,67,255000,165000,22,16,23,6,0,67,60,7
14472,E02005130,2010,87,251000,188000,27,24,27,9,9,78,77,10
14473,E02005130,2011,75,227000,165000,15,26,31,3,3,72,70,5
14474,E02005130,2012,89,257000,190000,27,26,36,0,4,85,88,1
14475,E02005130,2013,72,282000,190000,23,18,26,5,0,72,67,5
14476,E02005130,2014,47,267000,208000,13,12,20,2,0,47,45,2
14477,E02005131,2009,56,308000,228000,24,19,9,4,7,49,52,4
14478,E02005131,2010,72,278000,224000,28,21,20,3,6,66,68,4
14479,E02005131,2011,66,285000,230000,27,24,13,2,4,62,64,2
14480,E02005131,2012,68,284000,232000,21,27,14,6,8,60,62,6
14481,E02005131,2013,76,320000,250000,30,24,19,3,5,71,72,4
14482,E02005131,2014,29,286000,240000,8,7,13,1,0,29,29,0
14483,E02005139,2009,29,183000,175000,10,4,8,7,2,27,20,9
14484,E02005139,2010,25,207000,200000,10,5,3,7,0,25,17,8
14485,E02005139,2011,35,233000,205000,16,3,3,13,0,35,22,13
14486,E02005139,2012,29,243000,230000,17,2,1,9,0,29,20,9
14487,E02005139,2013,31,217000,183000,13,4,3,11,0,31,20,11
14488,E02005139,2014,5,296000,280000,2,1,1,1,0,5,4,1
14489,E02005145,2009,14,198000,153000,4,7,1,2,0,14,11,3
14490,E02005145,2010,17,229000,200000,5,8,2,2,0,17,15,2
14491,E02005145,2011,11,192000,175000,2,7,1,1,0,11,10,1
14492,E02005145,2012,14,197000,172000,3,4,4,3,0,14,11,3
14493,E02005145,2013,13,330000,318000,7,5,1,0,0,13,13,0
14494,E02005145,2014,3,384000,345000,2,1,0,0,0,3,3,0
14495,E02005149,2009,122,187000,172000,28,33,58,3,3,119,119,3
14496,E02005149,2010,122,213000,194000,21,45,52,4,1,121,117,5
14497,E02005149,2011,103,217000,185000,28,31,42,2,1,102,101,2
14498,E02005149,2012,138,201000,187000,27,42,65,4,1,137,134,4
14499,E02005149,2013,173,209000,196000,40,54,73,6,5,168,168,5
14500,E02005149,2014,77,214000,182000,15,18,41,3,2,75,75,2
14501,E02005150,2009,142,167000,159000,8,48,70,16,34,108,125,17
14502,E02005150,2010,141,172000,165000,8,40,76,17,32,109,121,20
14503,E02005150,2011,167,174000,169000,13,47,89,18,29,138,147,20
14504,E02005150,2012,143,176000,165000,15,39,71,18,24,119,124,19
14505,E02005150,2013,174,198000,170000,24,51,80,19,34,140,155,19
14506,E02005150,2014,62,183000,178000,6,21,32,3,0,62,59,3
14507,E02005151,2009,128,188000,166000,21,41,54,12,0,128,116,12
14508,E02005151,2010,155,216000,205000,36,61,50,8,0,155,146,9
14509,E02005151,2011,160,202000,186000,24,72,45,19,0,160,139,21
14510,E02005151,2012,201,208000,198000,36,68,74,23,25,176,178,23
14511,E02005151,2013,176,209000,200000,38,51,78,9,3,173,163,13
14512,E02005151,2014,74,230000,225000,24,17,27,6,2,72,68,6
14513,E02005153,2009,96,193000,190000,7,57,29,3,21,75,93,3
14514,E02005153,2010,83,217000,205000,9,40,28,6,21,62,75,8
14515,E02005153,2011,85,239000,210000,14,55,14,2,1,84,83,2
14516,E02005153,2012,90,219000,205000,12,63,10,5,0,90,85,5
14517,E02005153,2013,105,229000,210000,17,57,25,6,1,104,98,7
14518,E02005153,2014,51,249000,225000,15,16,16,4,0,51,47,4
14519,E02005154,2009,125,363000,245000,45,33,33,14,18,107,111,14
14520,E02005154,2010,161,453000,305000,65,39,50,7,1,160,153,8
14521,E02005154,2011,138,414000,296000,51,47,27,13,2,136,125,13
14522,E02005154,2012,140,411000,285000,52,48,29,11,0,140,126,14
14523,E02005154,2013,203,446000,335000,87,50,53,13,9,194,190,13
14524,E02005154,2014,63,481000,300000,23,14,22,4,3,60,59,4
14525,E02005155,2009,211,307000,280000,90,40,58,23,88,123,182,29
14526,E02005155,2010,235,341000,320000,101,67,48,19,92,143,214,21
14527,E02005155,2011,180,370000,320000,94,39,24,23,38,142,156,24
14528,E02005155,2012,216,355000,325000,108,52,43,13,51,165,204,12
14529,E02005155,2013,329,333000,300000,117,85,107,20,137,192,307,22
14530,E02005155,2014,74,355000,344000,31,19,17,7,6,68,67,7
14531,E02005156,2009,85,262000,220000,27,29,23,6,10,75,76,9
14532,E02005156,2010,67,313000,260000,24,22,16,5,4,63,63,4
14533,E02005156,2011,95,333000,242000,31,32,23,9,1,94,83,12
14534,E02005156,2012,71,299000,243000,24,25,14,8,4,67,63,8
14535,E02005156,2013,108,293000,244000,27,43,30,8,0,108,99,9
14536,E02005156,2014,33,278000,241000,11,8,12,2,1,32,31,2
14537,E02005157,2009,54,235000,230000,12,30,12,0,0,54,53,1
14538,E02005157,2010,45,325000,240000,9,28,7,1,0,45,42,3
14539,E02005157,2011,56,284000,240000,17,31,7,1,0,56,54,2
14540,E02005157,2012,51,313000,280000,13,28,7,3,2,49,48,3
14541,E02005157,2013,59,360000,280000,12,34,11,2,2,57,57,2
14542,E02005157,2014,25,311000,280000,5,15,4,1,0,25,23,2
14543,E02005158,2009,81,314000,250000,38,30,5,8,1,80,73,8
14544,E02005158,2010,93,404000,340000,44,35,11,3,6,87,90,3
14545,E02005158,2011,93,462000,305000,32,43,8,10,11,82,84,9
14546,E02005158,2012,100,423000,329000,40,45,13,2,10,90,98,2
14547,E02005158,2013,108,398000,326000,43,43,11,11,0,108,97,11
14548,E02005158,2014,34,369000,350000,13,14,3,4,1,33,30,4
14549,E02005159,2009,81,299000,263000,31,48,2,0,0,81,81,0
14550,E02005159,2010,87,314000,270000,28,46,10,3,5,82,81,6
14551,E02005159,2011,75,306000,288000,26,42,4,3,5,70,69,6
14552,E02005159,2012,89,346000,315000,38,43,7,1,0,89,88,1
14553,E02005159,2013,110,329000,291000,39,65,5,1,0,110,107,3
14554,E02005159,2014,21,483000,415000,10,10,1,0,0,21,21,0
14555,E02005160,2009,166,228000,195000,21,37,38,70,35,131,94,72
14556,E02005160,2010,197,256000,210000,26,53,40,78,40,157,119,78
14557,E02005160,2011,193,245000,197000,19,45,48,81,21,172,109,84
14558,E02005160,2012,171,256000,208000,20,36,39,76,4,167,95,76
14559,E02005160,2013,255,255000,215000,23,38,57,137,11,244,114,141
14560,E02005160,2014,78,280000,247000,6,23,15,34,6,72,45,33
14561,E02005161,2009,109,227000,198000,13,39,36,21,10,99,85,24
14562,E02005161,2010,126,251000,220000,14,52,50,10,10,116,114,12
14563,E02005161,2011,130,267000,229000,15,58,45,12,5,125,118,12
14564,E02005161,2012,120,253000,232000,16,49,40,15,0,120,103,17
14565,E02005161,2013,167,263000,240000,22,43,74,28,42,125,138,29
14566,E02005161,2014,75,310000,270000,12,25,25,13,19,56,62,13
14567,E02005162,2009,80,236000,215000,17,35,21,7,2,78,73,7
14568,E02005162,2010,116,259000,229000,30,38,38,10,6,110,105,11
14569,E02005162,2011,137,238000,222000,34,60,34,9,2,135,128,9
14570,E02005162,2012,117,264000,235000,42,33,36,6,0,117,111,6
14571,E02005162,2013,108,279000,242000,34,37,26,11,1,107,97,11
14572,E02005162,2014,44,297000,250000,12,16,15,1,0,44,43,1
14573,E02005163,2009,110,290000,243000,26,38,41,5,0,110,104,6
14574,E02005163,2010,132,279000,224000,28,51,35,18,3,129,114,18
14575,E02005163,2011,118,284000,239000,24,38,43,13,2,116,104,14
14576,E02005163,2012,104,330000,250000,29,43,19,13,2,102,91,13
14577,E02005163,2013,143,358000,277000,38,50,37,18,0,143,125,18
14578,E02005163,2014,48,290000,242000,9,12,19,8,0,48,40,8
14579,E02005164,2009,80,210000,175000,9,35,25,11,0,80,68,12
14580,E02005164,2010,103,253000,195000,23,40,23,17,0,103,86,17
14581,E02005164,2011,123,258000,205000,23,51,28,21,0,123,100,23
14582,E02005164,2012,109,237000,205000,18,48,24,19,0,109,89,20
14583,E02005164,2013,121,260000,215000,23,44,33,21,0,121,98,23
14584,E02005164,2014,49,262000,222000,7,17,13,12,0,49,36,13
14585,E02005165,2009,91,306000,270000,42,26,15,8,6,85,83,8
14586,E02005165,2010,98,347000,276000,39,38,15,6,1,97,92,6
14587,E02005165,2011,82,343000,286000,36,34,9,3,0,82,80,2
14588,E02005165,2012,99,331000,280000,40,31,20,8,0,99,91,8
14589,E02005165,2013,100,339000,300000,46,31,15,8,1,99,92,8
14590,E02005165,2014,26,344000,296000,11,7,6,2,0,26,24,2
14591,E02005166,2009,54,213000,168000,10,18,17,9,1,53,44,10
14592,E02005166,2010,67,227000,180000,11,21,18,17,0,67,48,19
14593,E02005166,2011,70,203000,179000,8,20,22,20,3,67,49,21
14594,E02005166,2012,52,222000,190000,5,10,20,17,0,52,35,17
14595,E02005166,2013,79,246000,200000,10,23,29,17,0,79,60,19
14596,E02005166,2014,29,248000,225000,3,6,10,10,0,29,19,10
14597,E02005167,2009,93,455000,330000,43,27,17,6,5,88,85,8
14598,E02005167,2010,97,485000,390000,41,30,18,8,11,86,87,10
14599,E02005167,2011,108,469000,395000,52,29,24,3,3,105,103,5
14600,E02005167,2012,90,498000,442000,48,29,10,3,1,89,87,3
14601,E02005167,2013,120,499000,385000,53,38,25,4,1,119,115,5
14602,E02005167,2014,37,491000,415000,17,11,7,2,0,37,35,2
14603,E02005168,2009,144,288000,242000,25,41,16,62,31,113,83,61
14604,E02005168,2010,149,343000,260000,25,55,21,48,4,145,100,49
14605,E02005168,2011,143,315000,269000,25,56,20,42,4,139,102,41
14606,E02005168,2012,137,361000,296000,21,51,18,47,1,136,90,47
14607,E02005168,2013,150,376000,290000,21,53,25,51,9,141,102,48
14608,E02005168,2014,65,336000,265000,11,17,10,27,0,65,38,27
14609,E02005169,2009,174,233000,167000,9,14,35,116,38,136,58,116
14610,E02005169,2010,198,281000,190000,16,16,34,132,22,176,66,132
14611,E02005169,2011,216,246000,182000,16,16,39,145,69,147,66,150
14612,E02005169,2012,177,267000,190000,7,19,37,114,3,174,58,119
14613,E02005169,2013,205,241000,190000,8,19,36,142,5,200,61,144
14614,E02005169,2014,86,270000,220000,3,10,15,58,0,86,28,58
14615,E02005170,2009,180,274000,196000,26,38,34,82,17,163,97,83
14616,E02005170,2010,187,351000,270000,28,61,59,39,1,186,145,42
14617,E02005170,2011,190,310000,250000,31,50,45,64,22,168,124,66
14618,E02005170,2012,191,329000,270000,26,65,46,54,17,174,135,56
14619,E02005170,2013,199,337000,250000,30,45,51,73,2,197,126,73
14620,E02005170,2014,62,314000,250000,8,17,13,24,0,62,37,25
14621,E02005171,2009,63,309000,178000,11,12,19,21,0,63,41,22
14622,E02005171,2010,76,318000,192000,9,15,29,23,2,74,50,26
14623,E02005171,2011,113,280000,196000,13,24,48,28,25,88,86,27
14624,E02005171,2012,91,244000,209000,9,15,41,26,9,82,65,26
14625,E02005171,2013,94,262000,214000,9,20,36,29,4,90,65,29
14626,E02005171,2014,36,210000,208000,0,12,15,9,3,33,26,10
14627,E02005172,2009,59,447000,386000,28,19,10,2,0,59,57,2
14628,E02005172,2010,98,416000,340000,37,36,20,5,5,93,91,7
14629,E02005172,2011,85,483000,409000,40,25,17,3,2,83,82,3
14630,E02005172,2012,107,437000,360000,51,29,20,7,0,107,101,6
14631,E02005172,2013,92,450000,359000,37,27,21,7,0,92,83,9
14632,E02005172,2014,32,514000,450000,16,11,4,1,0,32,31,1
14633,E02005173,2009,158,370000,315000,56,21,35,46,8,150,114,44
14634,E02005173,2010,158,444000,391000,55,23,39,41,7,151,116,42
14635,E02005173,2011,156,452000,362000,59,22,25,50,2,154,105,51
14636,E02005173,2012,164,447000,384000,50,22,42,50,2,162,113,51
14637,E02005173,2013,190,436000,360000,62,23,36,69,0,190,117,73
14638,E02005173,2014,53,491000,358000,17,5,7,24,1,52,29,24
14639,E02005174,2009,68,323000,250000,24,27,16,1,0,68,67,1
14640,E02005174,2010,67,338000,250000,26,24,15,2,0,67,65,2
14641,E02005174,2011,70,314000,252000,25,24,17,4,0,70,64,6
14642,E02005174,2012,80,328000,265000,27,24,21,8,0,80,72,8
14643,E02005174,2013,92,410000,303000,44,19,25,4,2,90,88,4
14644,E02005174,2014,31,335000,285000,12,11,8,0,0,31,31,0
14645,E02005175,2009,109,308000,250000,45,30,24,10,1,108,99,10
14646,E02005175,2010,96,370000,286000,36,28,27,5,2,94,91,5
14647,E02005175,2011,104,364000,250000,47,23,27,7,0,104,97,7
14648,E02005175,2012,79,354000,270000,35,21,19,4,2,77,75,4
14649,E02005175,2013,89,335000,250000,30,25,26,8,0,89,81,8
14650,E02005175,2014,43,353000,241000,10,11,16,6,0,43,38,5
14651,E02005623,2009,50,191000,175000,20,13,11,6,5,45,42,8
14652,E02005623,2010,44,220000,184000,18,19,4,3,1,43,40,4
14653,E02005623,2011,52,220000,184000,26,20,5,1,1,51,49,3
14654,E02005623,2012,50,204000,169000,16,19,12,3,0,50,46,4
14655,E02005623,2013,60,234000,210000,23,21,12,4,3,57,53,7
14656,E02005623,2014,26,299000,255000,16,7,2,1,5,21,25,1
14657,E02005632,2009,53,202000,175000,31,17,5,0,0,53,53,0
14658,E02005632,2010,50,239000,222000,28,16,6,0,3,47,50,0
14659,E02005632,2011,39,242000,200000,26,9,4,0,0,39,39,0
14660,E02005632,2012,58,217000,204000,35,12,11,0,0,58,58,0
14661,E02005632,2013,66,212000,192000,32,21,13,0,0,66,65,1
14662,E02005632,2014,20,230000,205000,8,7,5,0,0,20,20,0
14663,E02005633,2009,109,147000,136000,47,45,16,1,13,96,107,2
14664,E02005633,2010,88,138000,125000,24,42,22,0,1,87,88,0
14665,E02005633,2011,116,149000,132000,47,49,19,1,0,116,115,1
14666,E02005633,2012,125,144000,128000,50,48,27,0,2,123,125,0
14667,E02005633,2013,145,145000,130000,56,58,25,6,1,144,139,6
14668,E02005633,2014,53,144000,126000,11,26,15,1,0,53,52,1
14669,E02005634,2009,78,127000,118000,26,31,19,2,0,78,76,2
14670,E02005634,2010,80,131000,119000,29,25,23,3,0,80,78,2
14671,E02005634,2011,119,136000,125000,42,45,29,3,11,108,118,1
14672,E02005634,2012,156,136000,135000,44,50,51,11,54,102,147,9
14673,E02005634,2013,165,144000,139000,50,50,55,10,51,114,155,10
14674,E02005634,2014,53,153000,146000,24,11,11,7,12,41,47,6
14675,E02005635,2009,124,151000,136000,46,42,26,10,3,121,115,9
14676,E02005635,2010,133,152000,140000,44,46,34,9,6,127,125,8
14677,E02005635,2011,131,173000,160000,46,37,45,3,15,116,127,4
14678,E02005635,2012,152,168000,152000,66,40,32,14,19,133,139,13
14679,E02005635,2013,164,170000,148000,57,51,52,4,5,159,160,4
14680,E02005635,2014,49,189000,170000,24,14,11,0,0,49,49,0
14681,E02005636,2009,148,142000,135000,51,56,37,4,28,120,144,4
14682,E02005636,2010,155,149000,131000,43,65,36,11,15,140,146,9
14683,E02005636,2011,199,148000,144000,63,57,65,14,60,139,185,14
14684,E02005636,2012,198,148000,134000,67,60,60,11,58,140,187,11
14685,E02005636,2013,192,155000,138000,56,63,62,11,47,145,181,11
14686,E02005636,2014,89,140000,125000,22,23,29,15,24,65,74,15
14687,E02005637,2009,114,112000,104000,11,26,45,32,16,98,82,32
14688,E02005637,2010,125,115000,106000,8,34,59,24,12,113,101,24
14689,E02005637,2011,112,114000,100000,22,21,49,20,3,109,92,20
14690,E02005637,2012,124,100000,96000,8,17,76,23,7,117,101,23
14691,E02005637,2013,142,109000,104000,14,20,85,23,0,142,119,23
14692,E02005637,2014,59,106000,102000,4,6,31,18,2,57,41,18
14693,E02005638,2009,130,162000,145000,59,58,13,0,0,130,130,0
14694,E02005638,2010,134,174000,170000,61,62,11,0,0,134,134,0
14695,E02005638,2011,129,174000,161000,64,49,16,0,0,129,129,0
14696,E02005638,2012,135,164000,150000,57,60,17,1,0,135,134,1
14697,E02005638,2013,157,177000,160000,77,60,20,0,0,157,157,0
14698,E02005638,2014,53,167000,158000,14,33,6,0,0,53,53,0
14699,E02005650,2009,45,124000,123000,6,22,17,0,0,45,45,0
14700,E02005650,2010,31,145000,144000,5,22,3,1,0,31,30,1
14701,E02005650,2011,38,139000,137000,3,21,13,1,0,38,37,1
14702,E02005650,2012,44,147000,146000,14,22,7,1,0,44,43,1
14703,E02005650,2013,58,143000,138000,12,26,17,3,0,58,55,3
14704,E02005650,2014,22,152000,155000,6,11,4,1,0,22,21,1
14705,E02005651,2009,100,149000,143000,24,56,13,7,20,80,93,7
14706,E02005651,2010,86,164000,150000,26,42,11,7,17,69,80,6
14707,E02005651,2011,94,151000,140000,27,51,14,2,2,92,92,2
14708,E02005651,2012,95,157000,147000,21,55,10,9,0,95,87,8
14709,E02005651,2013,105,160000,155000,30,62,7,6,1,104,99,6
14710,E02005651,2014,26,168000,167000,7,16,3,0,0,26,26,0
14711,E02005652,2009,26,128000,122000,2,14,10,0,0,26,26,0
14712,E02005652,2010,30,141000,124000,4,10,9,7,6,24,22,8
14713,E02005652,2011,18,133000,134000,2,9,4,3,1,17,15,3
14714,E02005652,2012,18,140000,131000,4,7,7,0,0,18,18,0
14715,E02005652,2013,33,128000,125000,1,15,15,2,0,33,30,3
14716,E02005652,2014,7,147000,152000,1,3,3,0,0,7,7,0
14717,E02005653,2009,55,98000,92000,8,17,24,6,0,55,53,2
14718,E02005653,2010,68,116000,99000,16,18,29,5,0,68,68,0
14719,E02005653,2011,64,102000,90000,7,15,39,3,0,64,60,4
14720,E02005653,2012,65,103000,95000,13,12,36,4,0,65,62,3
14721,E02005653,2013,84,116000,102000,17,16,46,5,0,84,79,5
14722,E02005653,2014,27,129000,115000,11,4,11,1,0,27,26,1
14723,E02005654,2009,68,132000,110000,19,28,20,1,0,68,68,0
14724,E02005654,2010,81,119000,109000,24,22,28,7,4,77,73,8
14725,E02005654,2011,68,124000,105000,17,23,25,3,1,67,65,3
14726,E02005654,2012,75,128000,106000,20,19,34,2,1,74,69,6
14727,E02005654,2013,110,124000,109000,23,35,47,5,3,107,102,8
14728,E02005654,2014,44,152000,125000,13,10,21,0,0,44,44,0
14729,E02005655,2009,75,151000,142000,27,28,17,3,0,75,70,5
14730,E02005655,2010,50,159000,166000,16,21,8,5,0,50,44,6
14731,E02005655,2011,84,160000,155000,33,30,17,4,0,84,75,9
14732,E02005655,2012,81,172000,159000,25,35,20,1,1,80,76,5
14733,E02005655,2013,106,165000,155000,31,42,26,7,0,106,94,12
14734,E02005655,2014,35,183000,182000,13,11,9,2,0,35,32,3
14735,E02005656,2009,33,105000,100000,6,10,15,2,0,33,32,1
14736,E02005656,2010,29,99000,93000,3,3,21,2,0,29,29,0
14737,E02005656,2011,42,99000,94000,3,7,30,2,0,42,41,1
14738,E02005656,2012,41,122000,112000,12,8,21,0,0,41,41,0
14739,E02005656,2013,43,113000,102000,5,7,31,0,0,43,43,0
14740,E02005656,2014,18,123000,110000,3,1,13,1,0,18,17,1
14741,E02005657,2009,72,152000,133000,6,26,33,7,3,69,65,7
14742,E02005657,2010,68,154000,137000,9,28,21,10,5,63,57,11
14743,E02005657,2011,59,161000,125000,10,20,23,6,0,59,53,6
14744,E02005657,2012,68,145000,136000,7,31,26,4,1,67,63,5
14745,E02005657,2013,88,174000,145000,15,36,28,9,3,85,79,9
14746,E02005657,2014,31,163000,160000,4,8,12,7,0,31,25,6
14747,E02005658,2009,46,114000,113000,1,12,33,0,0,46,46,0
14748,E02005658,2010,65,117000,114000,1,19,44,1,0,65,64,1
14749,E02005658,2011,54,119000,113000,1,12,41,0,0,54,54,0
14750,E02005658,2012,56,120000,117000,2,10,44,0,0,56,56,0
14751,E02005658,2013,74,124000,120000,4,10,60,0,0,74,74,0
14752,E02005658,2014,32,118000,120000,0,9,23,0,0,32,32,0
14753,E02005659,2009,66,137000,128000,3,46,14,3,0,66,60,6
14754,E02005659,2010,63,145000,140000,2,44,13,4,0,63,56,7
14755,E02005659,2011,69,149000,148000,6,43,17,3,0,69,64,5
14756,E02005659,2012,69,151000,148000,0,58,8,3,1,68,66,3
14757,E02005659,2013,141,160000,154000,12,82,26,21,53,88,118,23
14758,E02005659,2014,63,164000,160000,8,31,10,14,24,39,49,14
14759,E02005660,2009,41,119000,118000,9,17,14,1,0,41,40,1
14760,E02005660,2010,41,151000,125000,16,11,14,0,0,41,41,0
14761,E02005660,2011,57,127000,120000,19,15,23,0,0,57,56,1
14762,E02005660,2012,48,151000,140000,26,9,13,0,0,48,48,0
14763,E02005660,2013,65,202000,138000,26,13,23,3,7,58,61,4
14764,E02005660,2014,26,153000,155000,10,9,6,1,0,26,25,1
14765,E02005661,2009,65,141000,125000,2,27,33,3,7,58,62,3
14766,E02005661,2010,80,117000,105000,2,22,31,25,26,54,55,25
14767,E02005661,2011,80,128000,100000,1,26,28,25,26,54,55,25
14768,E02005661,2012,58,125000,120000,1,18,35,4,0,58,54,4
14769,E02005661,2013,58,130000,122000,1,21,31,5,0,58,53,5
14770,E02005661,2014,24,146000,144000,2,8,12,2,0,24,22,2
14771,E02005662,2009,83,154000,142000,2,19,58,4,2,81,80,3
14772,E02005662,2010,78,162000,146000,2,20,48,8,0,78,70,8
14773,E02005662,2011,64,154000,142000,4,15,43,2,1,63,62,2
14774,E02005662,2012,84,163000,144000,2,22,56,4,0,84,80,4
14775,E02005662,2013,105,154000,148000,2,30,63,10,0,105,95,10
14776,E02005662,2014,40,150000,149000,0,11,26,3,0,40,37,3
14777,E02005664,2009,73,126000,118000,1,15,46,11,3,70,62,11
14778,E02005664,2010,67,142000,123000,3,13,43,8,0,67,58,9
14779,E02005664,2011,89,146000,128000,3,12,68,6,0,89,82,7
14780,E02005664,2012,82,144000,125000,2,11,60,9,0,82,73,9
14781,E02005664,2013,101,138000,125000,2,19,64,16,1,100,84,17
14782,E02005664,2014,43,162000,138000,1,5,26,11,0,43,32,11
14783,E02005665,2009,79,179000,130000,35,28,16,0,0,79,79,0
14784,E02005665,2010,76,157000,125000,26,19,30,1,2,74,75,1
14785,E02005665,2011,80,151000,130000,33,21,26,0,2,78,80,0
14786,E02005665,2012,116,169000,142000,46,42,24,4,24,92,112,4
14787,E02005665,2013,155,183000,174000,61,42,41,11,38,117,143,12
14788,E02005665,2014,39,167000,148000,18,8,13,0,1,38,39,0
14789,E02005666,2009,44,97000,98000,0,23,18,3,0,44,40,4
14790,E02005666,2010,58,104000,108000,0,22,32,4,0,58,53,5
14791,E02005666,2011,51,101000,97000,1,21,26,3,0,51,44,7
14792,E02005666,2012,51,102000,100000,1,16,28,6,0,51,45,6
14793,E02005666,2013,71,113000,110000,1,25,39,6,0,71,62,9
14794,E02005666,2014,19,114000,124000,1,6,11,1,0,19,17,2
14795,E02005667,2009,58,148000,138000,20,21,11,6,0,58,52,6
14796,E02005667,2010,80,141000,137000,13,38,21,8,13,67,73,7
14797,E02005667,2011,91,175000,150000,33,26,18,14,28,63,78,13
14798,E02005667,2012,130,163000,155000,42,41,33,14,46,84,116,14
14799,E02005667,2013,120,174000,162000,46,41,23,10,40,80,110,10
14800,E02005667,2014,39,183000,160000,9,12,16,2,6,33,37,2
14801,E02005668,2009,96,154000,140000,24,37,15,20,37,59,73,23
14802,E02005668,2010,99,178000,176000,37,43,11,8,45,54,91,8
14803,E02005668,2011,94,185000,170000,27,42,17,8,36,58,87,7
14804,E02005668,2012,101,164000,155000,18,56,18,9,17,84,92,9
14805,E02005668,2013,111,173000,159000,17,63,23,8,8,103,103,8
14806,E02005668,2014,21,169000,150000,3,12,4,2,0,21,19,2
14807,E02005669,2009,75,229000,205000,42,22,7,4,1,74,67,8
14808,E02005669,2010,79,235000,228000,39,29,4,7,8,71,70,9
14809,E02005669,2011,62,266000,238000,35,20,4,3,1,61,59,3
14810,E02005669,2012,79,266000,237000,55,17,4,3,2,77,75,4
14811,E02005669,2013,98,249000,231000,72,18,8,0,0,98,98,0
14812,E02005669,2014,32,254000,224000,18,7,0,7,0,32,25,7
14813,E02005670,2009,125,88000,87000,1,2,47,75,57,68,50,75
14814,E02005670,2010,114,94000,91000,1,5,56,52,31,83,62,52
14815,E02005670,2011,60,108000,91000,0,2,51,7,0,60,52,8
14816,E02005670,2012,67,100000,96000,0,0,44,23,0,67,44,23
14817,E02005670,2013,84,99000,102000,0,1,60,23,0,84,61,23
14818,E02005670,2014,47,130000,107000,0,1,34,12,0,47,35,12
14819,E02005671,2009,116,145000,133000,3,8,99,6,1,115,110,6
14820,E02005671,2010,122,146000,134000,2,2,107,11,0,122,112,10
14821,E02005671,2011,98,144000,130000,2,5,87,4,2,96,93,5
14822,E02005671,2012,108,140000,134000,0,3,98,7,1,107,101,7
14823,E02005671,2013,132,152000,141000,0,3,122,7,1,131,125,7
14824,E02005671,2014,50,169000,167000,1,1,44,4,0,50,46,4
14825,E02005672,2009,84,108000,105000,1,4,70,9,0,84,73,11
14826,E02005672,2010,73,111000,110000,0,1,60,12,0,73,61,12
14827,E02005672,2011,99,115000,110000,1,3,73,22,1,98,78,21
14828,E02005672,2012,75,106000,110000,0,2,56,17,0,75,58,17
14829,E02005672,2013,100,126000,117000,0,1,85,14,0,100,87,13
14830,E02005672,2014,42,123000,120000,0,0,34,8,0,42,34,8
14831,E02005673,2009,93,133000,110000,4,29,51,9,0,93,83,10
14832,E02005673,2010,100,127000,112000,5,30,50,15,0,100,86,14
14833,E02005673,2011,92,122000,110000,4,32,45,11,0,92,81,11
14834,E02005673,2012,101,128000,111000,4,34,57,6,0,101,95,6
14835,E02005673,2013,148,125000,122000,4,61,65,18,1,147,130,18
14836,E02005673,2014,52,170000,135000,2,18,30,2,3,49,50,2
14837,E02005674,2009,86,132000,124000,4,9,25,48,22,64,40,46
14838,E02005674,2010,105,147000,128000,11,11,42,41,17,88,65,40
14839,E02005674,2011,91,130000,118000,10,7,44,30,0,91,60,31
14840,E02005674,2012,82,140000,123000,7,7,30,38,0,82,44,38
14841,E02005674,2013,109,165000,131000,15,14,50,30,1,108,79,30
14842,E02005674,2014,49,164000,125000,8,5,11,25,0,49,25,24
14843,E02005675,2009,50,126000,123000,8,24,18,0,1,49,50,0
14844,E02005675,2010,70,133000,128000,17,30,21,2,0,70,66,4
14845,E02005675,2011,68,133000,132000,17,32,16,3,0,68,63,5
14846,E02005675,2012,66,132000,124000,15,28,20,3,0,66,63,3
14847,E02005675,2013,72,139000,133000,19,24,29,0,0,72,72,0
14848,E02005675,2014,29,149000,142000,6,13,8,2,0,29,27,2
14849,E02005676,2009,62,132000,134000,20,24,16,2,0,62,60,2
14850,E02005676,2010,68,143000,144000,13,45,10,0,0,68,67,1
14851,E02005676,2011,75,135000,135000,11,40,19,5,0,75,69,6
14852,E02005676,2012,76,149000,149000,16,43,17,0,0,76,76,0
14853,E02005676,2013,82,151000,148000,17,43,20,2,0,82,78,4
14854,E02005676,2014,31,155000,157000,8,13,8,2,0,31,29,2
14855,E02005677,2009,94,161000,134000,28,26,34,6,3,91,88,6
14856,E02005677,2010,103,172000,148000,23,30,34,16,6,97,87,16
14857,E02005677,2011,100,160000,136000,14,25,40,21,13,87,79,21
14858,E02005677,2012,111,161000,130000,26,21,56,8,1,110,103,8
14859,E02005677,2013,157,163000,135000,30,30,68,29,9,148,128,29
14860,E02005677,2014,67,182000,137000,17,7,33,10,4,63,57,10
14861,E02005678,2009,250,181000,180000,65,43,59,83,130,120,162,88
14862,E02005678,2010,161,208000,197000,71,34,37,19,43,118,137,24
14863,E02005678,2011,159,223000,205000,81,27,34,17,28,131,136,23
14864,E02005678,2012,231,208000,195000,103,40,53,35,73,158,197,34
14865,E02005678,2013,311,200000,192000,113,58,79,61,95,216,248,63
14866,E02005678,2014,120,197000,190000,40,21,32,27,37,83,93,27
14867,E02005679,2009,134,163000,154000,61,36,32,5,0,134,126,8
14868,E02005679,2010,136,175000,160000,69,36,25,6,0,136,130,6
14869,E02005679,2011,132,185000,159000,68,32,28,4,0,132,128,4
14870,E02005679,2012,129,185000,164000,68,31,22,8,0,129,122,7
14871,E02005679,2013,158,187000,174000,81,40,35,2,0,158,156,2
14872,E02005679,2014,56,183000,173000,28,11,15,2,0,56,54,2
14873,E02005680,2009,111,244000,200000,73,22,15,1,0,111,110,1
14874,E02005680,2010,117,264000,242000,79,24,13,1,0,117,115,2
14875,E02005680,2011,116,237000,223000,71,27,16,2,0,116,114,2
14876,E02005680,2012,101,276000,241000,63,16,19,3,0,101,98,3
14877,E02005680,2013,149,273000,228000,84,24,36,5,13,136,144,5
14878,E02005680,2014,56,277000,238000,32,12,12,0,0,56,56,0
14879,E02005681,2009,47,227000,183000,22,19,6,0,0,47,46,1
14880,E02005681,2010,47,256000,176000,23,16,8,0,1,46,47,0
14881,E02005681,2011,61,242000,191000,28,19,14,0,0,61,61,0
14882,E02005681,2012,54,290000,236000,28,22,3,1,6,48,53,1
14883,E02005681,2013,71,278000,207000,45,13,12,1,11,60,70,1
14884,E02005681,2014,18,256000,235000,8,8,2,0,0,18,18,0
14885,E02005682,2009,76,274000,225000,41,28,6,1,5,71,76,0
14886,E02005682,2010,62,337000,295000,38,16,8,0,5,57,61,1
14887,E02005682,2011,72,270000,240000,40,22,10,0,3,69,72,0
14888,E02005682,2012,56,313000,266000,38,13,5,0,6,50,56,0
14889,E02005682,2013,95,290000,250000,55,25,14,1,9,86,94,1
14890,E02005682,2014,31,257000,220000,14,7,10,0,0,31,31,0
14891,E02005683,2009,206,223000,200000,91,62,22,31,40,166,172,34
14892,E02005683,2010,182,236000,211000,79,50,22,31,24,158,148,34
14893,E02005683,2011,234,218000,195000,87,70,39,38,40,194,195,39
14894,E02005683,2012,192,221000,184000,70,67,42,13,25,167,177,15
14895,E02005683,2013,208,219000,188000,69,81,36,22,11,197,184,24
14896,E02005683,2014,96,240000,198000,39,24,23,10,4,92,85,11
14897,E02005684,2009,114,266000,220000,60,32,18,4,6,108,110,4
14898,E02005684,2010,96,271000,235000,46,28,19,3,4,92,93,3
14899,E02005684,2011,129,290000,240000,72,33,20,4,11,118,126,3
14900,E02005684,2012,90,261000,235000,48,16,23,3,4,86,87,3
14901,E02005684,2013,193,288000,265000,114,33,43,3,58,135,189,4
14902,E02005684,2014,66,340000,312000,40,13,13,0,15,51,66,0
14903,E02005685,2009,108,189000,162000,30,46,16,16,8,100,89,19
14904,E02005685,2010,141,233000,186000,54,56,17,14,13,128,118,23
14905,E02005685,2011,129,208000,177000,47,49,14,19,1,128,109,20
14906,E02005685,2012,102,206000,186000,32,36,24,10,2,100,88,14
14907,E02005685,2013,139,245000,202000,47,50,32,10,5,134,123,16
14908,E02005685,2014,53,230000,197000,19,20,12,2,2,51,49,4
14909,E02005686,2009,14,224000,183000,9,4,1,0,0,14,14,0
14910,E02005686,2010,14,243000,186000,7,4,3,0,0,14,14,0
14911,E02005686,2011,18,230000,204000,6,5,7,0,6,12,18,0
14912,E02005686,2012,13,350000,237000,6,5,2,0,0,13,13,0
14913,E02005686,2013,14,275000,228000,11,3,0,0,3,11,14,0
14914,E02005686,2014,14,293000,248000,11,2,1,0,3,11,14,0
14915,E02005687,2009,71,294000,248000,33,20,18,0,2,69,71,0
14916,E02005687,2010,91,321000,280000,55,28,6,2,14,77,90,1
14917,E02005687,2011,102,308000,272000,61,26,13,2,21,81,98,4
14918,E02005687,2012,94,313000,295000,50,23,20,1,18,76,93,1
14919,E02005687,2013,95,287000,255000,48,27,20,0,4,91,95,0
14920,E02005687,2014,23,388000,340000,10,7,5,1,0,23,22,1
14921,E02005688,2009,137,235000,198000,56,58,19,4,25,112,130,7
14922,E02005688,2010,112,228000,218000,41,56,14,1,19,93,110,2
14923,E02005688,2011,121,244000,224000,44,61,14,2,13,108,116,5
14924,E02005688,2012,122,248000,215000,54,45,22,1,9,113,120,2
14925,E02005688,2013,163,262000,218000,70,53,35,5,15,148,153,10
14926,E02005688,2014,69,281000,250000,37,19,12,1,15,54,68,1
14927,E02005689,2009,139,198000,182000,68,47,22,2,0,139,136,3
14928,E02005689,2010,133,219000,210000,70,41,19,3,3,130,131,2
14929,E02005689,2011,104,218000,214000,54,28,20,2,1,103,101,3
14930,E02005689,2012,115,218000,215000,63,32,17,3,1,114,112,3
14931,E02005689,2013,135,238000,217000,69,37,28,1,1,134,134,1
14932,E02005689,2014,56,239000,228000,31,8,15,2,0,56,54,2
14933,E02005690,2009,116,178000,166000,21,27,22,46,35,81,70,46
14934,E02005690,2010,103,193000,185000,20,30,20,33,29,74,67,36
14935,E02005690,2011,108,191000,171000,25,26,22,35,29,79,71,37
14936,E02005690,2012,112,176000,165000,22,17,28,45,29,83,66,46
14937,E02005690,2013,97,186000,165000,24,25,30,18,12,85,78,19
14938,E02005690,2014,42,175000,171000,6,13,12,11,0,42,31,11
14939,E02005691,2009,66,255000,216000,33,21,11,1,0,66,63,3
14940,E02005691,2010,61,312000,242000,28,18,14,1,3,58,60,1
14941,E02005691,2011,88,341000,250000,41,29,17,1,3,85,86,2
14942,E02005691,2012,77,282000,242000,32,24,21,0,4,73,77,0
14943,E02005691,2013,100,302000,245000,43,29,24,4,1,99,96,4
14944,E02005691,2014,32,306000,278000,14,9,8,1,2,30,31,1
14945,E02005692,2009,48,137000,106000,9,21,16,2,2,46,44,4
14946,E02005692,2010,52,168000,125000,14,18,19,1,0,52,51,1
14947,E02005692,2011,55,133000,115000,16,23,11,5,1,54,50,5
14948,E02005692,2012,45,189000,122000,17,14,13,1,0,45,43,2
14949,E02005692,2013,78,150000,120000,17,26,28,7,7,71,71,7
14950,E02005692,2014,45,179000,155000,10,22,11,2,13,32,42,3
14951,E02005693,2009,82,144000,142000,37,33,11,1,4,78,80,2
14952,E02005693,2010,81,139000,137000,30,31,17,3,0,81,79,2
14953,E02005693,2011,63,149000,147000,26,26,10,1,0,63,62,1
14954,E02005693,2012,65,149000,141000,25,30,10,0,4,61,65,0
14955,E02005693,2013,91,144000,141000,29,43,13,6,0,91,86,5
14956,E02005693,2014,32,162000,151000,12,9,10,1,1,31,31,1
14957,E02005694,2009,89,157000,143000,51,27,10,1,0,89,88,1
14958,E02005694,2010,110,151000,147000,64,28,17,1,0,110,108,2
14959,E02005694,2011,93,171000,145000,48,32,12,1,0,93,92,1
14960,E02005694,2012,79,162000,145000,48,25,4,2,0,79,77,2
14961,E02005694,2013,97,163000,146000,57,29,11,0,0,97,97,0
14962,E02005694,2014,37,186000,170000,25,9,3,0,1,36,37,0
14963,E02005695,2009,85,93000,90000,1,14,48,22,14,71,61,24
14964,E02005695,2010,80,105000,104000,7,15,36,22,14,66,56,24
14965,E02005695,2011,88,104000,102000,7,12,51,18,7,81,70,18
14966,E02005695,2012,93,106000,105000,4,10,64,15,11,82,77,16
14967,E02005695,2013,133,115000,110000,3,21,94,15,30,103,117,16
14968,E02005695,2014,46,115000,110000,1,4,37,4,6,40,42,4
14969,E02005696,2009,35,92000,89000,0,15,18,2,0,35,33,2
14970,E02005696,2010,35,92000,87000,2,16,17,0,0,35,35,0
14971,E02005696,2011,33,101000,91000,2,11,20,0,0,33,32,1
14972,E02005696,2012,34,94000,92000,1,13,19,1,0,34,33,1
14973,E02005696,2013,47,103000,98000,2,18,27,0,0,47,47,0
14974,E02005696,2014,18,107000,98000,0,8,10,0,0,18,18,0
14975,E02005697,2009,51,110000,100000,3,16,23,9,8,43,40,11
14976,E02005697,2010,77,121000,110000,7,24,28,18,14,63,58,19
14977,E02005697,2011,61,112000,100000,5,12,27,17,8,53,44,17
14978,E02005697,2012,67,120000,97000,10,9,42,6,0,67,62,5
14979,E02005697,2013,62,114000,110000,6,18,31,7,0,62,55,7
14980,E02005697,2014,25,126000,115000,2,6,15,2,0,25,23,2
14981,E02005698,2009,30,128000,121000,8,15,7,0,0,30,30,0
14982,E02005698,2010,42,132000,130000,7,22,13,0,0,42,42,0
14983,E02005698,2011,44,124000,124000,6,25,11,2,0,44,42,2
14984,E02005698,2012,54,129000,125000,7,29,18,0,1,53,54,0
14985,E02005698,2013,55,137000,130000,18,23,14,0,0,55,54,1
14986,E02005698,2014,20,164000,138000,7,8,5,0,0,20,20,0
14987,E02005699,2009,86,132000,123000,24,40,21,1,25,61,83,3
14988,E02005699,2010,126,131000,120000,31,64,29,2,29,97,123,3
14989,E02005699,2011,65,134000,123000,20,32,12,1,0,65,64,1
14990,E02005699,2012,89,134000,116000,25,37,26,1,0,89,87,2
14991,E02005699,2013,101,138000,125000,31,38,26,6,0,101,93,8
14992,E02005699,2014,31,142000,120000,10,14,6,1,0,31,30,1
14993,E02005700,2009,109,215000,175000,50,37,20,2,1,108,106,3
14994,E02005700,2010,116,224000,182000,44,48,20,4,0,116,112,4
14995,E02005700,2011,111,220000,172000,37,45,27,2,2,109,106,5
14996,E02005700,2012,134,219000,174000,49,41,38,6,8,126,127,7
14997,E02005700,2013,122,262000,215000,52,39,29,2,9,113,120,2
14998,E02005700,2014,33,236000,178000,8,12,12,1,0,33,31,2
14999,E02005701,2009,149,193000,161000,65,60,23,1,24,125,148,1
15000,E02005701,2010,164,198000,151000,66,56,38,4,9,155,156,8
15001,E02005701,2011,129,168000,140000,34,56,31,8,2,127,121,8
15002,E02005701,2012,179,184000,150000,44,68,61,6,19,160,174,5
15003,E02005701,2013,150,208000,162000,54,54,36,6,2,148,142,8
15004,E02005701,2014,66,173000,150000,20,20,23,3,0,66,63,3
15005,E02005928,2009,59,277000,228000,25,11,8,15,13,46,44,15
15006,E02005928,2010,52,303000,256000,22,10,4,16,13,39,36,16
15007,E02005928,2011,58,379000,282000,28,18,10,2,2,56,55,3
15008,E02005928,2012,31,399000,335000,17,9,5,0,0,31,31,0
15009,E02005928,2013,43,309000,260000,16,12,11,4,1,42,38,5
15010,E02005928,2014,11,255000,250000,4,1,2,4,0,11,7,4
15011,E02005930,2009,67,323000,273000,29,11,22,5,0,67,63,4
15012,E02005930,2010,85,375000,329000,42,23,15,5,0,85,78,7
15013,E02005930,2011,91,410000,360000,53,19,15,4,3,88,84,7
15014,E02005930,2012,74,376000,341000,43,15,12,4,4,70,69,5
15015,E02005930,2013,104,416000,329000,45,24,27,8,4,100,95,9
15016,E02005930,2014,31,467000,385000,13,10,7,1,0,31,29,2
15017,E02005931,2009,94,261000,215000,34,23,36,1,5,89,92,2
15018,E02005931,2010,88,288000,250000,36,32,19,1,0,88,87,1
15019,E02005931,2011,87,285000,234000,33,32,20,2,0,87,85,2
15020,E02005931,2012,117,273000,245000,41,29,43,4,8,109,113,4
15021,E02005931,2013,156,257000,228000,36,29,72,19,28,128,138,18
15022,E02005931,2014,61,276000,246000,13,15,29,4,11,50,57,4
15023,E02005932,2009,119,212000,200000,50,21,45,3,0,119,116,3
15024,E02005932,2010,129,236000,207000,52,29,42,6,1,128,124,5
15025,E02005932,2011,106,223000,216000,48,22,30,6,0,106,101,5
15026,E02005932,2012,126,215000,197000,41,20,64,1,2,124,125,1
15027,E02005932,2013,153,241000,230000,60,18,65,10,3,150,143,10
15028,E02005932,2014,45,257000,250000,22,4,19,0,0,45,45,0
15029,E02005933,2009,97,180000,171000,12,47,37,1,0,97,96,1
15030,E02005933,2010,84,181000,175000,11,33,39,1,0,84,81,3
15031,E02005933,2011,80,190000,180000,11,39,28,2,0,80,78,2
15032,E02005933,2012,104,190000,180000,14,39,48,3,1,103,101,3
15033,E02005933,2013,152,214000,202000,34,49,67,2,12,140,150,2
15034,E02005933,2014,47,229000,220000,7,21,18,1,2,45,46,1
15035,E02005934,2009,99,192000,178000,23,40,35,1,0,99,98,1
15036,E02005934,2010,98,206000,190000,23,50,25,0,0,98,97,1
15037,E02005934,2011,99,205000,190000,32,40,26,1,0,99,99,0
15038,E02005934,2012,116,212000,196000,29,44,43,0,0,116,116,0
15039,E02005934,2013,123,227000,217000,38,39,45,1,0,123,121,2
15040,E02005934,2014,49,225000,210000,6,22,21,0,0,49,49,0
15041,E02005935,2009,137,200000,183000,40,34,45,18,0,137,119,18
15042,E02005935,2010,123,204000,190000,29,21,41,32,4,119,92,31
15043,E02005935,2011,148,209000,190000,34,27,52,35,4,144,113,35
15044,E02005935,2012,140,219000,210000,31,23,57,29,2,138,110,30
15045,E02005935,2013,164,213000,186000,38,20,66,40,1,163,121,43
15046,E02005935,2014,58,205000,195000,14,1,20,23,0,58,36,22
15047,E02005936,2009,133,325000,285000,57,42,30,4,30,103,126,7
15048,E02005936,2010,117,361000,320000,53,37,25,2,19,98,113,4
15049,E02005936,2011,91,475000,340000,51,28,11,1,5,86,89,2
15050,E02005936,2012,129,383000,318000,67,35,26,1,34,95,128,1
15051,E02005936,2013,180,382000,340000,103,36,38,3,75,105,178,2
15052,E02005936,2014,67,398000,348000,28,21,18,0,24,43,67,0
15053,E02005937,2009,90,245000,208000,22,29,24,15,3,87,73,17
15054,E02005937,2010,99,276000,235000,24,33,19,23,7,92,76,23
15055,E02005937,2011,96,254000,216000,22,28,20,26,13,83,69,27
15056,E02005937,2012,88,253000,232000,25,21,29,13,2,86,73,15
15057,E02005937,2013,105,290000,250000,33,36,28,8,2,103,94,11
15058,E02005937,2014,37,298000,280000,11,10,11,5,3,34,32,5
15059,E02005938,2009,63,226000,214000,12,38,8,5,5,58,58,5
15060,E02005938,2010,57,238000,231000,7,33,13,4,0,57,52,5
15061,E02005938,2011,74,253000,231000,13,45,11,5,2,72,67,7
15062,E02005938,2012,62,242000,234000,9,40,10,3,2,60,58,4
15063,E02005938,2013,90,262000,249000,10,50,14,16,6,84,73,17
15064,E02005938,2014,26,253000,250000,4,14,5,3,0,26,23,3
15065,E02005939,2009,72,223000,203000,17,28,17,10,4,68,62,10
15066,E02005939,2010,126,264000,230000,32,55,27,12,16,110,110,16
15067,E02005939,2011,134,267000,250000,29,61,31,13,42,92,109,25
15068,E02005939,2012,102,281000,239000,32,33,24,13,3,99,87,15
15069,E02005939,2013,103,250000,244000,18,44,27,14,2,101,87,16
15070,E02005939,2014,53,273000,250000,18,15,12,8,1,52,45,8
15071,E02005940,2009,98,378000,290000,27,29,12,30,16,82,67,31
15072,E02005940,2010,119,400000,300000,33,31,11,44,14,105,72,47
15073,E02005940,2011,94,463000,350000,26,31,15,22,3,91,71,23
15074,E02005940,2012,91,436000,325000,15,25,14,37,11,80,54,37
15075,E02005940,2013,94,470000,348000,23,28,14,29,5,89,65,29
15076,E02005940,2014,23,407000,315000,3,9,2,9,1,22,14,9
15077,E02005941,2009,128,384000,310000,22,34,19,53,22,106,75,53
15078,E02005941,2010,114,514000,442000,13,48,26,27,1,113,86,28
15079,E02005941,2011,107,454000,397000,19,34,25,29,1,106,77,30
15080,E02005941,2012,91,560000,490000,16,28,20,27,2,89,63,28
15081,E02005941,2013,108,619000,556000,15,38,35,20,3,105,87,21
15082,E02005941,2014,31,529000,485000,0,10,12,9,1,30,22,9
15083,E02005942,2009,96,570000,475000,9,24,27,36,0,96,59,37
15084,E02005942,2010,140,626000,499000,14,34,36,56,1,139,82,58
15085,E02005942,2011,115,826000,568000,16,25,32,42,3,112,72,43
15086,E02005942,2012,108,766000,628000,10,22,35,41,0,108,65,43
15087,E02005942,2013,113,796000,635000,10,15,45,43,0,113,69,44
15088,E02005942,2014,17,796000,738000,0,4,6,7,0,17,10,7
15089,E02005943,2009,61,248000,230000,5,34,17,5,0,61,56,5
15090,E02005943,2010,79,299000,270000,16,40,17,6,0,79,72,7
15091,E02005943,2011,78,312000,278000,12,38,18,10,0,78,67,11
15092,E02005943,2012,64,312000,291000,10,35,16,3,2,62,61,3
15093,E02005943,2013,77,349000,300000,13,34,22,8,3,74,69,8
15094,E02005943,2014,27,359000,325000,3,11,13,0,0,27,27,0
15095,E02005944,2009,67,209000,192000,8,29,12,18,10,57,48,19
15096,E02005944,2010,64,226000,228000,1,36,12,15,1,63,49,15
15097,E02005944,2011,72,216000,210000,5,37,14,16,0,72,56,16
15098,E02005944,2012,40,243000,225000,4,19,7,10,0,40,29,11
15099,E02005944,2013,68,222000,211000,2,26,19,21,4,64,45,23
15100,E02005944,2014,26,224000,230000,0,6,13,7,2,24,17,9
15101,E02005945,2009,143,338000,280000,36,48,24,35,12,131,109,34
15102,E02005945,2010,127,348000,300000,29,46,20,32,1,126,93,34
15103,E02005945,2011,102,365000,300000,17,48,14,23,0,102,77,25
15104,E02005945,2012,125,350000,304000,20,49,24,32,2,123,91,34
15105,E02005945,2013,160,405000,336000,38,47,36,39,13,147,119,41
15106,E02005945,2014,33,464000,385000,11,7,2,13,1,32,19,14
15107,E02005946,2009,131,277000,250000,24,77,12,18,1,130,113,18
15108,E02005946,2010,101,276000,250000,13,49,14,25,5,96,76,25
15109,E02005946,2011,122,294000,266000,19,63,18,22,4,118,100,22
15110,E02005946,2012,112,289000,260000,13,55,19,25,0,112,87,25
15111,E02005946,2013,123,283000,250000,11,50,26,36,0,123,86,37
15112,E02005946,2014,42,291000,293000,7,24,2,9,0,42,33,9
15113,E02005947,2009,61,432000,270000,3,8,16,34,12,49,22,39
15114,E02005947,2010,78,553000,420000,4,9,13,52,0,78,25,53
15115,E02005947,2011,67,669000,400000,3,5,17,42,7,60,25,42
15116,E02005947,2012,52,795000,519000,2,5,16,29,0,52,22,30
15117,E02005947,2013,61,786000,450000,2,6,13,40,0,61,20,41
15118,E02005947,2014,15,845000,610000,1,2,7,5,0,15,10,5
15119,E02005948,2009,78,322000,314000,3,6,50,19,0,78,57,21
15120,E02005948,2010,106,345000,329000,9,22,55,20,0,106,84,22
15121,E02005948,2011,86,327000,320000,2,10,54,20,3,83,65,21
15122,E02005948,2012,70,361000,322000,1,4,44,21,4,66,49,21
15123,E02005948,2013,104,392000,372000,1,15,64,24,1,103,80,24
15124,E02005948,2014,19,375000,375000,0,0,14,5,0,19,14,5
15125,E02005949,2009,49,232000,210000,5,19,12,13,1,48,36,13
15126,E02005949,2010,57,259000,225000,6,26,14,11,2,55,46,11
15127,E02005949,2011,51,221000,210000,3,13,24,11,4,47,39,12
15128,E02005949,2012,47,282000,227000,6,10,18,13,0,47,34,13
15129,E02005949,2013,56,272000,238000,6,9,24,17,0,56,39,17
15130,E02005949,2014,22,265000,249000,2,2,8,10,0,22,12,10
15131,E02005950,2009,121,312000,285000,8,33,61,19,3,118,103,18
15132,E02005950,2010,97,352000,320000,12,22,52,11,0,97,85,12
15133,E02005950,2011,99,342000,322000,3,24,56,16,0,99,81,18
15134,E02005950,2012,103,374000,345000,7,17,62,17,1,102,84,19
15135,E02005950,2013,115,361000,338000,4,14,73,24,1,114,92,23
15136,E02005950,2014,48,398000,398000,3,8,30,7,0,48,41,7
15137,E02005951,2009,73,277000,253000,5,16,24,28,0,73,43,30
15138,E02005951,2010,109,304000,283000,8,20,38,43,0,109,66,43
15139,E02005951,2011,66,318000,276000,1,13,30,22,0,66,44,22
15140,E02005951,2012,80,316000,290000,1,13,37,29,0,80,51,29
15141,E02005951,2013,74,341000,329000,1,16,39,18,0,74,55,19
15142,E02005951,2014,19,374000,386000,0,1,14,4,0,19,14,5
15143,E02005952,2009,168,211000,210000,11,55,39,63,22,146,104,64
15144,E02005952,2010,162,232000,239000,7,53,40,62,10,152,99,63
15145,E02005952,2011,158,223000,226000,5,57,46,50,11,147,105,53
15146,E02005952,2012,150,244000,246000,6,51,51,42,13,137,107,43
15147,E02005952,2013,165,244000,248000,4,59,45,57,2,163,108,57
15148,E02005952,2014,58,268000,260000,5,17,17,19,0,58,39,19
15149,E02005953,2009,76,272000,248000,2,26,41,7,2,74,69,7
15150,E02005953,2010,53,333000,306000,5,18,26,4,0,53,51,2
15151,E02005953,2011,56,306000,280000,0,12,38,6,0,56,50,6
15152,E02005953,2012,73,337000,305000,3,7,56,7,0,73,67,6
15153,E02005953,2013,56,330000,294000,0,7,43,6,0,56,50,6
15154,E02005953,2014,23,375000,360000,0,2,18,3,0,23,20,3
15155,E02005954,2009,123,284000,228000,14,53,37,19,25,98,102,21
15156,E02005954,2010,116,278000,245000,11,56,36,13,9,107,100,16
15157,E02005954,2011,112,280000,238000,14,45,41,12,13,99,98,14
15158,E02005954,2012,92,290000,250000,14,46,23,9,2,90,80,12
15159,E02005954,2013,122,294000,250000,10,41,55,16,1,121,106,16
15160,E02005954,2014,61,270000,265000,2,26,22,11,2,59,50,11
15161,E02005955,2009,111,204000,204000,9,40,50,12,6,105,98,13
15162,E02005955,2010,156,215000,209000,15,63,46,32,22,134,122,34
15163,E02005955,2011,115,218000,220000,5,56,30,24,14,101,90,25
15164,E02005955,2012,88,226000,220000,0,30,38,20,3,85,70,18
15165,E02005955,2013,129,237000,235000,4,53,41,31,1,128,100,29
15166,E02005955,2014,48,246000,235000,1,19,17,11,0,48,37,11
15167,E02005956,2009,39,167000,170000,0,15,20,4,0,39,35,4
15168,E02005956,2010,27,178000,180000,0,10,15,2,0,27,25,2
15169,E02005956,2011,37,165000,170000,0,8,27,2,0,37,35,2
15170,E02005956,2012,28,176000,177000,0,6,19,3,0,28,23,5
15171,E02005956,2013,48,184000,189000,0,12,29,7,0,48,38,10
15172,E02005956,2014,9,196000,213000,0,1,5,3,0,9,6,3
15173,E02005957,2009,48,170000,175000,1,17,27,3,0,48,43,5
15174,E02005957,2010,36,182000,187000,1,17,15,3,0,36,31,5
15175,E02005957,2011,50,164000,176000,2,10,33,5,1,49,38,12
15176,E02005957,2012,53,177000,184000,1,13,35,4,0,53,46,7
15177,E02005957,2013,54,197000,198000,3,19,28,4,0,54,50,4
15178,E02005957,2014,16,197000,202000,1,2,9,4,0,16,13,3
15179,E02005958,2009,89,225000,205000,17,27,36,9,0,89,77,12
15180,E02005958,2010,89,258000,230000,26,25,27,11,0,89,74,15
15181,E02005958,2011,85,236000,220000,17,18,33,17,0,85,65,20
15182,E02005958,2012,98,248000,224000,18,16,40,24,7,91,71,27
15183,E02005958,2013,120,250000,237000,24,28,52,16,0,120,100,20
15184,E02005958,2014,34,265000,250000,11,3,13,7,0,34,26,8
15185,E02005959,2009,41,341000,300000,22,11,7,1,0,41,40,1
15186,E02005959,2010,54,413000,364000,35,12,5,2,1,53,52,2
15187,E02005959,2011,43,383000,382000,23,15,3,2,0,43,40,3
15188,E02005959,2012,39,366000,330000,24,9,4,2,1,38,37,2
15189,E02005959,2013,35,440000,358000,18,12,4,1,0,35,34,1
15190,E02005959,2014,13,370000,365000,5,3,4,1,0,13,12,1
15191,E02005960,2009,115,271000,235000,28,31,23,33,25,90,82,33
15192,E02005960,2010,93,316000,250000,23,37,16,17,2,91,76,17
15193,E02005960,2011,95,299000,278000,14,35,33,13,24,71,81,14
15194,E02005960,2012,122,338000,295000,28,41,35,18,31,91,105,17
15195,E02005960,2013,112,335000,276000,29,33,35,15,7,105,96,16
15196,E02005960,2014,54,356000,295000,15,14,19,6,3,51,44,10
15197,E02005961,2009,68,334000,286000,37,17,9,5,4,64,61,7
15198,E02005961,2010,78,356000,285000,37,20,15,6,0,78,70,8
15199,E02005961,2011,67,384000,300000,30,19,9,9,1,66,60,7
15200,E02005961,2012,58,382000,326000,28,18,8,4,1,57,54,4
15201,E02005961,2013,95,404000,347000,42,30,17,6,7,88,89,6
15202,E02005961,2014,40,367000,350000,17,10,8,5,0,40,35,5
15203,E02005962,2009,101,283000,247000,34,36,27,4,10,91,96,5
15204,E02005962,2010,134,335000,272000,46,46,27,15,24,110,117,17
15205,E02005962,2011,125,348000,275000,46,47,20,12,12,113,111,14
15206,E02005962,2012,113,325000,265000,42,36,25,10,23,90,103,10
15207,E02005962,2013,151,360000,280000,54,52,37,8,40,111,139,12
15208,E02005962,2014,51,302000,250000,14,17,19,1,11,40,49,2
15209,E02005963,2009,65,332000,225000,28,22,14,1,1,64,64,1
15210,E02005963,2010,72,403000,329000,29,30,11,2,0,72,68,4
15211,E02005963,2011,68,359000,264000,16,32,17,3,0,68,65,3
15212,E02005963,2012,70,411000,250000,24,20,21,5,0,70,65,5
15213,E02005963,2013,94,373000,283000,30,24,34,6,1,93,88,6
15214,E02005963,2014,29,350000,268000,9,9,9,2,0,29,27,2
15215,E02005964,2009,86,346000,284000,35,36,15,0,0,86,86,0
15216,E02005964,2010,100,381000,295000,41,45,11,3,0,100,98,2
15217,E02005964,2011,78,352000,305000,37,30,10,1,0,78,77,1
15218,E02005964,2012,105,344000,315000,49,39,13,4,1,104,101,4
15219,E02005964,2013,109,378000,325000,41,46,22,0,6,103,108,1
15220,E02005964,2014,32,298000,284000,8,17,7,0,0,32,30,2
15221,E02005965,2009,51,542000,462000,26,14,11,0,0,51,50,1
15222,E02005965,2010,73,475000,350000,25,27,18,3,0,73,67,6
15223,E02005965,2011,54,416000,332000,19,17,13,5,3,51,45,9
15224,E02005965,2012,65,470000,355000,20,23,21,1,3,62,60,5
15225,E02005965,2013,66,473000,368000,26,22,12,6,5,61,60,6
15226,E02005965,2014,31,526000,320000,11,9,9,2,3,28,28,3
15227,E02005966,2009,139,197000,181000,31,42,61,5,0,139,133,6
15228,E02005966,2010,153,211000,192000,36,42,70,5,0,153,144,9
15229,E02005966,2011,166,216000,202000,49,47,68,2,0,166,160,6
15230,E02005966,2012,144,214000,195000,34,37,69,4,0,144,138,6
15231,E02005966,2013,173,232000,208000,50,30,89,4,0,173,167,6
15232,E02005966,2014,73,231000,217000,12,14,44,3,0,73,66,7
15233,E02005967,2009,62,202000,190000,12,28,16,6,0,62,56,6
15234,E02005967,2010,71,217000,212000,14,31,12,14,9,62,57,14
15235,E02005967,2011,85,204000,197000,18,29,18,20,25,60,62,23
15236,E02005967,2012,187,234000,235000,50,55,56,26,111,76,165,22
15237,E02005967,2013,230,232000,226000,47,90,56,37,149,81,195,35
15238,E02005967,2014,52,251000,249000,10,26,10,6,16,36,45,7
15239,E02005968,2009,50,345000,298000,27,9,12,2,0,50,48,2
15240,E02005968,2010,59,357000,282000,25,19,12,3,0,59,56,3
15241,E02005968,2011,70,396000,328000,34,17,13,6,0,70,64,6
15242,E02005968,2012,84,384000,294000,39,14,25,6,15,69,78,6
15243,E02005968,2013,81,397000,340000,26,21,30,4,17,64,77,4
15244,E02005968,2014,23,465000,340000,10,4,5,4,0,23,19,4
15245,E02005969,2009,146,258000,230000,26,53,35,32,5,141,113,33
15246,E02005969,2010,129,294000,250000,30,46,36,17,8,121,107,22
15247,E02005969,2011,132,292000,250000,23,42,47,20,11,121,111,21
15248,E02005969,2012,145,294000,250000,30,33,58,24,6,139,121,24
15249,E02005969,2013,133,333000,270000,31,45,39,18,0,133,115,18
15250,E02005969,2014,57,321000,250000,8,13,28,8,0,57,49,8
15251,E02005970,2009,71,175000,165000,9,25,19,18,0,71,52,19
15252,E02005970,2010,78,179000,176000,8,33,17,20,2,76,55,23
15253,E02005970,2011,96,179000,175000,5,33,37,21,12,84,74,22
15254,E02005970,2012,83,192000,180000,8,26,34,15,4,79,67,16
15255,E02005970,2013,124,192000,191000,14,40,37,33,0,124,92,32
15256,E02005970,2014,24,192000,187000,2,7,11,4,1,23,18,6
15257,E02005971,2009,65,199000,185000,11,34,14,6,0,65,57,8
15258,E02005971,2010,64,208000,210000,11,32,11,10,0,64,55,9
15259,E02005971,2011,70,217000,211000,9,45,10,6,0,70,64,6
15260,E02005971,2012,68,210000,197000,8,40,16,4,2,66,63,5
15261,E02005971,2013,95,222000,217000,12,57,20,6,1,94,86,9
15262,E02005971,2014,26,254000,244000,4,17,5,0,2,24,26,0
15263,E02005972,2009,108,326000,257000,43,37,12,16,16,92,90,18
15264,E02005972,2010,117,379000,295000,44,44,10,19,1,116,97,20
15265,E02005972,2011,110,379000,346000,37,39,22,12,15,95,98,12
15266,E02005972,2012,169,401000,330000,49,47,38,35,69,100,134,35
15267,E02005972,2013,186,397000,328000,55,49,42,40,54,132,146,40
15268,E02005972,2014,94,387000,346000,22,27,14,31,29,65,62,32
15269,E02005973,2009,92,398000,340000,27,15,28,22,0,92,70,22
15270,E02005973,2010,122,390000,362000,36,21,36,29,1,121,89,33
15271,E02005973,2011,105,385000,308000,29,20,24,32,0,105,74,31
15272,E02005973,2012,116,506000,424000,34,12,40,30,4,112,83,33
15273,E02005973,2013,125,497000,405000,35,30,38,22,1,124,101,24
15274,E02005973,2014,47,487000,405000,12,5,20,10,0,47,37,10
15275,E02005974,2009,107,426000,322000,30,20,31,26,6,101,77,30
15276,E02005974,2010,158,463000,363000,38,26,37,57,28,130,101,57
15277,E02005974,2011,138,457000,381000,29,28,49,32,13,125,105,33
15278,E02005974,2012,123,478000,400000,27,18,50,28,12,111,93,30
15279,E02005974,2013,142,490000,385000,25,22,60,35,7,135,105,37
15280,E02005974,2014,49,578000,375000,9,12,16,12,2,47,37,12
15281,E02005975,2009,82,452000,386000,51,15,8,8,0,82,72,10
15282,E02005975,2010,97,556000,455000,71,15,8,3,0,97,94,3
15283,E02005975,2011,96,493000,426000,53,23,11,9,1,95,87,9
15284,E02005975,2012,107,507000,442000,66,16,18,7,6,101,101,6
15285,E02005975,2013,128,492000,420000,63,36,18,11,12,116,117,11
15286,E02005975,2014,31,538000,455000,18,7,2,4,1,30,27,4
15287,E02005976,2009,53,690000,545000,34,13,6,0,0,53,51,2
15288,E02005976,2010,75,790000,690000,53,16,5,1,0,75,74,1
15289,E02005976,2011,61,730000,625000,45,13,3,0,0,61,61,0
15290,E02005976,2012,49,921000,776000,36,6,6,1,1,48,48,1
15291,E02005976,2013,66,979000,851000,51,11,4,0,2,64,66,0
15292,E02005976,2014,26,924000,675000,17,8,0,1,0,26,25,1
15293,E02005977,2009,60,359000,332000,32,18,9,1,0,60,57,3
15294,E02005977,2010,69,416000,376000,41,19,7,2,0,69,65,4
15295,E02005977,2011,71,390000,337000,38,23,7,3,0,71,67,4
15296,E02005977,2012,68,424000,371000,37,17,12,2,0,68,66,2
15297,E02005977,2013,87,433000,390000,50,24,9,4,6,81,82,5
15298,E02005977,2014,29,470000,468000,19,4,3,3,4,25,25,4
15299,E02005978,2009,104,351000,296000,57,17,9,21,25,79,81,23
15300,E02005978,2010,115,416000,350000,70,24,15,6,24,91,108,7
15301,E02005978,2011,91,381000,280000,40,30,12,9,2,89,79,12
15302,E02005978,2012,107,415000,310000,57,19,19,12,29,78,94,13
15303,E02005978,2013,143,409000,350000,70,39,21,13,42,101,127,16
15304,E02005978,2014,40,466000,393000,23,8,7,2,11,29,38,2
15305,E02005979,2009,119,247000,230000,22,54,6,37,30,89,82,37
15306,E02005979,2010,123,302000,250000,38,59,7,19,2,121,105,18
15307,E02005979,2011,100,309000,262000,30,48,11,11,0,100,88,12
15308,E02005979,2012,124,335000,285000,47,65,5,7,10,114,117,7
15309,E02005979,2013,153,366000,290000,59,62,11,21,5,148,133,20
15310,E02005979,2014,53,358000,330000,15,23,3,12,10,43,41,12
15311,E02005980,2009,82,420000,275000,49,21,6,6,2,80,76,6
15312,E02005980,2010,94,459000,324000,53,21,12,8,0,94,85,9
15313,E02005980,2011,71,406000,325000,46,13,4,8,2,69,63,8
15314,E02005980,2012,101,515000,350000,67,19,12,3,8,93,98,3
15315,E02005980,2013,91,393000,332000,53,24,8,6,0,91,85,6
15316,E02005980,2014,35,369000,318000,17,7,5,6,0,35,29,6
15317,E02005981,2009,114,230000,214000,40,45,20,9,0,114,100,14
15318,E02005981,2010,124,253000,228000,36,45,27,16,0,124,109,15
15319,E02005981,2011,127,244000,230000,42,51,23,11,0,127,116,11
15320,E02005981,2012,122,276000,250000,46,43,27,6,0,122,116,6
15321,E02005981,2013,148,283000,250000,53,46,41,8,0,148,140,8
15322,E02005981,2014,47,285000,285000,23,10,10,4,0,47,43,4
15323,E02005982,2009,94,218000,194000,18,36,29,11,0,94,83,11
15324,E02005982,2010,82,270000,216000,20,32,21,9,0,82,73,9
15325,E02005982,2011,92,259000,220000,21,32,25,14,0,92,77,15
15326,E02005982,2012,98,294000,246000,29,19,37,13,4,94,84,14
15327,E02005982,2013,95,262000,240000,24,23,38,10,1,94,84,11
15328,E02005982,2014,29,260000,240000,6,8,13,2,0,29,27,2
15329,E02005983,2009,178,223000,200000,14,58,52,54,34,144,117,61
15330,E02005983,2010,194,254000,220000,28,50,61,55,25,169,125,69
15331,E02005983,2011,154,252000,217000,19,36,45,54,12,142,93,61
15332,E02005983,2012,160,251000,226000,8,28,57,67,16,144,89,71
15333,E02005983,2013,231,265000,230000,19,39,80,93,23,208,131,100
15334,E02005983,2014,81,276000,235000,6,14,36,25,4,77,53,28
15335,E02005984,2009,76,363000,295000,51,21,4,0,1,75,76,0
15336,E02005984,2010,93,443000,382000,59,25,9,0,2,91,93,0
15337,E02005984,2011,81,461000,363000,47,28,6,0,1,80,81,0
15338,E02005984,2012,78,419000,335000,43,24,10,1,2,76,78,0
15339,E02005984,2013,98,441000,342000,56,28,14,0,8,90,98,0
15340,E02005984,2014,38,480000,384000,17,11,9,1,5,33,37,1
15341,E02005985,2009,82,210000,200000,15,36,21,10,0,82,72,10
15342,E02005985,2010,80,227000,214000,14,28,21,17,0,80,61,19
15343,E02005985,2011,103,219000,200000,10,42,34,17,0,103,84,19
15344,E02005985,2012,92,212000,206000,17,20,36,19,0,92,71,21
15345,E02005985,2013,121,226000,212000,21,23,51,26,0,121,93,28
15346,E02005985,2014,49,273000,250000,12,13,16,8,0,49,39,10
15347,E02005986,2009,41,241000,220000,15,14,10,2,0,41,39,2
15348,E02005986,2010,40,302000,206000,12,11,16,1,0,40,38,2
15349,E02005986,2011,26,228000,206000,10,6,9,1,0,26,25,1
15350,E02005986,2012,27,334000,300000,12,8,6,1,0,27,27,0
15351,E02005986,2013,39,261000,210000,13,9,14,3,0,39,35,4
15352,E02005986,2014,18,233000,215000,7,3,8,0,0,18,17,1
15353,E02005987,2009,71,361000,265000,43,17,6,5,1,70,66,5
15354,E02005987,2010,86,350000,255000,38,36,9,3,3,83,82,4
15355,E02005987,2011,86,341000,298000,41,27,13,5,3,83,81,5
15356,E02005987,2012,83,363000,312000,48,26,7,2,12,71,81,2
15357,E02005987,2013,123,346000,280000,58,34,21,10,1,122,112,11
15358,E02005987,2014,46,333000,264000,16,17,7,6,1,45,40,6
15359,E02005988,2009,98,209000,189000,30,27,36,5,7,91,89,9
15360,E02005988,2010,74,225000,210000,25,28,19,2,0,74,70,4
15361,E02005988,2011,90,241000,214000,40,19,28,3,0,90,87,3
15362,E02005988,2012,84,210000,191000,29,18,36,1,0,84,82,2
15363,E02005988,2013,82,226000,213000,21,19,35,7,0,82,75,7
15364,E02005988,2014,34,228000,216000,9,4,19,2,0,34,32,2
15365,E02005991,2009,152,194000,175000,21,40,26,65,35,117,87,65
15366,E02005991,2010,124,234000,210000,28,39,28,29,17,107,92,32
15367,E02005991,2011,139,231000,224000,31,52,26,30,9,130,105,34
15368,E02005991,2012,113,239000,240000,28,34,31,20,4,109,91,22
15369,E02005991,2013,166,231000,205000,30,44,44,48,12,154,116,50
15370,E02005991,2014,50,270000,240000,17,6,13,14,3,47,35,15
15371,E02005992,2009,98,304000,250000,44,31,18,5,2,96,89,9
15372,E02005992,2010,114,345000,312000,55,25,25,9,5,109,101,13
15373,E02005992,2011,128,323000,291000,47,26,37,18,31,97,105,23
15374,E02005992,2012,146,357000,316000,65,48,24,9,33,113,135,11
15375,E02005992,2013,227,356000,300000,98,56,60,13,85,142,213,14
15376,E02005992,2014,45,372000,290000,20,11,11,3,11,34,40,5
15377,E02005994,2009,22,256000,212000,10,8,4,0,0,22,22,0
15378,E02005994,2010,24,404000,262000,13,7,4,0,0,24,24,0
15379,E02005994,2011,19,319000,262000,10,7,2,0,0,19,19,0
15380,E02005994,2012,17,305000,245000,10,4,3,0,0,17,17,0
15381,E02005994,2013,34,287000,262000,18,12,4,0,0,34,34,0
15382,E02005994,2014,8,244000,230000,4,2,1,1,0,8,7,1
15383,E02005996,2009,121,343000,305000,55,34,23,9,1,120,110,11
15384,E02005996,2010,137,348000,282000,46,41,32,18,16,121,119,18
15385,E02005996,2011,126,330000,280000,48,39,30,9,26,100,112,14
15386,E02005996,2012,129,361000,313000,37,27,39,26,25,104,101,28
15387,E02005996,2013,142,374000,324000,34,36,53,19,17,125,120,22
15388,E02005996,2014,42,351000,312000,14,7,14,7,3,39,35,7
15389,E02005997,2009,21,277000,250000,12,5,4,0,0,21,21,0
15390,E02005997,2010,23,428000,395000,14,8,1,0,0,23,22,1
15391,E02005997,2011,22,326000,276000,9,4,9,0,0,22,22,0
15392,E02005997,2012,18,332000,282000,6,10,2,0,0,18,18,0
15393,E02005997,2013,27,389000,301000,17,7,3,0,0,27,27,0
15394,E02005997,2014,5,406000,350000,5,0,0,0,0,5,5,0
15395,E02005998,2009,64,279000,250000,25,21,14,4,0,64,60,4
15396,E02005998,2010,73,323000,285000,33,17,18,5,0,73,68,5
15397,E02005998,2011,92,364000,305000,45,23,19,5,18,74,85,7
15398,E02005998,2012,93,318000,290000,35,26,23,9,20,73,84,9
15399,E02005998,2013,92,364000,314000,45,22,18,7,20,72,85,7
15400,E02005998,2014,32,377000,318000,13,8,9,2,4,28,30,2
15401,E02005999,2009,30,304000,231000,11,9,10,0,7,23,29,1
15402,E02005999,2010,44,300000,286000,20,12,11,1,4,40,41,3
15403,E02005999,2011,34,310000,250000,11,10,9,4,2,32,29,5
15404,E02005999,2012,24,331000,285000,14,6,3,1,0,24,23,1
15405,E02005999,2013,40,340000,296000,23,9,7,1,0,40,39,1
15406,E02005999,2014,8,402000,316000,3,2,3,0,0,8,8,0
15407,E02006000,2009,190,215000,198000,36,66,50,38,16,174,149,41
15408,E02006000,2010,212,230000,211000,43,63,59,47,1,211,163,49
15409,E02006000,2011,182,246000,222000,41,48,56,37,0,182,145,37
15410,E02006000,2012,167,255000,234000,37,38,63,29,0,167,139,28
15411,E02006000,2013,218,259000,230000,46,52,73,47,5,213,172,46
15412,E02006000,2014,81,267000,245000,13,15,35,18,3,78,64,17
15413,E02006001,2009,57,172000,163000,8,23,23,3,0,57,53,4
15414,E02006001,2010,56,202000,183000,9,23,20,4,5,51,52,4
15415,E02006001,2011,63,217000,197000,20,19,23,1,3,60,62,1
15416,E02006001,2012,61,214000,205000,11,15,21,14,10,51,49,12
15417,E02006001,2013,67,223000,202000,13,16,32,6,0,67,62,5
15418,E02006001,2014,26,219000,201000,6,5,13,2,0,26,25,1
15419,E02006002,2009,237,193000,170000,30,53,57,97,86,151,130,107
15420,E02006002,2010,221,189000,168000,25,51,33,112,76,145,105,116
15421,E02006002,2011,184,208000,200000,23,47,54,60,15,169,114,70
15422,E02006002,2012,135,214000,210000,17,34,46,38,9,126,90,45
15423,E02006002,2013,195,221000,215000,25,36,64,70,6,189,117,78
15424,E02006002,2014,78,247000,235000,8,19,31,20,12,66,57,21
15425,E02006003,2009,53,314000,250000,20,21,12,0,1,52,52,1
15426,E02006003,2010,57,300000,242000,22,18,15,2,0,57,55,2
15427,E02006003,2011,63,288000,230000,15,30,18,0,1,62,61,2
15428,E02006003,2012,51,366000,290000,24,8,18,1,6,45,50,1
15429,E02006003,2013,61,325000,283000,21,20,19,1,4,57,58,3
15430,E02006003,2014,23,326000,285000,7,9,7,0,0,23,23,0
15431,E02006007,2009,29,351000,310000,19,4,3,3,1,28,25,4
15432,E02006007,2010,40,380000,333000,22,11,5,2,2,38,38,2
15433,E02006007,2011,40,349000,300000,21,11,5,3,0,40,37,3
15434,E02006007,2012,21,552000,383000,13,1,7,0,0,21,21,0
15435,E02006007,2013,42,336000,277000,24,10,5,3,0,42,39,3
15436,E02006007,2014,10,507000,336000,5,1,4,0,1,9,10,0
15437,E02006227,2009,97,260000,240000,44,24,26,3,2,95,94,3
15438,E02006227,2010,104,345000,281000,50,27,23,4,2,102,97,7
15439,E02006227,2011,78,305000,278000,43,18,15,2,2,76,75,3
15440,E02006227,2012,89,322000,280000,45,18,26,0,5,84,89,0
15441,E02006227,2013,91,369000,300000,52,27,11,1,6,85,90,1
15442,E02006227,2014,39,328000,285000,18,7,14,0,0,39,38,1
15443,E02006228,2009,81,217000,178000,43,19,19,0,0,81,81,0
15444,E02006228,2010,88,218000,184000,36,22,22,8,3,85,79,9
15445,E02006228,2011,74,242000,191000,31,29,14,0,6,68,74,0
15446,E02006228,2012,75,201000,175000,31,23,20,1,3,72,74,1
15447,E02006228,2013,121,207000,176000,45,35,36,5,23,98,116,5
15448,E02006228,2014,40,220000,197000,15,16,9,0,10,30,40,0
15449,E02006229,2009,95,209000,185000,36,21,36,2,9,86,91,4
15450,E02006229,2010,102,230000,196000,40,24,25,13,15,87,88,14
15451,E02006229,2011,97,238000,205000,40,31,21,5,13,84,92,5
15452,E02006229,2012,81,231000,205000,34,15,28,4,2,79,77,4
15453,E02006229,2013,105,237000,210000,42,33,27,3,1,104,101,4
15454,E02006229,2014,32,315000,230000,13,9,10,0,1,31,31,1
15455,E02006230,2009,115,202000,175000,45,43,26,1,7,108,113,2
15456,E02006230,2010,125,271000,215000,61,45,18,1,2,123,124,1
15457,E02006230,2011,95,201000,180000,31,31,27,6,0,95,90,5
15458,E02006230,2012,151,206000,190000,61,41,46,3,26,125,148,3
15459,E02006230,2013,167,234000,200000,78,40,44,5,39,128,163,4
15460,E02006230,2014,46,243000,227000,23,12,11,0,7,39,46,0
15461,E02006231,2009,2,449000,449000,2,0,0,0,0,2,2,0
15462,E02006231,2010,5,309000,305000,5,0,0,0,0,5,5,0
15463,E02006231,2012,4,399000,412000,3,1,0,0,0,4,4,0
15464,E02006231,2013,4,274000,268000,3,1,0,0,0,4,4,0
15465,E02006231,2014,1,675000,675000,1,0,0,0,0,1,1,0
15466,E02006232,2009,80,212000,174000,32,22,22,4,0,80,76,4
15467,E02006232,2010,77,265000,235000,44,17,15,1,2,75,75,2
15468,E02006232,2011,78,277000,232000,43,19,14,2,0,78,76,2
15469,E02006232,2012,104,227000,191000,51,31,18,4,20,84,100,4
15470,E02006232,2013,107,248000,210000,55,25,25,2,22,85,105,2
15471,E02006232,2014,50,253000,230000,22,15,12,1,13,37,49,1
15472,E02006233,2009,187,163000,142000,53,42,77,15,26,161,163,24
15473,E02006233,2010,148,166000,152000,30,27,76,15,7,141,127,21
15474,E02006233,2011,150,160000,150000,30,29,72,19,0,150,128,22
15475,E02006233,2012,185,182000,162000,47,36,84,18,8,177,165,20
15476,E02006233,2013,180,163000,151000,36,36,87,21,2,178,157,23
15477,E02006233,2014,72,167000,155000,9,13,38,12,0,72,61,11
15478,E02006234,2009,149,164000,148000,43,46,45,15,50,99,131,18
15479,E02006234,2010,149,203000,179000,49,59,38,3,61,88,146,3
15480,E02006234,2011,158,174000,158000,50,55,50,3,58,100,154,4
15481,E02006234,2012,114,196000,170000,39,36,31,8,16,98,106,8
15482,E02006234,2013,134,174000,162000,37,44,40,13,20,114,120,14
15483,E02006234,2014,46,183000,165000,11,18,13,4,0,46,42,4
15484,E02006235,2009,96,335000,275000,57,18,19,2,1,95,94,2
15485,E02006235,2010,114,339000,288000,70,21,23,0,1,113,113,1
15486,E02006235,2011,101,320000,250000,46,28,25,2,0,101,99,2
15487,E02006235,2012,82,407000,320000,50,17,15,0,0,82,82,0
15488,E02006235,2013,96,333000,289000,47,27,22,0,0,96,96,0
15489,E02006235,2014,35,292000,250000,17,6,11,1,0,35,34,1
15490,E02006236,2009,113,255000,230000,73,28,11,1,0,113,111,2
15491,E02006236,2010,118,270000,240000,80,29,8,1,1,117,117,1
15492,E02006236,2011,139,252000,216000,73,45,17,4,9,130,131,8
15493,E02006236,2012,134,284000,233000,85,28,19,2,3,131,131,3
15494,E02006236,2013,133,301000,242000,84,34,14,1,7,126,128,5
15495,E02006236,2014,52,280000,255000,34,10,7,1,1,51,51,1
15496,E02006237,2010,1,356000,356000,1,0,0,0,0,1,1,0
15497,E02006237,2012,2,552000,552000,2,0,0,0,0,2,2,0
15498,E02006240,2009,2,173000,173000,1,1,0,0,1,1,2,0
15499,E02006240,2010,4,357000,342000,3,0,0,1,0,4,4,0
15500,E02006240,2011,8,260000,239000,5,3,0,0,0,8,8,0
15501,E02006240,2012,3,251000,272000,2,1,0,0,0,3,3,0
15502,E02006240,2013,8,316000,296000,5,3,0,0,1,7,8,0
15503,E02006242,2009,198,195000,184000,76,47,63,12,130,68,192,6
15504,E02006242,2010,222,212000,197000,99,57,49,17,140,82,201,21
15505,E02006242,2011,200,193000,180000,62,49,76,13,107,93,177,23
15506,E02006242,2012,201,197000,175000,64,52,77,8,122,79,194,7
15507,E02006242,2013,229,206000,181000,89,52,76,12,99,130,208,21
15508,E02006242,2014,67,208000,180000,20,19,22,6,14,53,60,7
15509,E02006243,2009,185,153000,132000,29,34,99,23,6,179,160,25
15510,E02006243,2010,135,176000,143000,22,25,68,20,16,119,109,26
15511,E02006243,2011,134,172000,140000,24,34,62,14,5,129,111,23
15512,E02006243,2012,127,199000,150000,27,19,66,15,5,122,105,22
15513,E02006243,2013,144,201000,150000,32,24,64,24,10,134,117,27
15514,E02006243,2014,66,173000,154000,8,10,38,10,5,61,55,11
15515,E02006266,2010,2,617000,617000,2,0,0,0,0,2,2,0
15516,E02006276,2009,16,263000,188000,10,5,1,0,1,15,16,0
15517,E02006276,2010,6,178000,176000,2,2,2,0,0,6,6,0
15518,E02006276,2011,13,266000,207000,5,7,1,0,0,13,13,0
15519,E02006276,2012,10,236000,205000,4,3,2,1,0,10,9,1
15520,E02006276,2013,14,226000,188000,4,5,4,1,0,14,13,1
15521,E02006276,2014,2,150000,150000,0,1,1,0,0,2,2,0
15522,E02006278,2009,23,186000,145000,4,4,9,6,2,21,17,6
15523,E02006278,2010,14,257000,226000,1,5,4,4,0,14,10,4
15524,E02006278,2011,14,212000,200000,1,5,7,1,1,13,12,2
15525,E02006278,2012,20,230000,216000,2,3,12,3,4,16,18,2
15526,E02006278,2013,13,272000,282000,2,0,10,1,0,13,12,1
15527,E02006278,2014,6,375000,425000,3,0,3,0,2,4,6,0
15528,E02006279,2009,109,186000,160000,37,40,28,4,4,105,104,5
15529,E02006279,2010,109,202000,180000,39,44,19,7,2,107,100,9
15530,E02006279,2011,109,200000,181000,34,46,26,3,0,109,105,4
15531,E02006279,2012,91,195000,172000,21,39,27,4,0,91,85,6
15532,E02006279,2013,117,211000,182000,29,48,36,4,0,117,113,4
15533,E02006279,2014,42,192000,172000,10,18,12,2,0,42,40,2
15534,E02006280,2009,93,260000,240000,52,27,13,1,7,86,90,3
15535,E02006280,2010,90,275000,240000,55,25,10,0,0,90,90,0
15536,E02006280,2011,104,275000,240000,60,16,17,11,9,95,93,11
15537,E02006280,2012,94,274000,228000,51,23,13,7,8,86,87,7
15538,E02006280,2013,112,291000,244000,63,27,22,0,0,112,111,1
15539,E02006280,2014,38,280000,244000,20,10,7,1,0,38,37,1
15540,E02006281,2009,110,183000,162000,20,18,27,45,42,68,66,44
15541,E02006281,2010,76,225000,196000,28,10,29,9,10,66,69,7
15542,E02006281,2011,73,242000,210000,35,19,14,5,3,70,66,7
15543,E02006281,2012,77,238000,240000,31,17,24,5,3,74,72,5
15544,E02006281,2013,79,240000,210000,32,17,26,4,1,78,76,3
15545,E02006281,2014,23,253000,225000,11,8,4,0,0,23,23,0
15546,E02006282,2009,87,281000,225000,52,16,14,5,0,87,82,5
15547,E02006282,2010,87,294000,245000,47,26,12,2,0,87,85,2
15548,E02006282,2011,77,323000,235000,52,18,7,0,0,77,76,1
15549,E02006282,2012,72,274000,245000,43,18,10,1,1,71,70,2
15550,E02006282,2013,114,297000,250000,71,26,14,3,6,108,111,3
15551,E02006282,2014,31,324000,278000,23,4,4,0,1,30,31,0
15552,E02006283,2009,62,220000,174000,25,26,11,0,1,61,61,1
15553,E02006283,2010,77,311000,232000,49,21,7,0,0,77,77,0
15554,E02006283,2011,63,288000,202000,25,28,10,0,1,62,63,0
15555,E02006283,2012,84,272000,212000,43,30,11,0,0,84,84,0
15556,E02006283,2013,118,292000,220000,59,42,17,0,1,117,118,0
15557,E02006283,2014,27,313000,250000,13,8,6,0,0,27,27,0
15558,E02006284,2009,84,156000,153000,24,24,32,4,1,83,78,6
15559,E02006284,2010,104,140000,133000,18,24,43,19,16,88,85,19
15560,E02006284,2011,86,170000,158000,25,27,32,2,0,86,80,6
15561,E02006284,2012,114,162000,159000,24,41,45,4,0,114,109,5
15562,E02006284,2013,110,165000,156000,22,33,50,5,1,109,103,7
15563,E02006284,2014,39,176000,165000,11,7,17,4,0,39,34,5
15564,E02006285,2009,135,157000,148000,43,25,55,12,23,112,124,11
15565,E02006285,2010,117,166000,160000,35,25,51,6,20,97,112,5
15566,E02006285,2011,127,164000,153000,33,27,65,2,18,109,125,2
15567,E02006285,2012,130,168000,155000,42,38,45,5,4,126,125,5
15568,E02006285,2013,122,183000,167000,43,20,57,2,0,122,120,2
15569,E02006285,2014,43,175000,149000,13,5,23,2,0,43,41,2
15570,E02006286,2009,137,134000,123000,29,29,73,6,17,120,125,12
15571,E02006286,2010,133,154000,140000,30,33,61,9,1,132,122,11
15572,E02006286,2011,136,143000,130000,23,30,71,12,2,134,121,15
15573,E02006286,2012,129,155000,138000,32,18,70,9,0,129,120,9
15574,E02006286,2013,175,155000,138000,38,24,102,11,5,170,164,11
15575,E02006286,2014,62,161000,145000,9,16,32,5,9,53,57,5
15576,E02006317,2009,74,281000,275000,7,31,27,9,0,74,63,11
15577,E02006317,2010,91,300000,290000,16,21,35,19,0,91,70,21
15578,E02006317,2011,83,310000,295000,16,29,26,12,1,82,69,14
15579,E02006317,2012,92,328000,308000,15,30,33,14,3,89,72,20
15580,E02006317,2013,99,343000,318000,16,30,41,12,0,99,85,14
15581,E02006317,2014,29,348000,325000,3,6,13,7,0,29,21,8
15582,E02006318,2009,104,471000,366000,32,24,22,26,1,103,78,26
15583,E02006318,2010,123,536000,475000,36,35,27,25,1,122,100,23
15584,E02006318,2011,105,597000,455000,32,17,23,33,0,105,72,33
15585,E02006318,2012,130,599000,468000,41,31,22,36,12,118,94,36
15586,E02006318,2013,157,726000,585000,47,41,26,43,9,148,108,49
15587,E02006318,2014,55,908000,700000,18,10,14,13,0,55,42,13
15588,E02006319,2009,75,253000,222000,14,26,31,4,1,74,71,4
15589,E02006319,2010,88,274000,260000,7,40,29,12,0,88,74,14
15590,E02006319,2011,98,264000,245000,7,34,45,12,0,98,86,12
15591,E02006319,2012,106,295000,250000,12,46,37,11,0,106,95,11
15592,E02006319,2013,124,295000,272000,12,43,58,11,0,124,113,11
15593,E02006319,2014,28,293000,258000,3,8,8,9,0,28,18,10
15594,E02006320,2009,78,225000,233000,9,23,28,18,3,75,60,18
15595,E02006320,2010,85,239000,240000,10,30,29,16,1,84,68,17
15596,E02006320,2011,80,257000,255000,11,29,23,17,1,79,63,17
15597,E02006320,2012,103,289000,283000,18,32,32,21,9,94,82,21
15598,E02006320,2013,156,276000,269000,7,47,66,36,12,144,119,37
15599,E02006320,2014,44,321000,322000,6,18,12,8,1,43,36,8
15600,E02006321,2009,102,466000,456000,32,22,17,31,4,98,69,33
15601,E02006321,2010,117,500000,385000,24,36,19,38,9,108,73,44
15602,E02006321,2011,123,543000,500000,30,41,21,31,3,120,88,35
15603,E02006321,2012,108,502000,459000,22,22,26,38,2,106,70,38
15604,E02006321,2013,130,602000,555000,27,32,31,40,0,130,90,40
15605,E02006321,2014,46,644000,624000,9,15,10,12,0,46,35,11
15606,E02006322,2009,106,437000,410000,24,38,35,9,0,106,95,11
15607,E02006322,2010,102,501000,468000,17,30,41,14,0,102,87,15
15608,E02006322,2011,103,518000,435000,26,28,35,14,1,102,89,14
15609,E02006322,2012,105,560000,499000,19,30,44,12,14,91,92,13
15610,E02006322,2013,155,566000,475000,34,35,54,32,8,147,123,32
15611,E02006322,2014,33,652000,625000,9,5,18,1,0,33,31,2
15612,E02006323,2009,145,344000,250000,26,23,15,81,56,89,63,82
15613,E02006323,2010,137,481000,290000,35,24,22,56,17,120,80,57
15614,E02006323,2011,138,469000,318000,36,28,17,57,10,128,79,59
15615,E02006323,2012,117,416000,310000,30,20,16,51,2,115,66,51
15616,E02006323,2013,175,497000,385000,42,44,25,64,18,157,110,65
15617,E02006323,2014,61,396000,250000,10,7,7,37,0,61,24,37
15618,E02006324,2009,90,334000,308000,18,46,21,5,3,87,84,6
15619,E02006324,2010,101,358000,317000,25,48,17,11,3,98,89,12
15620,E02006324,2011,121,331000,300000,16,53,26,26,13,108,91,30
15621,E02006324,2012,122,368000,348000,17,57,34,14,11,111,108,14
15622,E02006324,2013,187,388000,370000,31,77,39,40,41,146,147,40
15623,E02006324,2014,64,446000,412000,15,29,11,9,4,60,55,9
15624,E02006325,2009,129,473000,490000,64,23,8,34,10,119,96,33
15625,E02006325,2010,160,524000,500000,72,35,16,37,28,132,120,40
15626,E02006325,2011,217,457000,460000,64,48,27,78,81,136,138,79
15627,E02006325,2012,182,647000,660000,97,47,16,22,39,143,160,22
15628,E02006325,2013,188,621000,632000,79,56,9,44,8,180,144,44
15629,E02006325,2014,58,654000,700000,29,11,2,16,0,58,42,16
15630,E02006326,2009,104,359000,298000,30,20,25,29,4,100,72,32
15631,E02006326,2010,117,482000,360000,35,23,18,41,2,115,75,42
15632,E02006326,2011,157,371000,320000,35,46,30,46,22,135,109,48
15633,E02006326,2012,107,513000,400000,28,26,27,26,11,96,81,26
15634,E02006326,2013,175,480000,356000,42,47,28,58,25,150,116,59
15635,E02006326,2014,47,546000,425000,14,7,8,18,2,45,29,18
15636,E02006327,2009,144,486000,390000,47,15,33,49,11,133,93,51
15637,E02006327,2010,129,592000,465000,45,18,28,38,0,129,87,42
15638,E02006327,2011,140,482000,400000,35,17,40,48,13,127,87,53
15639,E02006327,2012,128,558000,435000,32,16,39,41,6,122,86,42
15640,E02006327,2013,162,583000,446000,43,14,51,54,2,160,101,61
15641,E02006327,2014,54,589000,450000,11,3,20,20,0,54,32,22
15642,E02006328,2009,184,403000,351000,50,32,52,50,5,179,130,54
15643,E02006328,2010,204,463000,392000,46,53,44,61,7,197,140,64
15644,E02006328,2011,230,473000,374000,48,46,49,87,20,210,138,92
15645,E02006328,2012,175,458000,330000,36,31,36,72,4,171,101,74
15646,E02006328,2013,259,498000,380000,51,48,66,94,4,255,164,95
15647,E02006328,2014,76,498000,440000,15,18,16,27,0,76,49,27
15648,E02006329,2009,125,799000,616000,61,19,19,26,14,111,99,26
15649,E02006329,2010,144,879000,618000,63,24,20,37,13,131,105,39
15650,E02006329,2011,127,912000,705000,51,16,18,42,9,118,84,43
15651,E02006329,2012,119,1030000,900000,56,12,18,33,17,102,86,33
15652,E02006329,2013,168,1107000,810000,73,24,27,44,27,141,123,45
15653,E02006329,2014,59,1296000,1000000,27,6,7,19,9,50,40,19
15654,E02006330,2009,136,547000,280000,41,49,18,28,18,118,105,31
15655,E02006330,2010,138,597000,313000,48,50,27,13,5,133,120,18
15656,E02006330,2011,153,605000,323000,47,58,25,23,9,144,125,28
15657,E02006330,2012,162,631000,336000,46,66,30,20,15,147,135,27
15658,E02006330,2013,186,584000,354000,48,66,44,28,34,152,158,28
15659,E02006330,2014,63,707000,385000,15,28,11,9,2,61,53,10
15660,E02006331,2009,90,482000,414000,43,29,16,2,5,85,87,3
15661,E02006331,2010,117,578000,499000,44,49,12,12,1,116,104,13
15662,E02006331,2011,113,644000,590000,53,40,11,9,0,113,103,10
15663,E02006331,2012,109,691000,565000,49,34,14,12,4,105,97,12
15664,E02006331,2013,122,698000,628000,53,43,15,11,0,122,111,11
15665,E02006331,2014,44,639000,550000,13,15,8,8,0,44,36,8
15666,E02006332,2009,98,725000,510000,36,13,11,38,18,80,58,40
15667,E02006332,2010,129,816000,475000,38,17,27,47,20,109,78,51
15668,E02006332,2011,130,986000,550000,58,24,14,34,18,112,95,35
15669,E02006332,2012,110,1156000,480000,44,13,27,26,3,107,82,28
15670,E02006332,2013,135,1072000,500000,46,17,29,43,10,125,90,45
15671,E02006332,2014,32,778000,480000,10,5,4,13,1,31,19,13
15672,E02006333,2009,156,823000,518000,82,26,27,21,8,148,134,22
15673,E02006333,2010,186,722000,492000,81,47,35,23,9,177,159,27
15674,E02006333,2011,164,715000,449000,60,45,36,23,8,156,141,23
15675,E02006333,2012,143,830000,480000,57,35,26,25,9,134,118,25
15676,E02006333,2013,184,928000,560000,86,33,30,35,6,178,148,36
15677,E02006333,2014,55,861000,530000,20,14,13,8,3,52,47,8
15678,E02006334,2009,171,909000,635000,111,42,7,11,32,139,156,15
15679,E02006334,2010,151,964000,795000,107,22,5,17,3,148,129,22
15680,E02006334,2011,158,1203000,825000,111,17,6,24,6,152,133,25
15681,E02006334,2012,133,1120000,825000,91,28,4,10,2,131,122,11
15682,E02006334,2013,175,1326000,945000,125,27,8,15,10,165,161,14
15683,E02006334,2014,53,1510000,926000,38,5,6,4,0,53,49,4
15684,E02006335,2009,84,306000,290000,20,32,18,14,7,77,69,15
15685,E02006335,2010,106,334000,316000,22,42,27,15,0,106,86,20
15686,E02006335,2011,93,380000,335000,36,26,17,14,7,86,77,16
15687,E02006335,2012,119,355000,325000,28,43,17,31,0,119,90,29
15688,E02006335,2013,109,364000,340000,29,34,21,25,0,109,83,26
15689,E02006335,2014,32,440000,418000,13,6,4,9,0,32,23,9
15690,E02006336,2009,74,220000,214000,3,35,13,23,0,74,47,27
15691,E02006336,2010,66,251000,239000,6,30,7,23,0,66,42,24
15692,E02006336,2011,88,236000,236000,1,41,21,25,0,88,55,33
15693,E02006336,2012,113,249000,250000,5,52,26,30,0,113,79,34
15694,E02006336,2013,150,262000,246000,8,37,42,63,32,118,82,68
15695,E02006336,2014,44,300000,291000,1,14,13,16,5,39,28,16
15696,E02006337,2009,80,309000,328000,9,54,8,9,0,80,72,8
15697,E02006337,2010,150,354000,360000,27,93,21,9,25,125,139,11
15698,E02006337,2011,113,355000,368000,13,76,14,10,5,108,102,11
15699,E02006337,2012,98,364000,375000,17,70,5,6,0,98,92,6
15700,E02006337,2013,101,423000,435000,12,80,1,8,0,101,93,8
15701,E02006337,2014,30,436000,460000,3,19,4,4,0,30,26,4
15702,E02006338,2009,74,267000,274000,13,29,27,5,3,71,68,6
15703,E02006338,2010,88,312000,311000,19,43,24,2,2,86,83,5
15704,E02006338,2011,93,316000,322000,27,44,18,4,2,91,86,7
15705,E02006338,2012,105,319000,318000,22,44,31,8,7,98,95,10
15706,E02006338,2013,117,346000,345000,30,56,26,5,1,116,110,7
15707,E02006338,2014,34,342000,358000,6,12,11,5,0,34,26,8
15708,E02006339,2009,109,277000,215000,24,19,29,37,8,101,68,41
15709,E02006339,2010,226,330000,300000,65,60,58,43,85,141,178,48
15710,E02006339,2011,267,355000,335000,87,57,59,64,115,152,198,69
15711,E02006339,2012,237,338000,310000,41,60,59,77,110,127,158,79
15712,E02006339,2013,262,339000,319000,40,42,57,123,94,168,136,126
15713,E02006339,2014,70,365000,334000,12,15,21,22,1,69,48,22
15714,E02006341,2009,126,282000,250000,24,46,26,30,5,121,95,31
15715,E02006341,2010,149,315000,280000,24,57,38,30,1,148,116,33
15716,E02006341,2011,124,300000,250000,18,41,35,30,0,124,93,31
15717,E02006341,2012,134,344000,308000,26,49,29,30,0,134,104,30
15718,E02006341,2013,157,343000,322000,28,48,39,42,1,156,115,42
15719,E02006341,2014,70,316000,308000,7,21,10,32,2,68,38,32
15720,E02006342,2009,185,249000,227000,16,21,21,127,63,122,57,128
15721,E02006342,2010,164,303000,245000,23,19,21,101,35,129,58,106
15722,E02006342,2011,158,297000,250000,19,20,18,101,43,115,56,102
15723,E02006342,2012,133,323000,250000,16,17,17,83,13,120,48,85
15724,E02006342,2013,182,282000,245000,19,21,14,128,16,166,53,129
15725,E02006342,2014,83,290000,250000,5,4,3,71,0,83,12,71
15726,E02006343,2009,106,407000,348000,49,25,15,17,1,105,87,19
15727,E02006343,2010,105,480000,376000,46,27,17,15,0,105,88,17
15728,E02006343,2011,112,468000,340000,53,28,14,17,3,109,93,19
15729,E02006343,2012,118,433000,352000,49,42,13,14,4,114,102,16
15730,E02006343,2013,160,486000,401000,73,35,33,19,26,134,137,23
15731,E02006343,2014,48,515000,478000,21,13,6,8,1,47,39,9
15732,E02006344,2009,91,429000,325000,42,38,10,1,2,89,89,2
15733,E02006344,2010,123,568000,425000,71,33,13,6,6,117,117,6
15734,E02006344,2011,128,537000,436000,68,48,9,3,6,122,125,3
15735,E02006344,2012,98,519000,439000,52,26,13,7,9,89,89,9
15736,E02006344,2013,104,524000,418000,54,34,9,7,10,94,96,8
15737,E02006344,2014,39,558000,490000,19,8,10,2,2,37,37,2
15738,E02006345,2009,56,437000,382000,34,14,7,1,0,56,55,1
15739,E02006345,2010,56,511000,421000,34,16,3,3,1,55,51,5
15740,E02006345,2011,48,434000,400000,30,15,1,2,0,48,45,3
15741,E02006345,2012,62,476000,386000,32,24,3,3,6,56,59,3
15742,E02006345,2013,59,470000,385000,33,21,4,1,0,59,58,1
15743,E02006345,2014,26,559000,495000,16,4,3,3,0,26,22,4
15744,E02006346,2009,154,545000,500000,102,31,6,15,2,152,138,16
15745,E02006346,2010,144,615000,548000,91,34,11,8,16,128,125,19
15746,E02006346,2011,146,678000,615000,97,22,14,13,13,133,121,25
15747,E02006346,2012,137,733000,650000,93,26,7,11,18,119,125,12
15748,E02006346,2013,161,666000,625000,117,29,7,8,1,160,151,10
15749,E02006346,2014,47,853000,790000,31,8,2,6,0,47,41,6
15750,E02006347,2009,112,224000,200000,28,36,29,19,0,112,93,19
15751,E02006347,2010,111,240000,215000,20,40,45,6,0,111,104,7
15752,E02006347,2011,101,229000,212000,24,30,39,8,0,101,93,8
15753,E02006347,2012,126,241000,240000,38,38,33,17,0,126,110,16
15754,E02006347,2013,150,231000,220000,32,40,57,21,1,149,127,23
15755,E02006347,2014,51,274000,250000,16,12,15,8,0,51,42,9
15756,E02006348,2009,137,291000,248000,29,61,31,16,23,114,115,22
15757,E02006348,2010,106,320000,298000,34,36,30,6,8,98,100,6
15758,E02006348,2011,112,354000,293000,36,42,20,14,2,110,99,13
15759,E02006348,2012,102,332000,288000,23,40,27,12,0,102,89,13
15760,E02006348,2013,136,363000,329000,38,62,26,10,9,127,126,10
15761,E02006348,2014,43,343000,315000,10,18,7,8,0,43,34,9
15762,E02006349,2009,136,241000,235000,32,36,31,37,9,127,92,44
15763,E02006349,2010,107,281000,270000,25,47,22,13,0,107,93,14
15764,E02006349,2011,141,263000,248000,25,38,50,28,1,140,111,30
15765,E02006349,2012,156,273000,250000,27,46,49,34,8,148,115,41
15766,E02006349,2013,169,285000,269000,34,47,43,45,6,163,120,49
15767,E02006349,2014,48,353000,320000,17,14,12,5,0,48,42,6
15768,E02006350,2009,69,225000,220000,3,29,24,13,8,61,56,13
15769,E02006350,2010,66,246000,250000,4,39,16,7,0,66,58,8
15770,E02006350,2011,63,227000,230000,2,31,16,14,5,58,49,14
15771,E02006350,2012,62,230000,237000,2,29,21,10,0,62,51,11
15772,E02006350,2013,66,245000,250000,1,38,21,6,0,66,60,6
15773,E02006350,2014,22,290000,290000,0,13,8,1,0,22,21,1
15774,E02006351,2009,123,274000,240000,25,46,35,17,0,123,106,17
15775,E02006351,2010,136,303000,250000,33,46,26,31,11,125,107,29
15776,E02006351,2011,139,340000,312000,38,42,39,20,25,114,118,21
15777,E02006351,2012,121,341000,310000,31,30,42,18,12,109,102,19
15778,E02006351,2013,128,316000,272000,25,39,41,23,0,128,103,25
15779,E02006351,2014,49,339000,290000,11,9,20,9,0,49,40,9
15780,E02006352,2009,65,236000,238000,18,40,4,3,0,65,60,5
15781,E02006352,2010,85,266000,250000,20,52,5,8,0,85,75,10
15782,E02006352,2011,78,279000,273000,18,49,8,3,7,71,73,5
15783,E02006352,2012,57,293000,282000,16,37,4,0,0,57,55,2
15784,E02006352,2013,72,299000,285000,20,48,4,0,1,71,70,2
15785,E02006352,2014,32,280000,300000,6,18,6,2,0,32,30,2
15786,E02006353,2009,92,191000,183000,13,45,20,14,9,83,76,16
15787,E02006353,2010,74,219000,206000,10,34,21,9,0,74,63,11
15788,E02006353,2011,89,210000,200000,12,44,18,15,0,89,72,17
15789,E02006353,2012,63,215000,225000,8,34,11,10,4,59,53,10
15790,E02006353,2013,88,225000,210000,18,24,33,13,1,87,75,13
15791,E02006353,2014,39,229000,228000,7,13,11,8,0,39,31,8
15792,E02006354,2009,125,399000,335000,54,25,19,27,5,120,92,33
15793,E02006354,2010,194,481000,432000,80,38,33,43,33,161,146,48
15794,E02006354,2011,165,444000,370000,52,35,25,53,35,130,108,57
15795,E02006354,2012,161,502000,500000,59,31,31,40,33,128,120,41
15796,E02006354,2013,189,543000,475000,88,28,20,53,17,172,130,59
15797,E02006354,2014,60,498000,387000,20,8,8,24,1,59,33,27
15798,E02006355,2009,57,220000,220000,3,39,4,11,0,57,44,13
15799,E02006355,2010,43,252000,238000,3,35,2,3,0,43,39,4
15800,E02006355,2011,45,267000,250000,4,35,2,4,0,45,41,4
15801,E02006355,2012,41,234000,236000,2,28,3,8,0,41,33,8
15802,E02006355,2013,49,256000,250000,2,37,4,6,0,49,41,8
15803,E02006355,2014,27,257000,263000,1,19,2,5,1,26,22,5
15804,E02006356,2009,248,282000,248000,19,47,22,160,61,187,81,167
15805,E02006356,2010,224,317000,278000,17,49,36,122,10,214,96,128
15806,E02006356,2011,220,319000,250000,26,38,23,133,13,207,80,140
15807,E02006356,2012,288,358000,300000,24,50,41,173,57,231,112,176
15808,E02006356,2013,316,351000,300000,20,67,50,179,27,289,133,183
15809,E02006356,2014,90,383000,305000,9,13,13,55,1,89,35,55
15810,E02006357,2009,98,244000,226000,34,31,20,13,0,98,85,13
15811,E02006357,2010,101,253000,230000,28,45,22,6,0,101,94,7
15812,E02006357,2011,88,256000,212000,26,24,26,12,2,86,75,13
15813,E02006357,2012,85,262000,242000,23,26,27,9,0,85,77,8
15814,E02006357,2013,115,286000,250000,39,33,30,13,0,115,102,13
15815,E02006357,2014,34,270000,250000,9,13,9,3,0,34,30,4
15816,E02006358,2009,82,286000,265000,16,38,15,13,0,82,67,15
15817,E02006358,2010,82,326000,319000,13,44,13,12,0,82,68,14
15818,E02006358,2011,98,349000,325000,23,41,13,21,0,98,75,23
15819,E02006358,2012,98,370000,349000,24,37,11,26,2,96,71,27
15820,E02006358,2013,109,371000,345000,21,43,25,20,7,102,87,22
15821,E02006358,2014,31,418000,422000,6,13,9,3,0,31,28,3
15822,E02006359,2009,87,607000,389000,38,10,7,32,0,87,53,34
15823,E02006359,2010,114,678000,500000,52,15,13,34,2,112,77,37
15824,E02006359,2011,128,526000,382000,40,19,21,48,1,127,80,48
15825,E02006359,2012,109,584000,450000,35,14,18,42,4,105,67,42
15826,E02006359,2013,114,569000,428000,35,15,16,48,10,104,66,48
15827,E02006359,2014,53,520000,368000,11,9,8,25,3,50,28,25
15828,E02006360,2009,121,507000,380000,49,33,26,13,3,118,105,16
15829,E02006360,2010,97,577000,390000,44,23,20,10,2,95,86,11
15830,E02006360,2011,105,571000,350000,38,28,24,15,0,105,87,18
15831,E02006360,2012,134,558000,393000,57,33,32,12,9,125,120,14
15832,E02006360,2013,122,600000,475000,56,27,25,14,6,116,106,16
15833,E02006360,2014,55,499000,410000,12,14,19,10,7,48,45,10
15834,E02006361,2009,86,608000,480000,51,22,9,4,3,83,81,5
15835,E02006361,2010,78,716000,499000,42,23,7,6,4,74,72,6
15836,E02006361,2011,54,764000,510000,32,14,6,2,1,53,51,3
15837,E02006361,2012,69,544000,460000,34,15,14,6,11,58,63,6
15838,E02006361,2013,81,574000,495000,38,24,11,8,3,78,73,8
15839,E02006361,2014,34,695000,581000,21,5,6,2,0,34,32,2
15840,E02006362,2009,86,390000,352000,29,35,7,15,3,83,70,16
15841,E02006362,2010,95,481000,420000,37,35,7,16,8,87,76,19
15842,E02006362,2011,117,464000,410000,38,49,6,24,7,110,92,25
15843,E02006362,2012,97,539000,435000,40,31,9,17,0,97,80,17
15844,E02006362,2013,129,490000,450000,47,52,12,18,3,126,108,21
15845,E02006362,2014,39,473000,450000,10,19,4,6,1,38,32,7
15846,E02006363,2009,75,405000,380000,41,17,7,10,0,75,64,11
15847,E02006363,2010,113,419000,370000,52,26,8,27,5,108,83,30
15848,E02006363,2011,85,435000,392000,38,23,10,14,1,84,71,14
15849,E02006363,2012,98,473000,415000,44,30,14,10,17,81,87,11
15850,E02006363,2013,99,440000,400000,39,23,14,23,2,97,76,23
15851,E02006363,2014,44,541000,500000,23,10,2,9,0,44,35,9
15852,E02006364,2009,90,220000,200000,5,28,24,33,1,89,57,33
15853,E02006364,2010,110,248000,228000,9,22,29,50,5,105,60,50
15854,E02006364,2011,102,291000,220000,20,25,13,44,7,95,59,43
15855,E02006364,2012,99,254000,230000,9,26,18,46,3,96,53,46
15856,E02006364,2013,138,276000,242000,16,32,19,71,8,130,67,71
15857,E02006364,2014,53,296000,250000,5,13,5,30,1,52,23,30
15858,E02006365,2009,101,385000,323000,43,15,12,31,16,85,68,33
15859,E02006365,2010,109,456000,384000,50,13,15,31,13,96,77,32
15860,E02006365,2011,127,425000,385000,46,21,18,42,23,104,84,43
15861,E02006365,2012,168,407000,372000,43,26,46,53,56,112,114,54
15862,E02006365,2013,141,482000,425000,55,23,21,42,8,133,98,43
15863,E02006365,2014,47,345000,315000,10,6,6,25,0,47,23,24
15864,E02006366,2009,86,409000,338000,41,30,8,7,0,86,77,9
15865,E02006366,2010,116,509000,382000,63,35,7,11,2,114,107,9
15866,E02006366,2011,116,467000,402000,58,46,9,3,3,113,111,5
15867,E02006366,2012,113,492000,432000,59,36,10,8,6,107,106,7
15868,E02006366,2013,116,519000,462000,63,33,17,3,5,111,113,3
15869,E02006366,2014,45,523000,450000,16,18,7,4,3,42,41,4
15870,E02006367,2009,88,464000,405000,60,9,6,13,6,82,76,12
15871,E02006367,2010,73,532000,485000,51,10,8,4,1,72,68,5
15872,E02006367,2011,77,484000,440000,51,10,6,10,0,77,67,10
15873,E02006367,2012,65,470000,450000,42,8,5,10,0,65,55,10
15874,E02006367,2013,97,502000,465000,51,17,11,18,1,96,79,18
15875,E02006367,2014,18,402000,336000,5,4,4,5,0,18,13,5
15876,E02006368,2009,75,391000,370000,38,16,12,9,6,69,64,11
15877,E02006368,2010,62,416000,390000,29,18,7,8,1,61,53,9
15878,E02006368,2011,91,462000,440000,52,24,9,6,10,81,83,8
15879,E02006368,2012,78,452000,445000,43,18,10,7,2,76,70,8
15880,E02006368,2013,105,486000,475000,55,29,9,12,9,96,91,14
15881,E02006368,2014,32,549000,476000,20,7,3,2,0,32,30,2
15882,E02006369,2009,54,434000,368000,26,21,6,1,0,54,51,3
15883,E02006369,2010,77,517000,421000,32,27,15,3,2,75,74,3
15884,E02006369,2011,50,451000,355000,18,24,7,1,0,50,49,1
15885,E02006369,2012,71,517000,430000,33,25,9,4,0,71,67,4
15886,E02006369,2013,59,625000,493000,32,14,7,6,0,59,53,6
15887,E02006369,2014,19,524000,445000,6,6,5,2,0,19,17,2
15888,E02006370,2009,94,276000,245000,13,25,27,29,4,90,64,30
15889,E02006370,2010,121,359000,285000,17,33,44,27,2,119,94,27
15890,E02006370,2011,117,401000,330000,23,31,37,26,9,108,90,27
15891,E02006370,2012,93,356000,312000,10,20,42,21,13,80,72,21
15892,E02006370,2013,98,363000,300000,12,27,34,25,2,96,70,28
15893,E02006370,2014,40,408000,328000,13,7,9,11,0,40,28,12
15894,E02006371,2009,90,300000,255000,17,22,21,30,0,90,58,32
15895,E02006371,2010,125,389000,300000,41,22,27,35,1,124,86,39
15896,E02006371,2011,127,338000,295000,26,30,22,49,16,111,77,50
15897,E02006371,2012,129,398000,315000,35,25,28,41,28,101,87,42
15898,E02006371,2013,132,385000,322000,29,32,30,41,14,118,89,43
15899,E02006371,2014,48,418000,337000,15,6,9,18,0,48,30,18
15900,E02006372,2009,67,251000,224000,14,20,24,9,4,63,57,10
15901,E02006372,2010,74,303000,250000,16,18,29,11,1,73,62,12
15902,E02006372,2011,79,282000,235000,15,25,30,9,1,78,70,9
15903,E02006372,2012,78,294000,250000,14,20,35,9,1,77,67,11
15904,E02006372,2013,84,319000,250000,19,28,28,9,0,84,73,11
15905,E02006372,2014,38,332000,295000,7,15,13,3,0,38,34,4
15906,E02006373,2009,79,460000,355000,32,25,16,6,3,76,73,6
15907,E02006373,2010,94,464000,386000,39,31,18,6,5,89,86,8
15908,E02006373,2011,79,492000,400000,32,22,17,8,8,71,72,7
15909,E02006373,2012,80,550000,408000,34,25,12,9,2,78,72,8
15910,E02006373,2013,89,502000,385000,35,30,19,5,0,89,83,6
15911,E02006373,2014,26,554000,554000,10,9,3,4,0,26,22,4
15912,E02006374,2009,63,370000,306000,30,25,6,2,0,63,61,2
15913,E02006374,2010,85,472000,370000,46,26,10,3,0,85,79,6
15914,E02006374,2011,59,472000,368000,30,16,10,3,0,59,55,4
15915,E02006374,2012,70,359000,289000,25,26,14,5,1,69,62,8
15916,E02006374,2013,94,414000,352000,42,30,14,8,1,93,83,11
15917,E02006374,2014,38,436000,336000,16,7,9,6,1,37,32,6
15918,E02006375,2009,100,376000,360000,45,41,6,8,20,80,91,9
15919,E02006375,2010,126,407000,395000,57,46,3,20,41,85,105,21
15920,E02006375,2011,123,412000,395000,56,43,6,18,20,103,105,18
15921,E02006375,2012,121,388000,368000,40,42,7,32,34,87,89,32
15922,E02006375,2013,137,457000,412000,57,58,10,12,31,106,125,12
15923,E02006375,2014,33,429000,420000,12,10,3,8,0,33,25,8
15924,E02006376,2009,114,320000,288000,27,36,13,38,0,114,67,47
15925,E02006376,2010,121,385000,348000,37,38,14,32,1,120,85,36
15926,E02006376,2011,131,349000,318000,22,43,14,52,0,131,75,56
15927,E02006376,2012,121,340000,325000,22,41,13,45,0,121,71,50
15928,E02006376,2013,156,364000,360000,35,52,15,54,0,156,97,59
15929,E02006376,2014,46,384000,327000,7,14,5,20,0,46,22,24
15930,E02006377,2009,79,358000,330000,35,25,13,6,11,68,73,6
15931,E02006377,2010,64,412000,395000,30,21,7,6,0,64,56,8
15932,E02006377,2011,96,414000,387000,50,25,8,13,16,80,83,13
15933,E02006377,2012,78,460000,448000,46,18,5,9,6,72,69,9
15934,E02006377,2013,88,439000,423000,43,23,8,14,0,88,74,14
15935,E02006377,2014,50,500000,488000,24,16,6,4,11,39,46,4
15936,E02006378,2009,105,435000,292000,47,30,16,12,3,102,92,13
15937,E02006378,2010,127,453000,360000,58,29,23,17,2,125,110,17
15938,E02006378,2011,107,424000,350000,51,26,21,9,2,105,98,9
15939,E02006378,2012,113,486000,370000,57,31,16,9,12,101,102,11
15940,E02006378,2013,105,469000,370000,44,25,19,17,5,100,84,21
15941,E02006378,2014,65,492000,390000,31,13,9,12,3,62,53,12
15942,E02006379,2009,64,205000,193000,4,21,24,15,0,64,47,17
15943,E02006379,2010,86,222000,213000,4,36,30,16,1,85,65,21
15944,E02006379,2011,77,230000,219000,7,24,27,19,0,77,57,20
15945,E02006379,2012,80,241000,225000,8,27,32,13,5,75,61,19
15946,E02006379,2013,116,272000,235000,15,35,43,23,9,107,95,21
15947,E02006379,2014,42,282000,248000,4,15,13,10,2,40,31,11
15948,E02006380,2009,90,421000,407000,36,26,8,20,3,87,69,21
15949,E02006380,2010,131,473000,416000,53,26,20,32,2,129,101,30
15950,E02006380,2011,104,447000,362000,36,24,18,26,11,93,74,30
15951,E02006380,2012,105,417000,375000,30,37,17,21,5,100,84,21
15952,E02006380,2013,130,569000,465000,50,28,19,33,19,111,97,33
15953,E02006380,2014,47,607000,543000,25,7,7,8,3,44,38,9
15954,E02006381,2009,80,526000,340000,26,24,14,16,7,73,63,17
15955,E02006381,2010,144,753000,486000,89,24,10,21,6,138,120,24
15956,E02006381,2011,104,886000,557000,60,17,12,15,2,102,88,16
15957,E02006381,2012,106,673000,355000,48,23,17,18,13,93,88,18
15958,E02006381,2013,154,752000,472000,65,25,29,35,52,102,119,35
15959,E02006381,2014,58,761000,537000,30,8,5,15,12,46,43,15
15960,E02006382,2009,70,198000,181000,7,25,24,14,7,63,55,15
15961,E02006382,2010,72,223000,212000,5,35,20,12,1,71,60,12
15962,E02006382,2011,88,231000,205000,10,37,31,10,0,88,78,10
15963,E02006382,2012,75,213000,206000,3,27,36,9,1,74,65,10
15964,E02006382,2013,109,249000,225000,8,41,45,15,0,109,94,15
15965,E02006382,2014,31,251000,245000,3,8,14,6,0,31,25,6
15966,E02006383,2009,175,425000,325000,62,34,26,53,16,159,120,55
15967,E02006383,2010,199,485000,331000,71,30,34,64,10,189,132,67
15968,E02006383,2011,188,384000,294000,45,31,32,80,27,161,104,84
15969,E02006383,2012,196,409000,310000,53,22,29,92,45,151,102,94
15970,E02006383,2013,246,453000,336000,61,29,32,124,34,212,122,124
15971,E02006383,2014,67,429000,355000,17,6,11,33,1,66,34,33
15972,E02006384,2009,146,230000,192000,23,18,32,73,23,123,70,76
15973,E02006384,2010,160,300000,228000,32,38,19,71,4,156,89,71
15974,E02006384,2011,162,320000,248000,32,38,21,71,27,135,92,70
15975,E02006384,2012,157,286000,220000,27,30,21,79,2,155,77,80
15976,E02006384,2013,250,261000,202000,33,31,37,149,58,192,100,150
15977,E02006384,2014,64,302000,236000,8,13,7,36,0,64,29,35
15978,E02006385,2009,309,233000,210000,23,49,102,135,164,145,174,135
15979,E02006385,2010,220,253000,246000,25,50,66,79,67,153,141,79
15980,E02006385,2011,218,223000,190000,19,51,33,115,23,195,104,114
15981,E02006385,2012,208,235000,225000,14,47,42,105,56,152,103,105
15982,E02006385,2013,273,253000,235000,27,57,77,112,38,235,159,114
15983,E02006385,2014,80,247000,217000,7,14,12,47,7,73,33,47
15984,E02006386,2009,157,336000,272000,36,35,27,59,43,114,98,59
15985,E02006386,2010,165,419000,370000,48,46,38,33,3,162,130,35
15986,E02006386,2011,138,406000,371000,45,33,31,29,0,138,109,29
15987,E02006386,2012,121,430000,385000,36,22,33,30,0,121,91,30
15988,E02006386,2013,141,467000,450000,44,23,40,34,1,140,108,33
15989,E02006386,2014,49,484000,500000,17,10,10,12,1,48,37,12
15990,E02006387,2009,78,301000,229000,14,33,13,18,2,76,60,18
15991,E02006387,2010,99,293000,250000,20,45,12,22,6,93,73,26
15992,E02006387,2011,94,349000,298000,24,48,12,10,0,94,83,11
15993,E02006387,2012,76,334000,272000,14,33,18,11,1,75,65,11
15994,E02006387,2013,84,404000,305000,20,33,22,9,0,84,75,9
15995,E02006387,2014,28,414000,380000,7,13,4,4,0,28,24,4
15996,E02006388,2009,105,210000,193000,12,42,16,35,0,105,68,37
15997,E02006388,2010,138,235000,226000,22,54,31,31,0,138,106,32
15998,E02006388,2011,142,234000,226000,15,59,29,39,6,136,99,43
15999,E02006388,2012,145,236000,225000,23,40,37,45,17,128,98,47
16000,E02006388,2013,166,251000,234000,20,55,36,55,25,141,110,56
16001,E02006388,2014,38,268000,262000,8,14,9,7,0,38,30,8
16002,E02006389,2009,65,296000,250000,20,32,3,10,0,65,55,10
16003,E02006389,2010,68,308000,275000,16,42,7,3,0,68,63,5
16004,E02006389,2011,78,296000,256000,21,41,5,11,7,71,66,12
16005,E02006389,2012,97,295000,250000,21,45,14,17,1,96,80,17
16006,E02006389,2013,92,340000,295000,16,57,9,10,0,92,82,10
16007,E02006389,2014,27,317000,310000,6,14,3,4,0,27,23,4
16008,E02006390,2009,66,224000,214000,13,30,16,7,6,60,60,6
16009,E02006390,2010,89,256000,240000,22,44,18,5,7,82,85,4
16010,E02006390,2011,105,240000,232000,22,51,22,10,0,105,94,11
16011,E02006390,2012,98,245000,246000,19,46,22,11,0,98,86,12
16012,E02006390,2013,111,266000,258000,24,43,28,16,0,111,96,15
16013,E02006390,2014,42,292000,282000,16,17,8,1,0,42,41,1
16014,E02006391,2009,93,285000,280000,29,26,32,6,38,55,88,5
16015,E02006391,2010,152,305000,300000,54,40,51,7,72,80,144,8
16016,E02006391,2011,158,287000,276000,41,67,40,10,67,91,144,14
16017,E02006391,2012,120,316000,316000,44,28,45,3,46,74,118,2
16018,E02006391,2013,223,323000,310000,66,56,87,14,120,103,218,5
16019,E02006391,2014,43,303000,300000,11,7,20,5,13,30,38,5
16020,E02006392,2009,123,211000,200000,19,48,12,44,4,119,75,48
16021,E02006392,2010,146,218000,200000,29,42,11,64,8,138,80,66
16022,E02006392,2011,140,204000,185000,19,42,14,65,0,140,73,67
16023,E02006392,2012,146,223000,193000,25,42,10,69,10,136,77,69
16024,E02006392,2013,180,239000,216000,29,61,12,78,4,176,100,80
16025,E02006392,2014,53,241000,190000,9,9,7,28,2,51,25,28
16026,E02006393,2009,88,272000,250000,14,34,13,27,0,88,58,30
16027,E02006393,2010,123,280000,250000,19,44,18,42,7,116,81,42
16028,E02006393,2011,110,276000,270000,14,33,19,44,13,97,67,43
16029,E02006393,2012,103,256000,248000,14,24,21,44,10,93,58,45
16030,E02006393,2013,120,284000,250000,13,34,26,47,11,109,73,47
16031,E02006393,2014,47,295000,266000,5,13,13,16,0,47,32,15
16032,E02006394,2009,89,424000,295000,30,23,18,18,24,65,71,18
16033,E02006394,2010,120,444000,285000,38,22,28,32,20,100,86,34
16034,E02006394,2011,93,519000,325000,33,26,19,15,8,85,77,16
16035,E02006394,2012,95,470000,280000,32,30,26,7,7,88,87,8
16036,E02006394,2013,118,435000,319000,36,31,31,20,3,115,99,19
16037,E02006394,2014,39,414000,320000,12,8,13,6,0,39,33,6
16038,E02006395,2009,108,228000,220000,18,49,24,17,7,101,88,20
16039,E02006395,2010,174,235000,231000,26,55,37,56,40,134,103,71
16040,E02006395,2011,130,255000,249000,16,56,30,28,16,114,98,32
16041,E02006395,2012,112,255000,245000,19,53,22,18,0,112,94,18
16042,E02006395,2013,145,280000,254000,32,56,45,12,5,140,130,15
16043,E02006395,2014,43,275000,279000,5,20,6,12,0,43,31,12
16044,E02006396,2009,78,310000,250000,20,20,21,17,12,66,60,18
16045,E02006396,2010,59,385000,350000,28,9,15,7,5,54,52,7
16046,E02006396,2011,90,375000,395000,32,30,21,7,22,68,83,7
16047,E02006396,2012,65,399000,335000,27,12,17,9,4,61,57,8
16048,E02006396,2013,87,375000,330000,34,18,22,13,0,87,74,13
16049,E02006396,2014,25,389000,363000,7,6,8,4,0,25,21,4
16050,E02006397,2009,118,927000,443000,43,17,25,33,38,80,81,37
16051,E02006397,2010,129,860000,525000,60,14,27,28,14,115,101,28
16052,E02006397,2011,102,1038000,560000,53,13,11,25,1,101,76,26
16053,E02006397,2012,97,1119000,590000,47,18,11,21,1,96,75,22
16054,E02006397,2013,115,932000,550000,53,19,12,31,0,115,84,31
16055,E02006397,2014,44,776000,485000,22,10,2,10,0,44,34,10
16056,E02006398,2009,76,238000,225000,10,27,19,20,0,76,56,20
16057,E02006398,2010,120,243000,230000,15,46,26,33,0,120,85,35
16058,E02006398,2011,140,250000,231000,19,40,38,43,0,140,96,44
16059,E02006398,2012,121,255000,244000,12,36,40,33,4,117,88,33
16060,E02006398,2013,150,250000,248000,14,36,60,40,3,147,108,42
16061,E02006398,2014,44,250000,236000,0,10,14,20,0,44,24,20
16062,E02006399,2009,209,235000,219000,30,67,31,81,42,167,122,87
16063,E02006399,2010,164,276000,238000,41,45,13,65,11,153,98,66
16064,E02006399,2011,184,305000,250000,54,55,36,39,18,166,143,41
16065,E02006399,2012,193,265000,250000,37,76,29,51,14,179,139,54
16066,E02006399,2013,228,300000,285000,47,73,58,50,29,199,178,50
16067,E02006399,2014,77,319000,315000,24,17,14,22,8,69,54,23
16068,E02006400,2009,70,345000,310000,24,27,7,12,1,69,56,14
16069,E02006400,2010,81,440000,370000,38,17,17,9,0,81,68,13
16070,E02006400,2011,64,385000,340000,23,18,11,12,1,63,51,13
16071,E02006400,2012,61,375000,300000,17,16,12,16,3,58,45,16
16072,E02006400,2013,81,416000,390000,30,28,17,6,4,77,75,6
16073,E02006400,2014,30,441000,427000,11,8,3,8,0,30,22,8
16074,E02006401,2009,141,249000,221000,27,49,19,46,20,121,92,49
16075,E02006401,2010,158,257000,249000,31,46,18,63,35,123,90,68
16076,E02006401,2011,144,246000,228000,32,33,26,53,17,127,88,56
16077,E02006401,2012,177,235000,218000,27,47,31,72,25,152,101,76
16078,E02006401,2013,175,253000,242000,31,44,36,64,19,156,110,65
16079,E02006401,2014,52,323000,322000,17,11,10,14,3,49,38,14
16080,E02006402,2009,142,294000,271000,47,69,17,9,15,127,130,12
16081,E02006402,2010,139,331000,290000,44,59,26,10,5,134,128,11
16082,E02006402,2011,149,318000,268000,49,69,16,15,3,146,129,20
16083,E02006402,2012,151,343000,320000,53,69,14,15,5,146,132,19
16084,E02006402,2013,144,343000,312000,49,65,14,16,0,144,127,17
16085,E02006402,2014,44,410000,342000,16,19,5,4,0,44,40,4
16086,E02006403,2009,44,170000,168000,4,10,11,19,0,44,22,22
16087,E02006403,2010,66,190000,194000,7,18,28,13,0,66,43,23
16088,E02006403,2011,48,183000,170000,5,17,9,17,0,48,29,19
16089,E02006403,2012,58,202000,192000,3,18,14,23,0,58,35,23
16090,E02006403,2013,63,207000,220000,3,20,20,20,0,63,42,21
16091,E02006403,2014,37,235000,240000,7,9,12,9,0,37,26,11
16092,E02006404,2009,50,192000,200000,3,25,15,7,0,50,39,11
16093,E02006404,2010,64,205000,215000,4,36,17,7,0,64,53,11
16094,E02006404,2011,85,217000,208000,5,33,29,18,12,73,63,22
16095,E02006404,2012,84,216000,220000,4,32,35,13,15,69,67,17
16096,E02006404,2013,128,223000,221000,4,31,48,45,46,82,82,46
16097,E02006404,2014,33,243000,244000,4,11,10,8,2,31,23,10
16098,E02006405,2009,150,231000,229000,30,59,21,40,21,129,106,44
16099,E02006405,2010,149,251000,245000,23,66,15,45,14,135,103,46
16100,E02006405,2011,129,249000,249000,19,45,25,40,10,119,87,42
16101,E02006405,2012,170,253000,245000,33,48,26,63,27,143,105,65
16102,E02006405,2013,201,280000,265000,42,65,24,70,23,178,129,72
16103,E02006405,2014,60,288000,282000,13,12,11,24,3,57,36,24
16104,E02006406,2009,109,228000,210000,8,27,29,45,6,103,65,44
16105,E02006406,2010,111,250000,230000,6,35,32,38,5,106,70,41
16106,E02006406,2011,116,247000,231000,10,23,28,55,0,116,58,58
16107,E02006406,2012,120,268000,240000,12,27,37,44,0,120,76,44
16108,E02006406,2013,139,288000,275000,9,30,45,55,14,125,84,55
16109,E02006406,2014,59,284000,255000,5,9,11,34,9,50,25,34
16110,E02006407,2009,80,249000,234000,20,29,9,22,3,77,57,23
16111,E02006407,2010,121,248000,235000,17,49,21,34,15,106,85,36
16112,E02006407,2011,89,255000,250000,9,51,9,20,8,81,68,21
16113,E02006407,2012,125,264000,250000,23,47,15,40,8,117,84,41
16114,E02006407,2013,185,262000,248000,27,71,16,71,28,157,114,71
16115,E02006407,2014,66,293000,295000,12,27,7,20,1,65,45,21
16116,E02006408,2009,110,221000,212000,20,28,22,40,16,94,70,40
16117,E02006408,2010,119,233000,225000,18,45,22,34,3,116,83,36
16118,E02006408,2011,139,222000,218000,17,40,33,49,10,129,85,54
16119,E02006408,2012,133,228000,221000,24,31,30,48,13,120,81,52
16120,E02006408,2013,147,243000,235000,26,52,25,44,2,145,102,45
16121,E02006408,2014,52,257000,248000,5,17,8,22,1,51,29,23
16122,E02006409,2009,69,235000,223000,6,30,22,11,4,65,58,11
16123,E02006409,2010,96,252000,244000,8,53,27,8,3,93,87,9
16124,E02006409,2011,75,230000,240000,3,31,32,9,8,67,60,15
16125,E02006409,2012,71,248000,250000,2,34,23,12,1,70,59,12
16126,E02006409,2013,87,275000,270000,3,43,30,11,0,87,74,13
16127,E02006409,2014,18,274000,257000,0,8,8,2,0,18,16,2
16128,E02006410,2009,69,223000,230000,7,27,27,8,1,68,60,9
16129,E02006410,2010,75,233000,227000,4,19,33,19,0,75,56,19
16130,E02006410,2011,94,237000,236000,7,35,31,21,0,94,72,22
16131,E02006410,2012,74,243000,250000,2,27,31,14,1,73,60,14
16132,E02006410,2013,116,242000,245000,8,32,43,33,0,116,84,32
16133,E02006410,2014,52,268000,264000,2,13,28,9,0,52,42,10
16134,E02006411,2009,96,272000,250000,19,41,13,23,0,96,71,25
16135,E02006411,2010,113,299000,275000,19,46,19,29,0,113,80,33
16136,E02006411,2011,122,289000,272000,18,47,26,31,0,122,86,36
16137,E02006411,2012,117,296000,280000,13,51,18,35,9,108,82,35
16138,E02006411,2013,101,328000,315000,25,32,12,32,0,101,67,34
16139,E02006411,2014,49,315000,285000,10,15,3,21,1,48,27,22
16140,E02006412,2009,107,354000,330000,44,26,9,28,16,91,79,28
16141,E02006412,2010,111,436000,400000,38,36,19,18,11,100,90,21
16142,E02006412,2011,94,409000,390000,37,20,24,13,7,87,81,13
16143,E02006412,2012,100,386000,339000,31,25,18,26,2,98,73,27
16144,E02006412,2013,123,469000,390000,46,24,21,32,5,118,91,32
16145,E02006412,2014,40,453000,464000,13,8,12,7,2,38,33,7
16146,E02006413,2009,60,260000,232000,14,17,20,9,7,53,51,9
16147,E02006413,2010,84,323000,296000,25,31,21,7,0,84,75,9
16148,E02006413,2011,76,313000,300000,22,33,18,3,0,76,72,4
16149,E02006413,2012,73,325000,300000,14,30,21,8,1,72,65,8
16150,E02006413,2013,93,333000,295000,23,23,31,16,6,87,77,16
16151,E02006413,2014,45,319000,310000,2,20,15,8,3,42,38,7
16152,E02006414,2009,71,283000,248000,16,26,19,10,10,61,61,10
16153,E02006414,2010,102,291000,256000,20,48,17,17,15,87,77,25
16154,E02006414,2011,83,313000,282000,15,38,23,7,0,83,76,7
16155,E02006414,2012,81,325000,292000,16,32,21,12,9,72,70,11
16156,E02006414,2013,98,363000,306000,24,38,27,9,1,97,89,9
16157,E02006414,2014,21,347000,325000,3,12,5,1,1,20,19,2
16158,E02006415,2009,133,286000,266000,32,32,28,41,27,106,88,45
16159,E02006415,2010,149,344000,290000,37,42,14,56,34,115,82,67
16160,E02006415,2011,116,365000,319000,27,32,16,41,9,107,73,43
16161,E02006415,2012,91,429000,381000,36,20,13,22,0,91,67,24
16162,E02006415,2013,136,418000,372000,48,32,22,34,0,136,99,37
16163,E02006415,2014,44,392000,341000,11,5,9,19,0,44,22,22
16164,E02006416,2009,97,487000,396000,57,30,6,4,0,97,91,6
16165,E02006416,2010,109,479000,385000,59,32,13,5,0,109,102,7
16166,E02006416,2011,101,597000,435000,59,28,10,4,0,101,95,6
16167,E02006416,2012,100,510000,404000,54,26,9,11,2,98,90,10
16168,E02006416,2013,156,537000,416000,85,44,17,10,3,153,145,11
16169,E02006416,2014,35,521000,470000,19,6,4,6,0,35,29,6
16170,E02006417,2009,73,246000,220000,17,31,14,11,0,73,60,13
16171,E02006417,2010,85,280000,245000,21,33,12,19,0,85,66,19
16172,E02006417,2011,131,237000,250000,25,43,37,26,52,79,93,38
16173,E02006417,2012,125,281000,261000,33,30,33,29,52,73,96,29
16174,E02006417,2013,114,301000,270000,33,41,24,16,4,110,95,19
16175,E02006417,2014,28,289000,278000,4,8,13,3,0,28,23,5
16176,E02006418,2009,113,291000,250000,41,21,14,37,19,94,72,41
16177,E02006418,2010,94,350000,334000,45,22,14,13,3,91,80,14
16178,E02006418,2011,111,360000,360000,66,18,11,16,0,111,93,18
16179,E02006418,2012,118,340000,340000,63,13,24,18,6,112,99,19
16180,E02006418,2013,124,350000,318000,54,21,32,17,4,120,106,18
16181,E02006418,2014,43,331000,280000,18,4,7,14,1,42,29,14
16182,E02006419,2009,76,229000,200000,13,33,15,15,0,76,58,18
16183,E02006419,2010,68,262000,232000,14,31,9,14,0,68,51,17
16184,E02006419,2011,86,247000,220000,17,34,12,23,4,82,60,26
16185,E02006419,2012,89,243000,220000,11,33,20,25,4,85,63,26
16186,E02006419,2013,95,258000,228000,15,43,14,23,1,94,71,24
16187,E02006419,2014,37,294000,250000,7,14,7,9,0,37,28,9
16188,E02006420,2009,96,425000,421000,67,4,2,23,0,96,73,23
16189,E02006420,2010,109,484000,475000,71,4,6,28,11,98,83,26
16190,E02006420,2011,142,405000,394000,84,7,3,48,32,110,94,48
16191,E02006420,2012,113,468000,435000,73,7,2,31,12,101,81,32
16192,E02006420,2013,136,441000,448000,77,10,5,44,22,114,92,44
16193,E02006420,2014,44,463000,430000,24,2,1,17,2,42,27,17
16194,E02006421,2009,89,366000,320000,53,14,17,5,0,89,85,4
16195,E02006421,2010,87,366000,325000,40,21,20,6,0,87,81,6
16196,E02006421,2011,90,339000,305000,37,27,20,6,1,89,84,6
16197,E02006421,2012,106,356000,342000,52,23,27,4,0,106,102,4
16198,E02006421,2013,140,398000,371000,75,29,30,6,6,134,132,8
16199,E02006421,2014,43,443000,410000,25,4,10,4,5,38,39,4
16200,E02006422,2009,77,267000,242000,32,12,26,7,3,74,70,7
16201,E02006422,2010,77,319000,297000,36,15,22,4,0,77,74,3
16202,E02006422,2011,95,318000,270000,41,23,29,2,6,89,93,2
16203,E02006422,2012,80,309000,282000,35,16,29,0,1,79,79,1
16204,E02006422,2013,89,312000,250000,36,7,40,6,0,89,83,6
16205,E02006422,2014,33,341000,315000,14,6,9,4,0,33,29,4
16206,E02006423,2009,176,232000,199000,38,33,8,97,33,143,80,96
16207,E02006423,2010,137,263000,215000,29,34,11,63,11,126,72,65
16208,E02006423,2011,143,269000,220000,40,46,14,43,0,143,100,43
16209,E02006423,2012,172,288000,234000,46,60,22,44,12,160,128,44
16210,E02006423,2013,183,308000,250000,47,57,17,62,33,150,120,63
16211,E02006423,2014,56,288000,240000,15,13,4,24,2,54,31,25
16212,E02006424,2009,72,418000,378000,42,20,2,8,0,72,64,8
16213,E02006424,2010,71,378000,306000,40,16,3,12,1,70,59,12
16214,E02006424,2011,86,408000,330000,51,16,5,14,9,77,70,16
16215,E02006424,2012,94,405000,324000,49,29,4,12,8,86,82,12
16216,E02006424,2013,119,381000,350000,60,27,7,25,1,118,94,25
16217,E02006424,2014,28,473000,462000,17,6,1,4,0,28,24,4
16218,E02006425,2009,69,264000,250000,31,16,15,7,1,68,62,7
16219,E02006425,2010,61,258000,239000,19,19,15,8,0,61,53,8
16220,E02006425,2011,82,280000,267000,27,30,22,3,5,77,79,3
16221,E02006425,2012,87,293000,275000,25,28,21,13,29,58,74,13
16222,E02006425,2013,98,290000,250000,37,26,24,11,13,85,87,11
16223,E02006425,2014,28,277000,262000,8,7,7,6,0,28,22,6
16224,E02006426,2009,82,243000,240000,31,28,11,12,3,79,70,12
16225,E02006426,2010,78,268000,250000,26,31,10,11,0,78,67,11
16226,E02006426,2011,75,265000,250000,25,28,14,8,0,75,64,11
16227,E02006426,2012,53,295000,270000,26,21,3,3,0,53,50,3
16228,E02006426,2013,92,284000,271000,32,26,23,11,0,92,78,14
16229,E02006426,2014,28,272000,255000,6,7,7,8,0,28,20,8
16230,E02006427,2009,84,263000,224000,22,24,24,14,11,73,70,14
16231,E02006427,2010,84,282000,244000,20,26,25,13,0,84,67,17
16232,E02006427,2011,88,263000,235000,27,29,19,13,0,88,73,15
16233,E02006427,2012,73,311000,280000,30,19,16,8,1,72,62,11
16234,E02006427,2013,124,314000,285000,40,39,35,10,26,98,113,11
16235,E02006427,2014,45,299000,292000,9,20,10,6,2,43,37,8
16236,E02006429,2009,109,306000,228000,36,21,13,39,3,106,69,40
16237,E02006429,2010,129,370000,249000,38,33,16,42,4,125,84,45
16238,E02006429,2011,151,353000,275000,47,25,15,64,19,132,86,65
16239,E02006429,2012,147,312000,236000,37,25,19,66,10,137,81,66
16240,E02006429,2013,167,356000,289000,52,24,16,75,16,151,92,75
16241,E02006429,2014,54,341000,257000,12,9,12,21,4,50,33,21
16242,E02006430,2009,152,242000,223000,26,46,42,38,6,146,112,40
16243,E02006430,2010,127,301000,250000,26,46,41,14,13,114,113,14
16244,E02006430,2011,165,278000,250000,32,47,61,25,12,153,140,25
16245,E02006430,2012,130,285000,260000,26,52,30,22,9,121,107,23
16246,E02006430,2013,167,302000,280000,33,49,57,28,20,147,136,31
16247,E02006430,2014,56,334000,304000,11,19,15,11,9,47,46,10
16248,E02006431,2009,203,292000,205000,46,46,10,101,41,162,98,105
16249,E02006431,2010,180,374000,300000,73,42,12,53,14,166,126,54
16250,E02006431,2011,159,366000,248000,47,44,12,56,7,152,103,56
16251,E02006431,2012,204,343000,244000,50,48,11,95,47,157,107,97
16252,E02006431,2013,216,342000,250000,59,58,15,84,21,195,130,86
16253,E02006431,2014,78,373000,275000,25,14,4,35,0,78,43,35
16254,E02006432,2009,81,333000,320000,32,19,15,15,23,58,66,15
16255,E02006432,2010,63,396000,350000,26,19,10,8,7,56,54,9
16256,E02006432,2011,75,371000,335000,31,21,7,16,14,61,59,16
16257,E02006432,2012,88,336000,303000,36,22,6,24,13,75,64,24
16258,E02006432,2013,89,404000,345000,40,15,15,19,3,86,70,19
16259,E02006432,2014,30,437000,446000,16,5,0,9,2,28,21,9
16260,E02006433,2009,116,473000,329000,36,33,16,31,4,112,84,32
16261,E02006433,2010,132,516000,441000,54,25,15,38,4,128,93,39
16262,E02006433,2011,128,540000,410000,58,22,17,31,7,121,96,32
16263,E02006433,2012,149,543000,442000,58,31,21,39,25,124,111,38
16264,E02006433,2013,158,547000,421000,63,25,24,46,26,132,112,46
16265,E02006433,2014,47,644000,575000,23,8,7,9,0,47,38,9
16266,E02006434,2009,62,315000,245000,20,24,15,3,0,62,60,2
16267,E02006434,2010,67,384000,298000,23,28,15,1,0,67,66,1
16268,E02006434,2011,72,423000,309000,31,27,13,1,0,72,70,2
16269,E02006434,2012,68,382000,299000,18,26,21,3,0,68,65,3
16270,E02006434,2013,76,452000,328000,29,33,13,1,1,75,75,1
16271,E02006434,2014,22,521000,368000,9,6,7,0,0,22,22,0
16272,E02006435,2009,65,377000,280000,24,20,13,8,7,58,55,10
16273,E02006435,2010,71,373000,370000,22,21,18,10,2,69,60,11
16274,E02006435,2011,70,386000,312000,24,23,17,6,2,68,63,7
16275,E02006435,2012,76,385000,334000,22,23,20,11,4,72,66,10
16276,E02006435,2013,87,398000,330000,28,21,29,9,2,85,77,10
16277,E02006435,2014,32,417000,348000,10,10,9,3,0,32,29,3
16278,E02006436,2009,80,308000,234000,14,30,24,12,15,65,67,13
16279,E02006436,2010,62,328000,250000,10,36,10,6,2,60,55,7
16280,E02006436,2011,60,265000,236000,11,21,22,6,1,59,54,6
16281,E02006436,2012,91,304000,265000,20,37,24,10,0,91,81,10
16282,E02006436,2013,102,304000,262000,24,30,32,16,0,102,85,17
16283,E02006436,2014,23,315000,250000,5,9,5,4,0,23,19,4
16284,E02006437,2009,95,346000,272000,27,32,30,6,8,87,89,6
16285,E02006437,2010,121,419000,310000,47,35,25,14,1,120,107,14
16286,E02006437,2011,78,389000,325000,31,31,7,9,0,78,69,9
16287,E02006437,2012,99,433000,365000,52,23,14,10,10,89,89,10
16288,E02006437,2013,151,425000,368000,72,43,29,7,17,134,144,7
16289,E02006437,2014,52,428000,418000,20,11,8,13,15,37,39,13
16290,E02006438,2009,117,335000,305000,65,33,9,10,26,91,107,10
16291,E02006438,2010,99,409000,368000,68,19,6,6,12,87,94,5
16292,E02006438,2011,79,390000,350000,50,15,10,4,1,78,74,5
16293,E02006438,2012,88,335000,299000,50,22,13,3,0,88,85,3
16294,E02006438,2013,96,375000,338000,60,20,12,4,0,96,92,4
16295,E02006438,2014,42,393000,329000,23,12,6,1,0,42,40,2
16296,E02006439,2009,87,247000,229000,28,32,18,9,0,87,77,10
16297,E02006439,2010,110,255000,244000,27,37,28,18,1,109,92,18
16298,E02006439,2011,68,270000,232000,18,25,17,8,0,68,58,10
16299,E02006439,2012,85,245000,236000,18,35,21,11,0,85,74,11
16300,E02006439,2013,92,279000,250000,33,26,25,8,5,87,84,8
16301,E02006439,2014,37,283000,250000,11,11,8,7,0,37,30,7
16302,E02006440,2009,100,269000,250000,45,30,18,7,0,100,91,9
16303,E02006440,2010,105,298000,270000,48,28,24,5,0,105,98,7
16304,E02006440,2011,101,302000,300000,41,29,24,7,1,100,92,9
16305,E02006440,2012,104,304000,288000,54,25,20,5,1,103,99,5
16306,E02006440,2013,129,297000,275000,58,29,28,14,2,127,116,13
16307,E02006440,2014,43,317000,292000,20,10,11,2,0,43,41,2
16308,E02006441,2009,177,298000,245000,23,37,60,57,57,120,115,62
16309,E02006441,2010,182,323000,280000,41,34,49,58,36,146,121,61
16310,E02006441,2011,121,341000,270000,29,23,32,37,1,120,83,38
16311,E02006441,2012,127,376000,300000,40,14,40,33,0,127,94,33
16312,E02006441,2013,178,323000,270000,30,32,55,61,9,169,115,63
16313,E02006441,2014,52,304000,292000,5,9,21,17,6,46,35,17
16314,E02006442,2009,75,483000,430000,39,14,4,18,7,68,57,18
16315,E02006442,2010,106,735000,632000,72,14,7,13,10,96,91,15
16316,E02006442,2011,115,631000,556000,66,20,6,23,17,98,91,24
16317,E02006442,2012,111,594000,425000,45,16,6,44,31,80,67,44
16318,E02006442,2013,118,656000,592000,67,18,5,28,7,111,89,29
16319,E02006442,2014,31,856000,635000,21,2,0,8,1,30,23,8
16320,E02006443,2009,99,236000,228000,29,32,16,22,0,99,77,22
16321,E02006443,2010,126,256000,245000,20,45,31,30,4,122,94,32
16322,E02006443,2011,115,282000,273000,33,38,28,16,7,108,99,16
16323,E02006443,2012,90,262000,250000,18,32,26,14,0,90,75,15
16324,E02006443,2013,105,274000,266000,17,39,27,22,0,105,82,23
16325,E02006443,2014,41,313000,310000,11,16,6,8,1,40,32,9
16326,E02006444,2009,123,382000,340000,61,41,9,12,10,113,111,12
16327,E02006444,2010,102,405000,325000,41,36,5,20,7,95,82,20
16328,E02006444,2011,90,372000,316000,36,29,10,15,1,89,72,18
16329,E02006444,2012,110,430000,336000,45,31,10,24,11,99,87,23
16330,E02006444,2013,107,397000,395000,36,45,9,17,12,95,90,17
16331,E02006444,2014,37,455000,375000,18,10,3,6,0,37,31,6
16332,E02006445,2009,126,311000,250000,27,31,25,43,4,122,79,47
16333,E02006445,2010,146,375000,303000,38,37,26,45,8,138,99,47
16334,E02006445,2011,138,355000,275000,35,32,23,48,3,135,84,54
16335,E02006445,2012,125,373000,320000,27,35,26,37,9,116,86,39
16336,E02006445,2013,177,351000,321000,26,45,39,67,27,150,109,68
16337,E02006445,2014,71,403000,330000,14,14,16,27,7,64,43,28
16338,E02006446,2009,97,589000,395000,40,33,15,9,1,96,88,9
16339,E02006446,2010,98,704000,490000,49,24,15,10,2,96,88,10
16340,E02006446,2011,89,702000,484000,45,24,6,14,0,89,75,14
16341,E02006446,2012,95,592000,432000,40,31,13,11,0,95,84,11
16342,E02006446,2013,130,579000,442000,64,27,19,20,3,127,110,20
16343,E02006446,2014,24,711000,499000,10,8,4,2,0,24,22,2
16344,E02006447,2009,107,394000,335000,51,28,25,3,2,105,104,3
16345,E02006447,2010,117,439000,340000,52,35,26,4,8,109,113,4
16346,E02006447,2011,96,393000,338000,44,31,14,7,0,96,88,8
16347,E02006447,2012,89,437000,390000,48,22,15,4,0,89,83,6
16348,E02006447,2013,119,455000,405000,44,44,26,5,7,112,112,7
16349,E02006447,2014,34,403000,318000,12,10,12,0,3,31,33,1
16350,E02006448,2009,94,347000,281000,36,23,18,17,12,82,78,16
16351,E02006448,2010,126,373000,320000,52,36,23,15,1,125,110,16
16352,E02006448,2011,115,402000,321000,44,25,32,14,5,110,101,14
16353,E02006448,2012,99,431000,333000,40,30,23,6,0,99,92,7
16354,E02006448,2013,137,463000,390000,58,28,37,14,0,137,123,14
16355,E02006448,2014,34,489000,401000,16,10,3,5,0,34,30,4
16356,E02006449,2009,84,358000,285000,33,23,20,8,0,84,73,11
16357,E02006449,2010,97,440000,365000,45,26,15,11,0,97,79,18
16358,E02006449,2011,92,351000,329000,33,30,17,12,2,90,74,18
16359,E02006449,2012,96,423000,372000,30,31,24,11,12,84,84,12
16360,E02006449,2013,86,421000,358000,27,29,18,12,1,85,74,12
16361,E02006449,2014,37,471000,370000,16,7,5,9,3,34,27,10
16362,E02006450,2009,84,677000,424000,45,23,7,9,2,82,75,9
16363,E02006450,2010,83,661000,522000,38,23,10,12,0,83,70,13
16364,E02006450,2011,84,728000,506000,42,18,10,14,0,84,71,13
16365,E02006450,2012,72,518000,405000,26,17,18,11,1,71,59,13
16366,E02006450,2013,77,670000,540000,34,20,12,11,7,70,66,11
16367,E02006450,2014,28,699000,571000,17,4,5,2,0,28,25,3
16368,E02006451,2009,139,349000,295000,54,42,27,16,2,137,112,27
16369,E02006451,2010,162,356000,310000,61,48,22,31,2,160,121,41
16370,E02006451,2011,167,398000,311000,73,38,30,26,2,165,121,46
16371,E02006451,2012,177,389000,365000,85,36,32,24,5,172,141,36
16372,E02006451,2013,192,398000,345000,78,49,30,35,3,189,150,42
16373,E02006451,2014,59,402000,368000,24,20,8,7,1,58,49,10
16374,E02006453,2009,89,444000,340000,44,23,10,12,0,89,69,20
16375,E02006453,2010,118,490000,392000,52,37,7,22,1,117,93,25
16376,E02006453,2011,107,458000,382000,43,39,12,13,1,106,85,22
16377,E02006453,2012,99,474000,394000,37,30,17,15,7,92,80,19
16378,E02006453,2013,108,447000,377000,41,27,22,18,3,105,83,25
16379,E02006453,2014,41,536000,355000,13,19,5,4,1,40,33,8
16380,E02006454,2009,107,386000,290000,35,26,25,21,17,90,81,26
16381,E02006454,2010,107,480000,375000,46,22,13,26,15,92,80,27
16382,E02006454,2011,106,421000,300000,38,28,21,19,6,100,85,21
16383,E02006454,2012,90,507000,350000,39,17,13,21,3,87,69,21
16384,E02006454,2013,133,556000,360000,53,25,25,30,2,131,99,34
16385,E02006454,2014,53,516000,340000,19,10,7,17,1,52,35,18
16386,E02006455,2009,85,297000,250000,26,28,12,19,0,85,66,19
16387,E02006455,2010,113,327000,268000,48,17,19,29,0,113,80,33
16388,E02006455,2011,93,305000,280000,30,26,16,21,0,93,72,21
16389,E02006455,2012,87,375000,305000,37,16,14,20,0,87,67,20
16390,E02006455,2013,120,356000,306000,50,22,19,29,5,115,92,28
16391,E02006455,2014,35,372000,274000,8,7,13,7,1,34,27,8
16392,E02006456,2009,146,251000,232000,13,53,47,33,19,127,107,39
16393,E02006456,2010,135,261000,242000,15,47,31,42,17,118,90,45
16394,E02006456,2011,132,261000,250000,16,46,34,36,4,128,98,34
16395,E02006456,2012,146,266000,250000,21,39,55,31,7,139,115,31
16396,E02006456,2013,151,280000,270000,19,45,48,39,11,140,113,38
16397,E02006456,2014,57,306000,295000,7,20,14,16,0,57,41,16
16398,E02006457,2009,166,467000,394000,87,10,12,57,26,140,110,56
16399,E02006457,2010,141,496000,460000,85,18,8,30,2,139,108,33
16400,E02006457,2011,137,515000,485000,77,15,11,34,5,132,103,34
16401,E02006457,2012,139,550000,495000,82,21,6,30,3,136,108,31
16402,E02006457,2013,168,535000,495000,91,23,12,42,8,160,125,43
16403,E02006457,2014,55,525000,535000,28,5,4,18,5,50,37,18
16404,E02006458,2009,120,430000,430000,62,27,14,17,9,111,102,18
16405,E02006458,2010,148,533000,500000,87,34,8,19,16,132,125,23
16406,E02006458,2011,144,456000,450000,71,29,9,35,18,126,107,37
16407,E02006458,2012,120,452000,415000,61,27,9,23,3,117,97,23
16408,E02006458,2013,159,549000,500000,101,26,8,24,2,157,135,24
16409,E02006458,2014,48,567000,482000,29,11,1,7,0,48,41,7
16410,E02006459,2009,73,194000,195000,1,27,28,17,0,73,57,16
16411,E02006459,2010,86,204000,211000,3,34,26,23,0,86,58,28
16412,E02006459,2011,96,202000,208000,1,30,37,28,0,96,65,31
16413,E02006459,2012,94,212000,218000,1,24,36,33,9,85,58,36
16414,E02006459,2013,98,212000,220000,2,27,31,38,3,95,61,37
16415,E02006459,2014,59,226000,225000,2,13,16,28,7,52,31,28
16416,E02006460,2009,164,199000,195000,14,31,90,29,0,164,134,30
16417,E02006460,2010,128,220000,210000,18,31,53,26,0,128,100,28
16418,E02006460,2011,139,226000,208000,24,18,79,18,0,139,125,14
16419,E02006460,2012,143,230000,215000,20,19,85,19,0,143,122,21
16420,E02006460,2013,146,229000,220000,21,20,74,31,0,146,115,31
16421,E02006460,2014,51,241000,238000,7,3,27,14,0,51,35,16
16422,E02006461,2009,106,405000,284000,39,23,20,24,9,97,81,25
16423,E02006461,2010,96,447000,376000,44,15,18,19,2,94,76,20
16424,E02006461,2011,126,397000,282000,39,13,14,60,28,98,64,62
16425,E02006461,2012,125,454000,360000,49,25,15,36,9,116,90,35
16426,E02006461,2013,122,548000,416000,52,26,13,31,3,119,90,32
16427,E02006461,2014,45,621000,550000,24,6,3,12,4,41,33,12
16428,E02006462,2009,124,252000,230000,29,30,38,27,0,124,97,27
16429,E02006462,2010,161,267000,242000,39,46,45,31,0,161,129,32
16430,E02006462,2011,131,265000,240000,34,32,38,27,0,131,105,26
16431,E02006462,2012,105,275000,245000,25,31,27,22,1,104,84,21
16432,E02006462,2013,157,313000,250000,42,35,44,36,3,154,120,37
16433,E02006462,2014,54,319000,264000,10,14,9,21,0,54,33,21
16434,E02006463,2009,217,222000,197000,27,24,27,139,61,156,76,141
16435,E02006463,2010,238,248000,218000,29,37,37,135,49,189,100,138
16436,E02006463,2011,260,232000,198000,21,29,37,173,76,184,83,177
16437,E02006463,2012,271,239000,205000,19,22,26,204,114,157,65,206
16438,E02006463,2013,408,249000,243000,22,25,47,314,196,212,88,320
16439,E02006463,2014,154,260000,214000,12,3,11,128,67,87,23,131
16440,E02006464,2009,78,260000,230000,12,31,22,13,1,77,64,14
16441,E02006464,2010,87,292000,249000,18,34,17,18,0,87,69,18
16442,E02006464,2011,92,310000,250000,21,31,23,17,0,92,74,18
16443,E02006464,2012,93,288000,250000,13,28,39,13,3,90,80,13
16444,E02006464,2013,109,302000,250000,17,32,36,24,0,109,85,24
16445,E02006464,2014,35,330000,280000,4,13,8,10,0,35,25,10
16446,E02006465,2009,99,344000,240000,39,14,17,29,19,80,67,32
16447,E02006465,2010,112,521000,410000,51,18,24,19,15,97,88,24
16448,E02006465,2011,98,485000,330000,42,11,20,25,0,98,70,28
16449,E02006465,2012,99,456000,350000,46,12,28,13,0,99,80,19
16450,E02006465,2013,104,465000,430000,54,9,18,23,0,104,79,25
16451,E02006465,2014,49,487000,377000,19,3,11,16,1,48,31,18
16452,E02006466,2009,102,255000,232000,23,45,18,16,1,101,86,16
16453,E02006466,2010,131,276000,250000,25,72,26,8,11,120,121,10
16454,E02006466,2011,118,275000,249000,29,47,26,16,9,109,103,15
16455,E02006466,2012,170,299000,274000,30,56,37,47,48,122,122,48
16456,E02006466,2013,200,294000,268000,28,81,42,49,56,144,147,53
16457,E02006466,2014,67,323000,320000,14,14,19,20,11,56,46,21
16458,E02006467,2009,79,421000,350000,39,19,10,11,12,67,67,12
16459,E02006467,2010,113,431000,383000,47,38,14,14,13,100,99,14
16460,E02006467,2011,113,521000,380000,55,32,10,16,19,94,94,19
16461,E02006467,2012,77,502000,395000,39,18,14,6,3,74,72,5
16462,E02006467,2013,110,448000,366000,51,36,17,6,1,109,104,6
16463,E02006467,2014,27,608000,410000,12,8,4,3,1,26,24,3
16464,E02006534,2009,103,206000,202000,17,66,13,7,0,103,95,8
16465,E02006534,2010,119,232000,237000,18,62,28,11,0,119,109,10
16466,E02006534,2011,122,223000,221000,19,73,22,8,0,122,114,8
16467,E02006534,2012,112,242000,240000,25,56,20,11,14,98,100,12
16468,E02006534,2013,115,248000,244000,22,60,17,16,0,115,98,17
16469,E02006534,2014,45,253000,250000,6,29,7,3,0,45,42,3
16470,E02006535,2009,91,243000,228000,29,33,14,15,0,91,77,14
16471,E02006535,2010,99,270000,242000,18,46,29,6,0,99,93,6
16472,E02006535,2011,129,271000,250000,24,45,46,14,17,112,113,16
16473,E02006535,2012,137,283000,273000,17,50,57,13,37,100,123,14
16474,E02006535,2013,174,268000,250000,29,39,53,53,62,112,122,52
16475,E02006535,2014,33,318000,280000,8,9,9,7,5,28,26,7
16476,E02006536,2009,84,209000,182000,20,40,22,2,1,83,83,1
16477,E02006536,2010,85,212000,202000,15,44,22,4,0,85,81,4
16478,E02006536,2011,116,208000,198000,30,53,27,6,0,116,111,5
16479,E02006536,2012,92,221000,210000,21,50,20,1,0,92,91,1
16480,E02006536,2013,120,230000,220000,31,58,24,7,3,117,113,7
16481,E02006536,2014,40,261000,237000,10,19,11,0,0,40,40,0
16482,E02006537,2009,95,187000,173000,10,27,38,20,0,95,74,21
16483,E02006537,2010,123,208000,202000,9,27,40,47,16,107,77,46
16484,E02006537,2011,127,200000,190000,11,38,48,30,4,123,96,31
16485,E02006537,2012,128,217000,209000,11,36,51,30,0,128,97,31
16486,E02006537,2013,97,230000,225000,7,27,46,17,0,97,80,17
16487,E02006537,2014,59,241000,225000,4,14,28,13,0,59,47,12
16488,E02006538,2009,148,239000,221000,25,29,39,55,10,138,90,58
16489,E02006538,2010,175,262000,238000,37,25,42,71,9,166,103,72
16490,E02006538,2011,207,252000,210000,41,28,37,101,16,191,105,102
16491,E02006538,2012,185,269000,232000,36,24,53,72,10,175,111,74
16492,E02006538,2013,198,263000,247000,21,30,61,86,5,193,104,94
16493,E02006538,2014,83,309000,265000,13,10,21,39,0,83,45,38
16494,E02006539,2009,119,181000,178000,20,67,25,7,0,119,113,6
16495,E02006539,2010,89,191000,186000,16,43,20,10,0,89,79,10
16496,E02006539,2011,89,187000,184000,11,48,16,14,0,89,74,15
16497,E02006539,2012,112,203000,205000,25,51,29,7,1,111,105,7
16498,E02006539,2013,109,204000,193000,19,44,33,13,6,103,96,13
16499,E02006539,2014,50,215000,210000,9,22,16,3,2,48,47,3
16500,E02006540,2009,82,168000,171000,18,26,27,11,0,82,71,11
16501,E02006540,2010,56,180000,178000,8,25,14,9,0,56,47,9
16502,E02006540,2011,76,185000,174000,12,26,27,11,0,76,66,10
16503,E02006540,2012,81,211000,185000,10,37,26,8,7,74,73,8
16504,E02006540,2013,86,202000,185000,13,34,26,13,1,85,74,12
16505,E02006540,2014,21,216000,210000,5,8,5,3,0,21,18,3
16506,E02006541,2009,147,156000,160000,17,43,25,62,5,142,84,63
16507,E02006541,2010,133,174000,175000,18,41,23,51,0,133,80,53
16508,E02006541,2011,130,175000,169000,22,34,22,52,2,128,82,48
16509,E02006541,2012,140,174000,173000,20,37,39,44,8,132,98,42
16510,E02006541,2013,136,187000,190000,21,39,19,57,1,135,81,55
16511,E02006541,2014,49,194000,198000,8,16,10,15,0,49,33,16
16512,E02006542,2009,93,307000,283000,26,20,26,21,6,87,68,25
16513,E02006542,2010,98,346000,289000,29,16,35,18,6,92,79,19
16514,E02006542,2011,109,341000,291000,36,16,38,19,5,104,89,20
16515,E02006542,2012,82,412000,371000,29,14,27,12,0,82,69,13
16516,E02006542,2013,114,401000,361000,35,15,46,18,0,114,95,19
16517,E02006542,2014,45,417000,325000,14,4,17,10,0,45,34,11
16518,E02006543,2009,94,255000,218000,36,30,24,4,0,94,90,4
16519,E02006543,2010,88,297000,249000,40,22,21,5,0,88,83,5
16520,E02006543,2011,86,274000,228000,31,24,25,6,2,84,80,6
16521,E02006543,2012,90,255000,218000,31,19,33,7,3,87,83,7
16522,E02006543,2013,101,271000,238000,41,21,33,6,3,98,95,6
16523,E02006543,2014,39,276000,225000,10,12,13,4,1,38,35,4
16524,E02006544,2009,126,249000,206000,51,29,24,22,8,118,104,22
16525,E02006544,2010,148,271000,232000,56,48,22,22,17,131,123,25
16526,E02006544,2011,144,258000,218000,55,38,33,18,4,140,125,19
16527,E02006544,2012,114,313000,246000,55,28,21,10,1,113,104,10
16528,E02006544,2013,186,276000,240000,80,43,37,26,16,170,160,26
16529,E02006544,2014,68,292000,232000,31,14,11,12,0,68,56,12
16530,E02006545,2009,140,169000,160000,19,42,67,12,35,105,130,10
16531,E02006545,2010,153,180000,166000,24,50,65,14,34,119,135,18
16532,E02006545,2011,132,170000,160000,22,27,54,29,27,105,101,31
16533,E02006545,2012,122,163000,160000,11,33,60,18,24,98,100,22
16534,E02006545,2013,126,172000,162000,14,37,63,12,9,117,114,12
16535,E02006545,2014,44,177000,178000,8,9,17,10,0,44,33,11
16536,E02006546,2009,182,234000,198000,49,61,35,37,14,168,147,35
16537,E02006546,2010,178,263000,219000,65,48,37,28,5,173,150,28
16538,E02006546,2011,161,257000,227000,54,40,43,24,1,160,134,27
16539,E02006546,2012,181,259000,229000,62,56,40,23,11,170,160,21
16540,E02006546,2013,199,266000,241000,75,56,39,29,11,188,167,32
16541,E02006546,2014,80,262000,232000,26,25,23,6,0,80,73,7
16542,E02006547,2009,83,211000,177000,25,30,20,8,5,78,74,9
16543,E02006547,2010,72,242000,199000,26,16,24,6,6,66,63,9
16544,E02006547,2011,73,211000,175000,18,26,23,6,4,69,65,8
16545,E02006547,2012,53,221000,185000,15,21,15,2,0,53,51,2
16546,E02006547,2013,89,219000,190000,21,23,42,3,1,88,85,4
16547,E02006547,2014,32,239000,202000,10,9,11,2,0,32,30,2
16548,E02006548,2009,171,181000,163000,36,48,69,18,5,166,154,17
16549,E02006548,2010,162,211000,190000,54,31,64,13,12,150,148,14
16550,E02006548,2011,163,195000,182000,40,43,67,13,6,157,151,12
16551,E02006548,2012,183,206000,188000,45,39,84,15,12,171,168,15
16552,E02006548,2013,193,212000,200000,54,47,82,10,11,182,183,10
16553,E02006548,2014,66,223000,227000,20,13,25,8,1,65,56,10
16554,E02006549,2009,140,293000,262000,93,20,8,19,6,134,122,18
16555,E02006549,2010,136,332000,300000,97,25,6,8,2,134,130,6
16556,E02006549,2011,107,319000,280000,75,14,3,15,1,106,97,10
16557,E02006549,2012,135,372000,320000,102,23,3,7,2,133,133,2
16558,E02006549,2013,150,337000,309000,109,27,4,10,2,148,143,7
16559,E02006549,2014,48,367000,322000,37,4,2,5,0,48,43,5
16560,E02006550,2009,171,189000,185000,32,74,30,35,4,167,136,35
16561,E02006550,2010,134,212000,204000,42,44,28,20,0,134,114,20
16562,E02006550,2011,171,195000,190000,35,61,29,46,7,164,125,46
16563,E02006550,2012,168,209000,200000,46,62,25,35,8,160,134,34
16564,E02006550,2013,191,207000,192000,44,54,49,44,0,191,147,44
16565,E02006550,2014,79,214000,220000,18,26,16,19,0,79,60,19
16566,E02006551,2009,212,263000,250000,77,34,24,77,12,200,131,81
16567,E02006551,2010,217,292000,250000,87,17,36,77,19,198,135,82
16568,E02006551,2011,225,285000,250000,101,26,29,69,13,212,146,79
16569,E02006551,2012,247,314000,275000,118,19,33,77,10,237,162,85
16570,E02006551,2013,232,331000,275000,112,18,34,68,11,221,157,75
16571,E02006551,2014,90,322000,262000,34,5,15,36,2,88,49,41
16572,E02006552,2009,140,133000,115000,3,11,47,79,1,139,62,78
16573,E02006552,2010,119,154000,130000,1,7,45,66,1,118,55,64
16574,E02006552,2011,102,153000,142000,6,6,44,46,0,102,54,48
16575,E02006552,2012,135,151000,145000,3,11,49,72,0,135,65,70
16576,E02006552,2013,125,153000,140000,3,4,44,74,2,123,53,72
16577,E02006552,2014,52,155000,122000,2,4,17,29,0,52,25,27
16578,E02006553,2009,123,157000,155000,16,50,46,11,0,123,111,12
16579,E02006553,2010,115,193000,172000,22,39,41,13,15,100,101,14
16580,E02006553,2011,177,191000,180000,38,71,55,13,55,122,162,15
16581,E02006553,2012,182,197000,187000,28,66,67,21,67,115,165,17
16582,E02006553,2013,185,204000,185000,38,52,77,18,50,135,167,18
16583,E02006553,2014,69,209000,185000,15,16,35,3,16,53,65,4
16584,E02006554,2009,132,217000,185000,50,31,20,31,6,126,100,32
16585,E02006554,2010,121,231000,210000,49,23,22,27,1,120,92,29
16586,E02006554,2011,118,245000,210000,49,25,20,24,0,118,94,24
16587,E02006554,2012,116,222000,205000,48,15,25,28,0,116,86,30
16588,E02006554,2013,139,236000,210000,63,29,23,24,1,138,113,26
16589,E02006554,2014,53,227000,213000,24,8,11,10,0,53,41,12
16590,E02006555,2009,77,159000,150000,7,30,25,15,0,77,60,17
16591,E02006555,2010,82,166000,160000,9,31,24,18,0,82,63,19
16592,E02006555,2011,111,158000,155000,17,34,34,26,0,111,83,28
16593,E02006555,2012,90,166000,164000,9,41,26,14,0,90,76,14
16594,E02006555,2013,97,166000,162000,14,28,30,25,1,96,72,25
16595,E02006555,2014,47,162000,162000,6,9,16,16,0,47,31,16
16596,E02006556,2009,151,257000,235000,92,38,12,9,0,151,142,9
16597,E02006556,2010,170,266000,231000,100,37,15,18,0,170,152,18
16598,E02006556,2011,190,269000,242000,109,38,29,14,37,153,176,14
16599,E02006556,2012,189,265000,238000,87,46,38,18,52,137,172,17
16600,E02006556,2013,249,258000,238000,112,58,52,27,91,158,222,27
16601,E02006556,2014,68,277000,250000,35,16,8,9,15,53,59,9
16602,E02006557,2009,62,168000,155000,11,18,21,12,2,60,47,15
16603,E02006557,2010,72,178000,170000,20,21,15,16,1,71,53,19
16604,E02006557,2011,88,177000,165000,20,31,23,14,0,88,70,18
16605,E02006557,2012,85,178000,165000,15,36,11,23,7,78,59,26
16606,E02006557,2013,88,178000,170000,17,27,26,18,8,80,68,20
16607,E02006557,2014,53,181000,188000,7,20,10,16,9,44,37,16
16608,E02006558,2009,189,178000,155000,14,12,26,137,37,152,52,137
16609,E02006558,2010,170,181000,151000,23,11,24,112,13,157,58,112
16610,E02006558,2011,168,151000,125000,14,15,24,115,9,159,52,116
16611,E02006558,2012,142,168000,152000,31,10,19,82,2,140,61,81
16612,E02006558,2013,166,161000,143000,22,17,20,107,2,164,60,106
16613,E02006558,2014,69,168000,138000,12,6,6,45,0,69,26,43
16614,E02006559,2009,170,252000,225000,89,32,13,36,5,165,133,37
16615,E02006559,2010,172,282000,245000,98,20,21,33,3,169,140,32
16616,E02006559,2011,204,301000,260000,133,23,24,24,2,202,178,26
16617,E02006559,2012,152,302000,250000,95,19,9,29,0,152,124,28
16618,E02006559,2013,167,306000,275000,112,21,12,22,0,167,145,22
16619,E02006559,2014,76,286000,262000,41,12,6,17,0,76,58,18
16620,E02006560,2009,190,189000,176000,70,66,35,19,2,188,171,19
16621,E02006560,2010,177,218000,195000,55,61,38,23,3,174,158,19
16622,E02006560,2011,163,216000,197000,65,55,33,10,1,162,152,11
16623,E02006560,2012,191,221000,208000,75,65,37,14,16,175,179,12
16624,E02006560,2013,186,231000,220000,72,66,39,9,6,180,176,10
16625,E02006560,2014,56,233000,219000,20,23,11,2,0,56,54,2
16626,E02006561,2009,81,385000,295000,41,22,13,5,0,81,73,8
16627,E02006561,2010,116,495000,324000,58,34,18,6,1,115,107,9
16628,E02006561,2011,87,422000,320000,43,24,13,7,3,84,80,7
16629,E02006561,2012,93,419000,360000,52,14,19,8,4,89,84,9
16630,E02006561,2013,94,499000,358000,43,31,13,7,2,92,85,9
16631,E02006561,2014,36,472000,376000,19,12,1,4,1,35,31,5
16632,E02006562,2009,76,451000,435000,51,12,9,4,9,67,73,3
16633,E02006562,2010,86,496000,452000,56,18,10,2,12,74,84,2
16634,E02006562,2011,99,599000,547000,81,13,3,2,6,93,97,2
16635,E02006562,2012,74,505000,439000,52,12,9,1,1,73,71,3
16636,E02006562,2013,94,469000,465000,56,21,13,4,2,92,90,4
16637,E02006562,2014,25,498000,495000,17,1,5,2,1,24,23,2
16638,E02006563,2009,57,507000,380000,28,16,13,0,0,57,57,0
16639,E02006563,2010,69,574000,425000,44,18,6,1,0,69,67,2
16640,E02006563,2011,63,626000,430000,36,14,9,4,0,63,58,5
16641,E02006563,2012,47,544000,438000,28,12,3,4,1,46,43,4
16642,E02006563,2013,70,545000,398000,42,19,9,0,2,68,69,1
16643,E02006563,2014,26,630000,455000,14,4,6,2,0,26,24,2
16644,E02006564,2009,126,291000,234000,37,31,27,31,13,113,94,32
16645,E02006564,2010,122,309000,260000,39,20,25,38,26,96,82,40
16646,E02006564,2011,109,315000,250000,32,26,34,17,3,106,92,17
16647,E02006564,2012,110,326000,268000,42,15,31,22,6,104,87,23
16648,E02006564,2013,159,319000,247000,50,20,53,36,3,156,119,40
16649,E02006564,2014,60,358000,284000,23,10,15,12,1,59,45,15
16650,E02006565,2009,82,473000,358000,44,21,14,3,3,79,79,3
16651,E02006565,2010,103,559000,390000,57,19,20,7,1,102,94,9
16652,E02006565,2011,89,449000,372000,40,26,16,7,1,88,80,9
16653,E02006565,2012,81,472000,370000,35,21,19,6,0,81,72,9
16654,E02006565,2013,110,491000,365000,49,30,26,5,0,110,105,5
16655,E02006565,2014,44,600000,441000,24,5,9,6,0,44,38,6
16656,E02006566,2009,111,333000,283000,44,23,20,24,25,86,73,38
16657,E02006566,2010,140,381000,348000,52,36,37,15,36,104,108,32
16658,E02006566,2011,104,433000,349000,44,24,22,14,29,75,74,30
16659,E02006566,2012,127,406000,345000,61,24,30,12,28,99,97,30
16660,E02006566,2013,131,413000,365000,56,28,30,17,18,113,98,33
16661,E02006566,2014,38,433000,411000,18,7,9,4,0,38,32,6
16662,E02006567,2009,78,332000,266000,28,30,17,3,6,72,71,7
16663,E02006567,2010,98,359000,293000,29,42,20,7,22,76,77,21
16664,E02006567,2011,88,436000,275000,28,31,20,9,4,84,77,11
16665,E02006567,2012,87,345000,248000,30,33,16,8,0,87,79,8
16666,E02006567,2013,100,348000,261000,34,38,18,10,3,97,89,11
16667,E02006567,2014,36,363000,269000,9,13,10,4,0,36,32,4
16668,E02006568,2009,202,221000,218000,18,35,72,77,67,135,122,80
16669,E02006568,2010,184,242000,243000,17,44,65,58,37,147,124,60
16670,E02006568,2011,161,268000,250000,14,37,52,58,26,135,101,60
16671,E02006568,2012,172,263000,246000,10,31,74,57,36,136,116,56
16672,E02006568,2013,229,272000,250000,15,44,87,83,60,169,145,84
16673,E02006568,2014,72,271000,246000,7,10,28,27,9,63,45,27
16674,E02006569,2009,126,367000,296000,56,30,38,2,15,111,124,2
16675,E02006569,2010,91,428000,340000,52,18,17,4,2,89,84,7
16676,E02006569,2011,118,449000,332000,68,30,16,4,13,105,112,6
16677,E02006569,2012,108,385000,320000,56,15,27,10,18,90,101,7
16678,E02006569,2013,140,410000,320000,67,35,30,8,24,116,130,10
16679,E02006569,2014,46,421000,312000,23,5,14,4,6,40,41,5
16680,E02006570,2009,179,211000,195000,16,33,59,71,12,167,105,74
16681,E02006570,2010,214,256000,226000,22,26,79,87,24,190,128,86
16682,E02006570,2011,164,273000,220000,23,18,52,71,18,146,92,72
16683,E02006570,2012,232,289000,250000,27,29,74,102,63,169,129,103
16684,E02006570,2013,227,300000,235000,22,29,79,97,23,204,132,95
16685,E02006570,2014,78,279000,247000,11,8,27,32,7,71,44,34
16686,E02006571,2009,143,263000,235000,55,35,32,21,11,132,122,21
16687,E02006571,2010,124,297000,266000,51,34,22,17,4,120,107,17
16688,E02006571,2011,136,292000,249000,43,34,43,16,26,110,123,13
16689,E02006571,2012,116,331000,280000,49,22,29,16,7,109,100,16
16690,E02006571,2013,162,321000,281000,58,51,40,13,19,143,148,14
16691,E02006571,2014,45,330000,285000,18,18,6,3,1,44,43,2
16692,E02006572,2009,111,250000,205000,32,34,34,11,13,98,101,10
16693,E02006572,2010,126,269000,232000,27,37,43,19,31,95,106,20
16694,E02006572,2011,136,254000,215000,35,37,38,26,18,118,111,25
16695,E02006572,2012,131,250000,220000,29,35,45,22,21,110,109,22
16696,E02006572,2013,103,260000,230000,22,22,45,14,3,100,87,16
16697,E02006572,2014,44,298000,255000,12,13,14,5,0,44,39,5
16698,E02006573,2009,198,351000,255000,117,37,19,25,8,190,171,27
16699,E02006573,2010,169,391000,270000,87,42,23,17,1,168,149,20
16700,E02006573,2011,200,370000,288000,110,53,15,22,0,200,177,23
16701,E02006573,2012,192,391000,272000,115,33,27,17,3,189,175,17
16702,E02006573,2013,253,412000,310000,145,55,32,21,12,241,229,24
16703,E02006573,2014,88,374000,309000,54,12,13,9,5,83,79,9
16704,E02006574,2009,195,207000,186000,79,72,27,17,5,190,179,16
16705,E02006574,2010,223,224000,197000,91,71,35,26,2,221,198,25
16706,E02006574,2011,193,216000,208000,76,67,21,29,3,190,163,30
16707,E02006574,2012,182,226000,208000,77,62,19,24,1,181,158,24
16708,E02006574,2013,206,230000,217000,81,66,38,21,3,203,185,21
16709,E02006574,2014,95,241000,220000,41,30,16,8,2,93,87,8
16710,E02006575,2009,80,193000,178000,4,29,40,7,31,49,72,8
16711,E02006575,2010,39,195000,185000,2,14,22,1,0,39,38,1
16712,E02006575,2011,59,169000,165000,3,15,32,9,0,59,50,9
16713,E02006575,2012,50,190000,180000,2,17,30,1,0,50,49,1
16714,E02006575,2013,77,196000,194000,4,17,48,8,1,76,68,9
16715,E02006575,2014,24,211000,222000,1,7,13,3,0,24,21,3
16716,E02006576,2009,88,218000,194000,23,21,35,9,0,88,80,8
16717,E02006576,2010,88,252000,230000,33,14,29,12,0,88,76,12
16718,E02006576,2011,119,265000,243000,54,18,34,13,0,119,105,14
16719,E02006576,2012,105,242000,225000,40,14,37,14,0,105,91,14
16720,E02006576,2013,123,258000,238000,41,13,47,22,0,123,101,22
16721,E02006576,2014,63,246000,225000,14,8,26,15,0,63,48,15
16722,E02006577,2009,76,180000,172000,4,16,37,19,3,73,56,20
16723,E02006577,2010,78,193000,190000,4,21,29,24,0,78,54,24
16724,E02006577,2011,87,188000,182000,10,17,31,29,0,87,56,31
16725,E02006577,2012,66,206000,195000,9,14,30,13,3,63,53,13
16726,E02006577,2013,102,227000,215000,13,22,45,22,9,93,80,22
16727,E02006577,2014,41,218000,220000,1,10,18,12,0,41,29,12
16728,E02006578,2009,240,171000,170000,9,9,38,184,139,101,56,184
16729,E02006578,2010,203,170000,165000,7,18,30,148,133,70,54,149
16730,E02006578,2011,189,177000,168000,12,14,45,118,99,90,71,118
16731,E02006578,2012,188,179000,160000,15,17,28,128,82,106,61,127
16732,E02006578,2013,136,200000,180000,9,21,37,69,5,131,67,69
16733,E02006578,2014,59,204000,185000,2,2,18,37,5,54,22,37
16734,E02006579,2009,70,199000,190000,9,25,24,12,5,65,59,11
16735,E02006579,2010,70,215000,205000,5,30,24,11,3,67,59,11
16736,E02006579,2011,78,214000,204000,8,35,28,7,2,76,71,7
16737,E02006579,2012,82,225000,211000,17,27,26,12,0,82,70,12
16738,E02006579,2013,83,248000,232000,18,31,24,10,0,83,73,10
16739,E02006579,2014,35,234000,238000,3,14,10,8,0,35,27,8
16740,E02006580,2009,79,182000,172000,10,19,35,15,0,79,64,15
16741,E02006580,2010,92,207000,188000,14,29,38,11,0,92,81,11
16742,E02006580,2011,87,194000,180000,7,28,40,12,0,87,73,14
16743,E02006580,2012,106,207000,184000,16,18,65,7,0,106,99,7
16744,E02006580,2013,113,221000,205000,7,32,57,17,1,112,96,17
16745,E02006580,2014,37,217000,217000,5,10,14,8,1,36,29,8
16746,E02006581,2009,96,175000,170000,7,23,40,26,8,88,69,27
16747,E02006581,2010,93,190000,195000,8,28,35,22,0,93,71,22
16748,E02006581,2011,125,195000,187000,17,33,39,36,31,94,89,36
16749,E02006581,2012,103,220000,200000,24,23,36,20,24,79,82,21
16750,E02006581,2013,140,211000,198000,18,30,53,39,5,135,103,37
16751,E02006581,2014,46,216000,220000,4,10,20,12,0,46,35,11
16752,E02006582,2009,116,260000,230000,49,17,20,30,32,84,86,30
16753,E02006582,2010,159,283000,275000,66,34,40,19,42,117,137,22
16754,E02006582,2011,144,256000,227000,55,19,30,40,33,111,104,40
16755,E02006582,2012,111,283000,250000,54,21,25,11,0,111,100,11
16756,E02006582,2013,155,268000,265000,61,20,53,21,0,155,134,21
16757,E02006582,2014,51,297000,277000,22,9,12,8,0,51,43,8
16758,E02006583,2009,100,193000,190000,10,26,45,19,0,100,80,20
16759,E02006583,2010,93,221000,212000,13,37,31,12,0,93,82,11
16760,E02006583,2011,115,213000,205000,12,40,54,9,0,115,106,9
16761,E02006583,2012,132,204000,200000,14,31,60,27,7,125,103,29
16762,E02006583,2013,146,243000,228000,18,43,73,12,23,123,133,13
16763,E02006583,2014,46,237000,236000,2,13,22,9,3,43,37,9
16764,E02006584,2009,62,147000,150000,1,3,40,18,0,62,44,18
16765,E02006584,2010,52,161000,169000,3,3,36,10,2,50,41,11
16766,E02006584,2011,58,155000,162000,0,8,39,11,4,54,46,12
16767,E02006584,2012,51,159000,168000,1,3,38,9,1,50,42,9
16768,E02006584,2013,68,165000,175000,0,0,47,21,2,66,47,21
16769,E02006584,2014,38,167000,175000,0,0,20,18,6,32,20,18
16770,E02006585,2009,54,175000,175000,1,10,38,5,0,54,48,6
16771,E02006585,2010,61,181000,180000,1,8,40,12,0,61,49,12
16772,E02006585,2011,55,174000,175000,0,8,38,9,0,55,46,9
16773,E02006585,2012,56,189000,190000,0,8,40,8,0,56,47,9
16774,E02006585,2013,68,197000,205000,0,5,50,13,0,68,55,13
16775,E02006585,2014,29,209000,220000,0,4,18,7,0,29,22,7
16776,E02006586,2009,57,141000,144000,1,3,46,7,0,57,48,9
16777,E02006586,2010,49,156000,157000,2,2,42,3,0,49,47,2
16778,E02006586,2011,75,154000,155000,2,6,62,5,0,75,70,5
16779,E02006586,2012,59,154000,158000,0,7,48,4,0,59,55,4
16780,E02006586,2013,64,160000,170000,0,2,53,9,0,64,55,9
16781,E02006586,2014,26,178000,180000,2,1,18,5,0,26,21,5
16782,E02006587,2009,53,144000,147000,0,10,32,11,0,53,44,9
16783,E02006587,2010,76,161000,155000,2,23,41,10,1,75,67,9
16784,E02006587,2011,58,157000,150000,2,10,40,6,0,58,54,4
16785,E02006587,2012,71,182000,157000,9,13,39,10,3,68,61,10
16786,E02006587,2013,89,166000,165000,6,10,55,18,0,89,70,19
16787,E02006587,2014,44,183000,176000,4,6,25,9,0,44,36,8
16788,E02006588,2009,90,325000,235000,33,20,24,13,0,90,74,16
16789,E02006588,2010,117,329000,232000,31,27,31,28,0,117,86,31
16790,E02006588,2011,102,299000,242000,32,23,29,18,2,100,84,18
16791,E02006588,2012,86,288000,232000,23,14,27,22,0,86,62,24
16792,E02006588,2013,146,272000,242000,37,26,37,46,9,137,100,46
16793,E02006588,2014,50,285000,240000,8,11,11,20,6,44,29,21
16794,E02006589,2009,159,249000,223000,57,48,50,4,1,158,154,5
16795,E02006589,2010,152,305000,274000,68,40,41,3,0,152,148,4
16796,E02006589,2011,160,272000,240000,54,47,52,7,1,159,151,9
16797,E02006589,2012,164,305000,257000,59,38,63,4,8,156,160,4
16798,E02006589,2013,162,328000,286000,73,37,46,6,2,160,156,6
16799,E02006589,2014,57,309000,275000,21,14,19,3,0,57,54,3
16800,E02006590,2009,114,233000,196000,22,21,28,43,0,114,70,44
16801,E02006590,2010,131,293000,234000,36,22,36,37,3,128,90,41
16802,E02006590,2011,118,269000,224000,18,24,39,37,3,115,77,41
16803,E02006590,2012,143,276000,240000,22,26,59,36,13,130,100,43
16804,E02006590,2013,140,313000,261000,30,23,43,44,0,140,90,50
16805,E02006590,2014,57,269000,240000,7,10,17,23,0,57,32,25
16806,E02006591,2009,150,218000,200000,24,34,21,71,2,148,78,72
16807,E02006591,2010,154,245000,227000,19,57,29,49,12,142,103,51
16808,E02006591,2011,108,245000,243000,21,36,19,32,0,108,74,34
16809,E02006591,2012,134,244000,233000,32,31,23,48,2,132,86,48
16810,E02006591,2013,144,251000,230000,29,40,23,52,0,144,92,52
16811,E02006591,2014,47,257000,240000,10,11,5,21,0,47,26,21
16812,E02006592,2009,68,391000,295000,29,18,2,19,15,53,48,20
16813,E02006592,2010,65,419000,365000,35,19,5,6,0,65,60,5
16814,E02006592,2011,64,552000,381000,36,18,5,5,0,64,56,8
16815,E02006592,2012,58,557000,414000,34,16,3,5,0,58,53,5
16816,E02006592,2013,78,515000,408000,43,26,7,2,0,78,74,4
16817,E02006592,2014,28,461000,358000,18,3,5,2,0,28,25,3
16818,E02006593,2009,138,219000,206000,16,44,26,52,8,130,85,53
16819,E02006593,2010,170,254000,246000,21,68,26,55,3,167,111,59
16820,E02006593,2011,136,244000,242000,18,47,18,53,9,127,82,54
16821,E02006593,2012,163,241000,232000,11,60,28,64,11,152,96,67
16822,E02006593,2013,209,264000,243000,17,67,34,91,24,185,115,94
16823,E02006593,2014,80,248000,220000,4,23,9,44,14,66,37,43
16824,E02006594,2009,101,245000,225000,26,35,30,10,0,101,93,8
16825,E02006594,2010,129,296000,250000,41,48,32,8,6,123,119,10
16826,E02006594,2011,113,309000,250000,34,35,34,10,11,102,102,11
16827,E02006594,2012,122,310000,250000,25,39,48,10,27,95,113,9
16828,E02006594,2013,234,326000,310000,52,75,90,17,107,127,218,16
16829,E02006594,2014,79,367000,327000,24,23,28,4,37,42,76,3
16830,E02006595,2009,119,346000,310000,59,27,18,15,38,81,102,17
16831,E02006595,2010,104,453000,395000,63,18,13,10,13,91,93,11
16832,E02006595,2011,124,445000,392000,78,14,17,15,4,120,105,19
16833,E02006595,2012,92,412000,391000,56,15,16,5,7,85,84,8
16834,E02006595,2013,101,413000,395000,51,21,18,11,11,90,88,13
16835,E02006595,2014,48,431000,397000,28,9,9,2,3,45,45,3
16836,E02006596,2009,121,254000,225000,45,31,32,13,1,120,109,12
16837,E02006596,2010,134,268000,244000,52,29,37,16,2,132,117,17
16838,E02006596,2011,130,265000,238000,46,27,40,17,4,126,112,18
16839,E02006596,2012,126,280000,250000,50,22,39,15,5,121,111,15
16840,E02006596,2013,203,305000,271000,78,43,64,18,52,151,184,19
16841,E02006596,2014,57,311000,277000,23,9,19,6,10,47,50,7
16842,E02006597,2009,133,314000,247000,37,47,36,13,15,118,120,13
16843,E02006597,2010,155,292000,241000,43,37,44,31,23,132,126,29
16844,E02006597,2011,152,305000,260000,55,37,35,25,18,134,126,26
16845,E02006597,2012,154,289000,258000,50,36,36,32,21,133,123,31
16846,E02006597,2013,215,306000,260000,56,48,76,35,57,158,185,30
16847,E02006597,2014,71,294000,285000,16,22,27,6,12,59,64,7
16848,E02006598,2009,63,335000,250000,29,9,22,3,7,56,60,3
16849,E02006598,2010,67,298000,250000,18,23,20,6,3,64,61,6
16850,E02006598,2011,68,372000,255000,28,20,18,2,0,68,65,3
16851,E02006598,2012,73,369000,290000,28,30,13,2,0,73,71,2
16852,E02006598,2013,67,353000,265000,23,21,19,4,1,66,63,4
16853,E02006598,2014,25,321000,265000,6,9,7,3,0,25,22,3
16854,E02006599,2009,104,431000,415000,87,5,5,7,1,103,97,7
16855,E02006599,2010,149,452000,390000,120,13,10,6,1,148,143,6
16856,E02006599,2011,105,530000,475000,92,11,1,1,0,105,104,1
16857,E02006599,2012,99,462000,419000,79,10,5,5,0,99,94,5
16858,E02006599,2013,144,497000,470000,128,6,6,4,0,144,140,4
16859,E02006599,2014,42,506000,485000,34,7,1,0,1,41,42,0
16860,E02006600,2009,204,246000,215000,59,35,60,50,66,138,144,60
16861,E02006600,2010,204,290000,236000,69,40,56,39,40,164,159,45
16862,E02006600,2011,157,280000,235000,51,34,35,37,1,156,118,39
16863,E02006600,2012,184,295000,250000,65,41,45,33,27,157,148,36
16864,E02006600,2013,238,309000,270000,73,60,60,45,48,190,189,49
16865,E02006600,2014,98,334000,286000,32,15,28,23,17,81,70,28
16866,E02006601,2009,91,345000,250000,43,28,14,6,1,90,82,9
16867,E02006601,2010,120,311000,250000,40,34,33,13,2,118,104,16
16868,E02006601,2011,92,359000,310000,45,27,12,8,2,90,85,7
16869,E02006601,2012,118,391000,332000,58,27,26,7,17,101,109,9
16870,E02006601,2013,152,346000,280000,53,35,47,17,41,111,135,17
16871,E02006601,2014,51,451000,360000,28,10,10,3,6,45,48,3
16872,E02006602,2009,108,357000,330000,77,17,6,8,4,104,100,8
16873,E02006602,2010,117,351000,320000,67,30,16,4,1,116,111,6
16874,E02006602,2011,114,383000,364000,73,22,6,13,0,114,100,14
16875,E02006602,2012,104,401000,345000,71,22,7,4,15,89,100,4
16876,E02006602,2013,131,419000,374000,83,24,16,8,9,122,122,9
16877,E02006602,2014,50,395000,314000,23,22,3,2,5,45,48,2
16878,E02006603,2009,150,281000,244000,52,35,42,21,4,146,128,22
16879,E02006603,2010,136,314000,260000,43,30,43,20,3,133,114,22
16880,E02006603,2011,127,309000,280000,48,36,29,14,0,127,113,14
16881,E02006603,2012,125,330000,300000,52,29,31,13,3,122,110,15
16882,E02006603,2013,172,315000,265000,48,43,43,38,3,169,135,37
16883,E02006603,2014,52,331000,316000,21,12,8,11,0,52,41,11
16884,E02006604,2009,195,213000,195000,35,43,47,70,43,152,125,70
16885,E02006604,2010,189,221000,200000,36,45,31,77,13,176,108,81
16886,E02006604,2011,212,225000,210000,43,57,26,86,22,190,126,86
16887,E02006604,2012,195,224000,206000,28,46,43,78,16,179,116,79
16888,E02006604,2013,234,235000,225000,42,58,41,93,0,234,140,94
16889,E02006604,2014,90,269000,242000,19,24,5,42,2,88,48,42
16890,E02006605,2009,63,278000,248000,26,18,9,10,2,61,53,10
16891,E02006605,2010,68,351000,276000,31,21,12,4,0,68,64,4
16892,E02006605,2011,69,306000,268000,25,23,12,9,4,65,60,9
16893,E02006605,2012,83,306000,285000,31,32,13,7,8,75,76,7
16894,E02006605,2013,90,311000,293000,38,26,16,10,2,88,80,10
16895,E02006605,2014,31,296000,270000,11,5,7,8,1,30,23,8
16896,E02006606,2009,121,264000,228000,50,16,45,10,4,117,109,12
16897,E02006606,2010,127,281000,250000,40,30,50,7,6,121,118,9
16898,E02006606,2011,122,309000,246000,44,20,51,7,7,115,115,7
16899,E02006606,2012,108,278000,272000,44,18,41,5,5,103,103,5
16900,E02006606,2013,170,306000,275000,64,33,61,12,22,148,155,15
16901,E02006606,2014,47,329000,310000,18,7,18,4,6,41,43,4
16902,E02006607,2009,103,292000,270000,44,37,4,18,7,96,84,19
16903,E02006607,2010,90,299000,279000,43,27,5,15,2,88,74,16
16904,E02006607,2011,111,309000,270000,41,37,10,23,7,104,86,25
16905,E02006607,2012,139,287000,250000,49,26,9,55,46,93,83,56
16906,E02006607,2013,146,320000,319000,52,42,29,23,30,116,120,26
16907,E02006607,2014,57,376000,370000,31,10,6,10,8,49,45,12
16908,E02006608,2009,60,341000,250000,25,26,8,1,0,60,59,1
16909,E02006608,2010,77,310000,270000,26,36,10,5,2,75,72,5
16910,E02006608,2011,74,354000,298000,31,29,12,2,9,65,71,3
16911,E02006608,2012,67,346000,270000,31,23,9,4,9,58,63,4
16912,E02006608,2013,110,402000,340000,58,39,10,3,42,68,107,3
16913,E02006608,2014,40,459000,431000,28,7,1,4,12,28,36,4
16914,E02006609,2009,68,447000,310000,35,21,8,4,0,68,62,6
16915,E02006609,2010,69,430000,335000,32,24,5,8,2,67,61,8
16916,E02006609,2011,78,421000,335000,33,29,12,4,0,78,71,7
16917,E02006609,2012,75,473000,348000,33,27,9,6,1,74,68,7
16918,E02006609,2013,77,490000,360000,31,28,11,7,0,77,69,8
16919,E02006609,2014,24,424000,372000,9,10,3,2,0,24,22,2
16920,E02006610,2009,83,402000,370000,35,23,9,16,3,80,67,16
16921,E02006610,2010,85,432000,350000,39,17,14,15,2,83,69,16
16922,E02006610,2011,79,423000,330000,35,22,14,8,3,76,69,10
16923,E02006610,2012,87,421000,380000,40,23,18,6,10,77,82,5
16924,E02006610,2013,74,467000,394000,28,25,13,8,13,61,66,8
16925,E02006610,2014,36,360000,301000,10,11,11,4,2,34,32,4
16926,E02006611,2009,146,289000,250000,45,42,30,29,1,145,119,27
16927,E02006611,2010,166,358000,310000,56,51,35,24,17,149,143,23
16928,E02006611,2011,194,359000,329000,75,49,50,20,31,163,175,19
16929,E02006611,2012,190,369000,313000,72,44,46,28,26,164,166,24
16930,E02006611,2013,200,370000,325000,82,50,51,17,27,173,184,16
16931,E02006611,2014,61,380000,348000,20,16,16,9,5,56,52,9
16932,E02006612,2009,211,231000,185000,31,32,36,112,15,196,105,106
16933,E02006612,2010,208,260000,210000,38,33,43,94,18,190,113,95
16934,E02006612,2011,205,248000,209000,27,46,43,89,9,196,116,89
16935,E02006612,2012,227,239000,196000,43,27,44,113,17,210,116,111
16936,E02006612,2013,296,283000,240000,50,45,71,130,82,214,168,128
16937,E02006612,2014,85,250000,228000,10,13,17,45,2,83,39,46
16938,E02006613,2009,89,233000,220000,18,40,18,13,17,72,75,14
16939,E02006613,2010,94,252000,214000,22,34,24,14,8,86,80,14
16940,E02006613,2011,98,219000,216000,11,34,27,26,12,86,70,28
16941,E02006613,2012,157,209000,210000,17,36,56,48,68,89,109,48
16942,E02006613,2013,145,234000,220000,18,46,33,48,41,104,99,46
16943,E02006613,2014,42,268000,240000,7,14,15,6,4,38,35,7
16944,E02006614,2009,108,302000,242000,44,27,18,19,3,105,88,20
16945,E02006614,2010,156,355000,292000,68,35,16,37,4,152,117,39
16946,E02006614,2011,169,314000,260000,49,42,37,41,27,142,126,43
16947,E02006614,2012,230,336000,300000,72,63,48,47,90,140,182,48
16948,E02006614,2013,184,362000,311000,63,49,41,31,29,155,148,36
16949,E02006614,2014,69,371000,325000,22,17,17,13,9,60,53,16
16950,E02006615,2009,107,219000,207000,28,29,46,4,0,107,101,6
16951,E02006615,2010,97,219000,214000,27,17,44,9,5,92,86,11
16952,E02006615,2011,97,223000,215000,25,19,48,5,1,96,92,5
16953,E02006615,2012,120,239000,234000,38,24,46,12,14,106,105,15
16954,E02006615,2013,144,236000,226000,29,34,71,10,18,126,132,12
16955,E02006615,2014,52,293000,250000,16,13,21,2,9,43,50,2
16956,E02006616,2009,113,228000,225000,28,46,29,10,26,87,100,13
16957,E02006616,2010,111,241000,229000,26,55,21,9,7,104,101,10
16958,E02006616,2011,109,222000,205000,24,35,37,13,2,107,96,13
16959,E02006616,2012,130,236000,215000,35,46,43,6,14,116,124,6
16960,E02006616,2013,171,269000,244000,61,62,38,10,30,141,160,11
16961,E02006616,2014,54,290000,250000,14,23,13,4,7,47,50,4
16962,E02006617,2009,145,184000,175000,14,38,46,47,6,139,95,50
16963,E02006617,2010,136,205000,195000,7,47,48,34,1,135,101,35
16964,E02006617,2011,122,195000,189000,11,46,36,29,3,119,92,30
16965,E02006617,2012,133,220000,197000,18,41,42,32,4,129,101,32
16966,E02006617,2013,181,216000,200000,16,58,40,67,0,181,111,70
16967,E02006617,2014,56,220000,223000,2,17,15,22,1,55,34,22
16968,E02006618,2009,80,291000,249000,44,26,9,1,2,78,78,2
16969,E02006618,2010,111,320000,285000,64,31,14,2,8,103,109,2
16970,E02006618,2011,96,314000,275000,39,37,17,3,17,79,95,1
16971,E02006618,2012,120,333000,300000,54,41,16,9,43,77,111,9
16972,E02006618,2013,114,337000,282000,64,35,13,2,4,110,112,2
16973,E02006618,2014,28,330000,296000,15,10,3,0,0,28,28,0
16974,E02006619,2009,110,367000,283000,45,41,17,7,7,103,102,8
16975,E02006619,2010,88,370000,281000,30,28,23,7,2,86,77,11
16976,E02006619,2011,89,396000,308000,30,31,20,8,0,89,81,8
16977,E02006619,2012,99,368000,325000,35,36,22,6,0,99,93,6
16978,E02006619,2013,103,387000,310000,33,37,23,10,0,103,93,10
16979,E02006619,2014,37,359000,310000,14,11,10,2,0,37,35,2
16980,E02006620,2009,179,317000,282000,89,57,19,14,18,161,166,13
16981,E02006620,2010,212,306000,275000,69,65,38,40,50,162,170,42
16982,E02006620,2011,149,342000,290000,50,62,20,17,27,122,129,20
16983,E02006620,2012,163,341000,315000,73,53,17,20,31,132,143,20
16984,E02006620,2013,172,373000,320000,73,57,21,21,16,156,150,22
16985,E02006620,2014,64,340000,319000,30,18,5,11,4,60,53,11
16986,E02006621,2009,126,279000,250000,83,35,4,4,1,125,122,4
16987,E02006621,2010,146,294000,274000,92,41,3,10,1,145,137,9
16988,E02006621,2011,151,286000,270000,99,39,3,10,3,148,141,10
16989,E02006621,2012,130,302000,285000,90,35,0,5,4,126,125,5
16990,E02006621,2013,170,308000,285000,119,44,2,5,0,170,165,5
16991,E02006621,2014,45,298000,290000,30,8,3,4,0,45,41,4
16992,E02006622,2009,130,213000,186000,34,56,18,22,1,129,111,19
16993,E02006622,2010,104,234000,226000,40,36,12,16,0,104,89,15
16994,E02006622,2011,122,228000,211000,43,38,19,22,0,122,104,18
16995,E02006622,2012,130,228000,217000,38,51,24,17,0,130,117,13
16996,E02006622,2013,134,241000,222000,37,49,22,26,1,133,112,22
16997,E02006622,2014,44,258000,244000,13,20,5,6,1,43,38,6
16998,E02006623,2009,111,168000,168000,14,50,36,11,1,110,99,12
16999,E02006623,2010,120,190000,188000,26,47,30,17,3,117,103,17
17000,E02006623,2011,121,176000,177000,14,51,39,17,3,118,104,17
17001,E02006623,2012,116,192000,185000,19,40,47,10,4,112,107,9
17002,E02006623,2013,129,202000,192000,17,61,42,9,6,123,119,10
17003,E02006623,2014,52,206000,196000,4,21,20,7,0,52,45,7
17004,E02006624,2009,117,238000,230000,31,50,8,28,1,116,98,19
17005,E02006624,2010,106,288000,270000,39,51,4,12,0,106,96,10
17006,E02006624,2011,115,282000,267000,48,36,10,21,2,113,100,15
17007,E02006624,2012,105,274000,250000,39,36,12,18,0,105,90,15
17008,E02006624,2013,156,290000,266000,68,36,11,41,25,131,122,34
17009,E02006624,2014,62,299000,284000,23,18,4,17,6,56,51,11
17010,E02006625,2009,117,183000,174000,13,27,48,29,0,117,90,27
17011,E02006625,2010,124,191000,192000,13,25,64,22,1,123,102,22
17012,E02006625,2011,117,191000,186000,11,25,53,28,0,117,88,29
17013,E02006625,2012,106,203000,202000,14,20,56,16,0,106,94,12
17014,E02006625,2013,138,200000,200000,6,27,81,24,0,138,115,23
17015,E02006625,2014,45,213000,220000,5,7,22,11,0,45,34,11
17016,E02006626,2009,72,161000,158000,10,29,25,8,0,72,65,7
17017,E02006626,2010,93,177000,175000,14,37,29,13,0,93,78,15
17018,E02006626,2011,78,183000,174000,14,27,31,6,0,78,72,6
17019,E02006626,2012,81,179000,175000,17,23,31,10,0,81,71,10
17020,E02006626,2013,113,188000,176000,22,37,40,14,0,113,98,15
17021,E02006626,2014,63,210000,206000,11,22,25,5,15,48,57,6
17022,E02006627,2009,134,181000,180000,17,69,23,25,3,131,106,28
17023,E02006627,2010,115,207000,218000,15,59,16,25,0,115,94,21
17024,E02006627,2011,135,203000,210000,14,76,7,38,10,125,97,38
17025,E02006627,2012,142,210000,210000,31,58,14,39,6,136,104,38
17026,E02006627,2013,150,211000,217000,26,71,15,38,2,148,114,36
17027,E02006627,2014,54,217000,227000,8,21,7,18,4,50,39,15
17028,E02006628,2009,140,170000,166000,5,25,70,40,12,128,105,35
17029,E02006628,2010,139,176000,175000,6,17,74,42,0,139,98,41
17030,E02006628,2011,126,171000,174000,3,18,68,37,0,126,92,34
17031,E02006628,2012,144,181000,178000,4,20,80,40,2,142,105,39
17032,E02006628,2013,178,180000,178000,2,26,94,56,4,174,127,51
17033,E02006628,2014,62,197000,188000,4,6,33,19,0,62,45,17
17034,E02006629,2009,98,188000,183000,14,30,37,17,1,97,83,15
17035,E02006629,2010,95,184000,179000,13,25,32,25,0,95,71,24
17036,E02006629,2011,89,196000,181000,8,33,30,18,0,89,73,16
17037,E02006629,2012,108,176000,180000,5,24,56,23,1,107,84,24
17038,E02006629,2013,120,198000,187000,7,33,55,25,0,120,97,23
17039,E02006629,2014,28,231000,231000,6,6,10,6,0,28,22,6
17040,E02006630,2009,159,154000,135000,2,9,9,139,21,138,34,125
17041,E02006630,2010,187,176000,148000,12,18,15,142,10,177,53,134
17042,E02006630,2011,192,174000,140000,10,20,8,154,11,181,52,140
17043,E02006630,2012,180,179000,150000,10,11,8,151,11,169,41,139
17044,E02006630,2013,228,174000,154000,6,17,14,191,8,220,46,182
17045,E02006630,2014,96,186000,156000,5,6,7,78,0,96,25,71
17046,E02006631,2009,179,157000,137000,9,9,44,117,27,152,68,111
17047,E02006631,2010,204,196000,172000,9,12,44,139,47,157,68,136
17048,E02006631,2011,187,191000,159000,5,10,43,129,28,159,62,125
17049,E02006631,2012,224,217000,173000,9,19,55,141,11,213,87,137
17050,E02006631,2013,237,192000,159000,6,9,69,153,7,230,85,152
17051,E02006631,2014,89,211000,183000,4,5,33,47,0,89,43,46
17052,E02006632,2009,168,207000,175000,26,25,24,93,1,167,94,74
17053,E02006632,2010,177,249000,210000,33,30,21,93,3,174,90,87
17054,E02006632,2011,184,212000,192000,28,36,24,96,28,156,91,93
17055,E02006632,2012,165,214000,185000,26,26,21,92,4,161,88,77
17056,E02006632,2013,182,245000,210000,39,23,20,100,6,176,92,90
17057,E02006632,2014,84,237000,222000,12,12,10,50,0,84,41,43
17058,E02006633,2009,143,237000,240000,55,37,12,39,0,143,119,24
17059,E02006633,2010,163,285000,275000,81,45,5,32,0,163,140,23
17060,E02006633,2011,166,263000,250000,63,54,4,45,0,166,139,27
17061,E02006633,2012,173,277000,272000,76,49,5,43,1,172,148,25
17062,E02006633,2013,186,271000,250000,74,44,13,55,0,186,150,36
17063,E02006633,2014,54,331000,330000,28,9,2,15,0,54,43,11
17064,E02006634,2009,3,726000,600000,2,0,1,0,0,3,3,0
17065,E02006634,2010,4,361000,352000,1,1,2,0,0,4,4,0
17066,E02006634,2011,6,390000,371000,3,1,2,0,0,6,6,0
17067,E02006634,2012,5,471000,490000,1,1,2,1,0,5,5,0
17068,E02006634,2013,3,662000,625000,1,1,1,0,0,3,3,0
17069,E02006634,2014,2,532000,532000,2,0,0,0,0,2,2,0
17070,E02006640,2009,10,647000,385000,6,3,1,0,0,10,10,0
17071,E02006640,2010,6,547000,502000,4,2,0,0,0,6,6,0
17072,E02006640,2011,6,922000,526000,3,2,1,0,0,6,6,0
17073,E02006640,2012,12,579000,586000,8,3,1,0,5,7,12,0
17074,E02006640,2013,14,628000,515000,9,4,1,0,1,13,14,0
17075,E02006640,2014,7,639000,585000,5,2,0,0,0,7,7,0
17076,E02006782,2009,73,268000,240000,5,24,36,8,4,69,65,8
17077,E02006782,2010,69,277000,249000,8,22,34,5,0,69,64,5
17078,E02006782,2011,85,305000,275000,14,35,33,3,1,84,82,3
17079,E02006782,2012,90,274000,250000,7,31,41,11,2,88,79,11
17080,E02006782,2013,115,334000,291000,16,44,46,9,7,108,106,9
17081,E02006782,2014,48,303000,299000,3,20,21,4,1,47,43,5
17082,E02006783,2009,60,170000,170000,1,0,49,10,0,60,50,10
17083,E02006783,2010,39,188000,185000,1,1,35,2,1,38,37,2
17084,E02006783,2011,52,180000,180000,0,8,38,6,0,52,47,5
17085,E02006783,2012,52,176000,176000,0,3,46,3,2,50,48,4
17086,E02006783,2013,70,203000,200000,1,4,61,4,0,70,66,4
17087,E02006783,2014,31,213000,210000,1,0,28,2,0,31,29,2
17088,E02006784,2009,66,188000,175000,1,11,40,14,1,65,53,13
17089,E02006784,2010,67,210000,190000,0,10,46,11,2,65,56,11
17090,E02006784,2011,52,204000,192000,0,12,35,5,0,52,47,5
17091,E02006784,2012,51,214000,195000,1,3,36,11,0,51,40,11
17092,E02006784,2013,72,235000,216000,1,8,50,13,0,72,59,13
17093,E02006784,2014,32,290000,244000,1,8,17,6,0,32,24,8
17094,E02006785,2009,69,183000,185000,3,29,15,22,0,69,49,20
17095,E02006785,2010,57,207000,210000,1,33,10,13,0,57,44,13
17096,E02006785,2011,72,205000,210000,1,39,13,19,0,72,53,19
17097,E02006785,2012,63,216000,214000,3,34,12,14,0,63,48,15
17098,E02006785,2013,73,225000,235000,3,43,12,15,0,73,58,15
17099,E02006785,2014,27,221000,245000,0,13,4,10,0,27,17,10
17100,E02006786,2009,50,182000,175000,1,7,42,0,0,50,50,0
17101,E02006786,2010,46,190000,185000,1,3,41,1,0,46,45,1
17102,E02006786,2011,52,178000,174000,1,4,45,2,0,52,50,2
17103,E02006786,2012,53,183000,188000,0,4,43,6,0,53,47,6
17104,E02006786,2013,72,205000,204000,1,7,55,9,4,68,62,10
17105,E02006786,2014,22,208000,214000,1,4,13,4,0,22,17,5
17106,E02006787,2009,86,285000,288000,2,29,48,7,0,86,79,7
17107,E02006787,2010,93,331000,335000,3,33,48,9,4,89,83,10
17108,E02006787,2011,90,310000,315000,2,21,55,12,0,90,77,13
17109,E02006787,2012,99,313000,311000,2,15,69,13,0,99,85,14
17110,E02006787,2013,123,368000,382000,5,38,60,20,0,123,103,20
17111,E02006787,2014,43,384000,406000,0,10,27,6,0,43,37,6
17112,E02006788,2009,51,190000,190000,2,5,38,6,0,51,47,4
17113,E02006788,2010,52,200000,205000,0,8,40,4,0,52,48,4
17114,E02006788,2011,54,200000,200000,0,9,36,9,0,54,47,7
17115,E02006788,2012,60,211000,214000,2,6,46,6,2,58,54,6
17116,E02006788,2013,68,230000,230000,0,10,55,3,0,68,65,3
17117,E02006788,2014,33,267000,265000,0,1,30,2,0,33,31,2
17118,E02006789,2009,86,307000,289000,41,21,13,11,13,73,76,10
17119,E02006789,2010,83,324000,285000,32,21,13,17,4,79,66,17
17120,E02006789,2011,94,355000,320000,46,24,11,13,0,94,81,13
17121,E02006789,2012,85,348000,321000,39,18,12,16,7,78,69,16
17122,E02006789,2013,88,374000,329000,45,21,11,11,5,83,76,12
17123,E02006789,2014,45,399000,308000,22,6,5,12,0,45,33,12
17124,E02006790,2009,84,320000,268000,28,24,11,21,4,80,60,24
17125,E02006790,2010,104,319000,280000,29,36,18,21,5,99,82,22
17126,E02006790,2011,96,340000,277000,33,39,9,15,2,94,79,17
17127,E02006790,2012,114,316000,274000,27,37,18,32,10,104,83,31
17128,E02006790,2013,134,338000,295000,42,47,18,27,2,132,106,28
17129,E02006790,2014,47,342000,325000,10,18,9,10,1,46,36,11
17130,E02006791,2009,99,435000,380000,4,8,27,60,11,88,39,60
17131,E02006791,2010,155,503000,440000,2,16,56,81,10,145,64,91
17132,E02006791,2011,129,511000,445000,3,10,39,77,10,119,47,82
17133,E02006791,2012,151,559000,426000,2,6,48,95,22,129,50,101
17134,E02006791,2013,135,575000,480000,1,6,46,82,15,120,51,84
17135,E02006791,2014,47,750000,725000,0,3,19,25,0,47,21,26
17136,E02006792,2009,91,459000,375000,1,15,13,62,0,91,27,64
17137,E02006792,2010,135,583000,420000,4,16,28,87,5,130,45,90
17138,E02006792,2011,147,515000,348000,4,16,19,108,5,142,37,110
17139,E02006792,2012,133,550000,411000,3,10,26,94,8,125,35,98
17140,E02006792,2013,148,607000,482000,3,11,32,102,8,140,46,102
17141,E02006792,2014,47,640000,550000,0,5,7,35,0,47,12,35
17142,E02006793,2009,25,155000,137000,0,3,9,13,0,25,12,13
17143,E02006793,2010,45,176000,171000,0,5,19,21,0,45,24,21
17144,E02006793,2011,40,160000,148000,0,5,14,21,0,40,19,21
17145,E02006793,2012,36,177000,180000,0,5,15,16,1,35,20,16
17146,E02006793,2013,43,189000,215000,0,2,24,17,1,42,26,17
17147,E02006793,2014,26,203000,239000,0,2,12,12,0,26,14,12
17148,E02006794,2009,28,178000,167000,0,2,9,17,1,27,11,17
17149,E02006794,2010,35,221000,205000,1,6,12,16,1,34,18,17
17150,E02006794,2011,16,188000,196000,0,2,8,6,0,16,10,6
17151,E02006794,2012,33,197000,200000,0,1,15,17,7,26,16,17
17152,E02006794,2013,29,215000,195000,0,1,13,15,3,26,13,16
17153,E02006794,2014,14,302000,294000,0,2,9,3,0,14,11,3
17154,E02006795,2009,52,252000,250000,0,11,31,10,0,52,42,10
17155,E02006795,2010,60,273000,285000,1,18,26,15,0,60,46,14
17156,E02006795,2011,50,279000,290000,1,12,29,8,0,50,42,8
17157,E02006795,2012,68,293000,300000,2,12,41,13,0,68,54,14
17158,E02006795,2013,65,303000,306000,0,8,46,11,0,65,54,11
17159,E02006795,2014,22,344000,345000,0,6,15,1,0,22,21,1
17160,E02006796,2009,93,229000,225000,9,30,17,37,0,93,55,38
17161,E02006796,2010,122,247000,250000,11,39,31,41,0,122,78,44
17162,E02006796,2011,132,260000,255000,10,58,30,34,0,132,93,39
17163,E02006796,2012,113,269000,270000,8,47,25,33,0,113,79,34
17164,E02006796,2013,137,287000,291000,14,48,34,41,12,125,93,44
17165,E02006796,2014,40,293000,258000,2,12,8,18,1,39,23,17
17166,E02006798,2009,26,186000,168000,0,0,8,18,2,24,9,17
17167,E02006798,2010,43,203000,210000,0,3,7,33,9,34,10,33
17168,E02006798,2011,36,206000,206000,0,0,10,26,4,32,10,26
17169,E02006798,2012,75,197000,183000,0,1,8,66,17,58,9,66
17170,E02006798,2013,115,211000,205000,0,0,14,101,44,71,14,101
17171,E02006798,2014,23,247000,250000,0,1,5,17,3,20,6,17
17172,E02006799,2009,56,164000,164000,1,10,43,2,0,56,54,2
17173,E02006799,2010,76,174000,173000,1,15,50,10,0,76,67,9
17174,E02006799,2011,128,188000,195000,0,21,89,18,56,72,110,18
17175,E02006799,2012,59,179000,177000,0,7,47,5,5,54,53,6
17176,E02006799,2013,87,188000,185000,0,15,66,6,0,87,81,6
17177,E02006799,2014,27,206000,210000,0,3,22,2,0,27,25,2
17178,E02006800,2009,82,226000,208000,4,7,55,16,1,81,66,16
17179,E02006800,2010,82,240000,239000,3,14,48,17,0,82,65,17
17180,E02006800,2011,95,230000,233000,1,16,62,16,0,95,80,15
17181,E02006800,2012,76,205000,216000,0,10,43,23,0,76,52,24
17182,E02006800,2013,90,247000,250000,1,14,59,16,0,90,72,18
17183,E02006800,2014,42,298000,305000,1,6,30,5,0,42,37,5
17184,E02006801,2009,64,489000,418000,0,0,5,59,2,62,5,59
17185,E02006801,2010,108,515000,440000,1,1,11,95,14,94,13,95
17186,E02006801,2011,123,443000,428000,2,0,3,118,26,97,4,119
17187,E02006801,2012,72,471000,442000,0,1,4,67,1,71,5,67
17188,E02006801,2013,89,549000,490000,0,0,4,85,2,87,4,85
17189,E02006801,2014,33,736000,670000,0,0,2,31,8,25,2,31
17190,E02006802,2009,45,290000,268000,1,0,7,37,0,45,7,38
17191,E02006802,2010,53,437000,355000,0,2,11,40,1,52,13,40
17192,E02006802,2011,65,374000,305000,0,0,6,59,3,62,6,59
17193,E02006802,2012,64,422000,342000,1,0,7,56,4,60,8,56
17194,E02006802,2013,62,498000,402000,0,0,14,48,6,56,10,52
17195,E02006802,2014,20,591000,552000,0,0,5,15,3,17,4,16
17196,E02006821,2009,83,224000,215000,20,36,19,8,0,83,75,8
17197,E02006821,2010,78,225000,220000,23,28,17,10,0,78,68,10
17198,E02006821,2011,71,223000,203000,21,23,18,9,0,71,62,9
17199,E02006821,2012,82,206000,197000,9,39,26,8,0,82,74,8
17200,E02006821,2013,86,222000,211000,17,41,16,12,0,86,73,13
17201,E02006821,2014,28,226000,235000,6,12,7,3,0,28,25,3
17202,E02006822,2009,106,197000,176000,30,46,23,7,0,106,99,7
17203,E02006822,2010,99,201000,185000,23,47,23,6,0,99,93,6
17204,E02006822,2011,104,195000,180000,20,47,27,10,0,104,94,10
17205,E02006822,2012,116,193000,180000,23,43,37,13,6,110,103,13
17206,E02006822,2013,118,207000,201000,30,47,33,8,1,117,110,8
17207,E02006822,2014,32,222000,222000,11,11,8,2,0,32,30,2
17208,E02006823,2009,125,560000,455000,85,17,12,11,9,116,111,14
17209,E02006823,2010,124,565000,406000,69,36,10,9,3,121,107,17
17210,E02006823,2011,116,566000,422000,68,23,20,5,1,115,110,6
17211,E02006823,2012,126,527000,384000,64,25,21,16,2,124,106,20
17212,E02006823,2013,156,676000,480000,89,27,24,16,2,154,138,18
17213,E02006823,2014,37,760000,656000,20,9,3,5,0,37,32,5
17214,E02006824,2009,137,296000,260000,44,56,25,12,1,136,117,20
17215,E02006824,2010,128,300000,275000,38,44,16,30,16,112,96,32
17216,E02006824,2011,126,374000,267000,36,38,24,28,13,113,96,30
17217,E02006824,2012,152,365000,310000,57,48,30,17,14,138,128,24
17218,E02006824,2013,163,341000,290000,49,47,42,25,17,146,130,33
17219,E02006824,2014,59,407000,345000,20,21,12,6,7,52,53,6
17220,E02006825,2009,96,334000,272000,63,19,6,8,14,82,87,9
17221,E02006825,2010,86,314000,275000,56,19,9,2,11,75,84,2
17222,E02006825,2011,65,320000,260000,40,18,5,2,3,62,63,2
17223,E02006825,2012,78,327000,293000,51,21,5,1,3,75,78,0
17224,E02006825,2013,93,327000,270000,54,28,11,0,0,93,93,0
17225,E02006825,2014,22,440000,429000,16,3,3,0,3,19,22,0
17226,E02006826,2009,122,175000,157000,21,36,48,17,2,120,105,17
17227,E02006826,2010,130,177000,156000,20,34,52,24,3,127,106,24
17228,E02006826,2011,166,190000,161000,32,45,55,34,2,164,134,32
17229,E02006826,2012,155,198000,175000,16,42,65,32,19,136,123,32
17230,E02006826,2013,205,193000,162000,33,43,84,45,22,183,160,45
17231,E02006826,2014,63,198000,180000,8,21,20,14,5,58,49,14
17232,E02006829,2009,86,287000,232000,40,22,15,9,3,83,77,9
17233,E02006829,2010,80,299000,266000,38,19,16,7,0,80,73,7
17234,E02006829,2011,85,286000,245000,43,22,16,4,0,85,81,4
17235,E02006829,2012,80,283000,234000,35,16,21,8,0,80,72,8
17236,E02006829,2013,127,285000,250000,61,33,22,11,13,114,115,12
17237,E02006829,2014,54,322000,293000,27,11,10,6,12,42,48,6
17238,E02006830,2009,58,174000,166000,11,17,25,5,5,53,53,5
17239,E02006830,2010,72,177000,170000,11,26,30,5,3,69,66,6
17240,E02006830,2011,49,178000,167000,13,13,19,4,1,48,45,4
17241,E02006830,2012,59,160000,151000,7,18,27,7,0,59,52,7
17242,E02006830,2013,70,183000,180000,14,29,21,6,0,70,64,6
17243,E02006830,2014,30,184000,184000,6,6,16,2,0,30,28,2
17244,E02006831,2009,93,195000,180000,25,30,12,26,14,79,67,26
17245,E02006831,2010,77,196000,185000,20,23,16,18,2,75,59,18
17246,E02006831,2011,77,200000,197000,33,25,9,10,0,77,67,10
17247,E02006831,2012,81,210000,204000,33,27,14,7,1,80,74,7
17248,E02006831,2013,96,220000,210000,45,33,9,9,0,96,87,9
17249,E02006831,2014,40,224000,210000,14,14,8,4,2,38,36,4
17250,E02006832,2009,103,184000,170000,12,12,74,5,0,103,95,8
17251,E02006832,2010,76,196000,180000,5,9,57,5,0,76,70,6
17252,E02006832,2011,92,203000,180000,13,16,60,3,0,92,85,7
17253,E02006832,2012,85,213000,184000,8,9,64,4,0,85,81,4
17254,E02006832,2013,77,201000,185000,10,10,54,3,0,77,72,5
17255,E02006832,2014,29,217000,220000,3,3,22,1,0,29,27,2
17256,E02006833,2009,107,340000,278000,44,22,25,16,9,98,88,19
17257,E02006833,2010,148,327000,274000,59,38,29,22,20,128,128,20
17258,E02006833,2011,146,371000,268000,60,29,43,14,20,126,131,15
17259,E02006833,2012,142,321000,250000,49,36,45,12,16,126,131,11
17260,E02006833,2013,194,345000,310000,82,52,46,14,37,157,179,15
17261,E02006833,2014,51,393000,340000,19,12,12,8,7,44,44,7
17262,E02006836,2009,99,457000,305000,38,13,25,23,1,98,76,23
17263,E02006836,2010,113,437000,330000,46,10,28,29,1,112,83,30
17264,E02006836,2011,112,508000,416000,53,16,26,17,1,111,95,17
17265,E02006836,2012,112,475000,370000,48,12,20,32,0,112,81,31
17266,E02006836,2013,123,530000,412000,59,12,21,31,0,123,92,31
17267,E02006836,2014,43,535000,422000,19,3,8,13,0,43,30,13
17268,E02006837,2009,146,380000,381000,61,27,21,37,9,137,101,45
17269,E02006837,2010,159,465000,475000,89,25,7,38,3,156,118,41
17270,E02006837,2011,139,443000,422000,71,23,12,33,0,139,104,35
17271,E02006837,2012,164,447000,432000,79,22,14,49,16,148,109,55
17272,E02006837,2013,162,477000,505000,84,21,10,47,4,158,111,51
17273,E02006837,2014,55,533000,500000,32,6,5,12,0,55,42,13
17274,E02006838,2009,129,367000,325000,92,18,6,13,1,128,117,12
17275,E02006838,2010,126,392000,382000,90,13,9,14,2,124,112,14
17276,E02006838,2011,90,415000,331000,57,15,6,12,1,89,79,11
17277,E02006838,2012,94,406000,385000,64,14,6,10,2,92,84,10
17278,E02006838,2013,121,448000,400000,86,19,3,13,10,111,108,13
17279,E02006838,2014,42,440000,424000,29,7,2,4,1,41,38,4
17280,E02006839,2009,115,445000,390000,65,14,5,31,27,88,83,32
17281,E02006839,2010,113,469000,405000,54,25,6,28,13,100,85,28
17282,E02006839,2011,140,491000,408000,67,31,17,25,20,120,113,27
17283,E02006839,2012,124,496000,400000,61,27,10,26,2,122,96,28
17284,E02006839,2013,129,555000,473000,69,26,11,23,7,122,106,23
17285,E02006839,2014,46,595000,555000,23,8,4,11,1,45,35,11
17286,E02006853,2009,217,329000,295000,0,0,5,212,183,34,5,212
17287,E02006853,2010,551,315000,290000,0,1,4,546,484,67,5,546
17288,E02006853,2011,279,322000,305000,0,0,3,276,197,82,4,275
17289,E02006853,2012,136,340000,327000,0,0,5,131,18,118,6,130
17290,E02006853,2013,165,367000,340000,0,1,4,160,21,144,5,160
17291,E02006853,2014,71,412000,360000,0,0,2,69,4,67,2,69
17292,E02006854,2009,658,428000,364000,0,0,0,658,584,74,0,658
17293,E02006854,2010,714,420000,353000,0,3,1,710,426,288,5,709
17294,E02006854,2011,273,482000,405000,0,0,0,273,79,194,1,272
17295,E02006854,2012,147,510000,410000,0,0,0,147,8,139,0,147
17296,E02006854,2013,236,547000,434000,0,0,1,235,9,227,0,236
17297,E02006854,2014,106,554000,482000,0,0,0,106,1,105,0,106
17298,E02006855,2009,83,179000,170000,7,25,36,15,2,81,67,16
17299,E02006855,2010,69,201000,191000,5,18,33,13,2,67,55,14
17300,E02006855,2011,92,180000,175000,6,26,37,23,10,82,71,21
17301,E02006855,2012,119,202000,190000,3,21,65,30,41,78,89,30
17302,E02006855,2013,113,193000,175000,6,19,44,44,26,87,69,44
17303,E02006855,2014,37,212000,205000,2,9,19,7,0,37,30,7
17304,E02006856,2009,244,168000,160000,9,43,67,125,44,200,117,127
17305,E02006856,2010,258,210000,195000,7,34,79,138,73,185,119,139
17306,E02006856,2011,178,211000,196000,9,25,66,78,27,151,95,83
17307,E02006856,2012,210,207000,196000,5,37,70,98,35,175,112,98
17308,E02006856,2013,249,225000,208000,6,33,88,122,36,213,139,110
17309,E02006856,2014,78,238000,208000,3,12,21,42,8,70,36,42
17310,E02006857,2009,155,169000,170000,26,50,55,24,9,146,128,27
17311,E02006857,2010,151,182000,185000,25,37,49,40,23,128,108,43
17312,E02006857,2011,155,173000,169000,21,39,45,50,22,133,107,48
17313,E02006857,2012,116,185000,185000,29,24,42,21,0,116,95,21
17314,E02006857,2013,251,170000,165000,27,47,74,103,69,182,147,104
17315,E02006857,2014,64,192000,192000,10,14,28,12,0,64,52,12
17316,E02006858,2009,139,217000,210000,9,18,39,73,5,134,64,75
17317,E02006858,2010,169,242000,235000,19,7,57,86,5,164,80,89
17318,E02006858,2011,148,241000,232000,15,10,36,87,4,144,61,87
17319,E02006858,2012,143,228000,220000,15,14,43,71,3,140,68,75
17320,E02006858,2013,185,222000,210000,12,16,53,104,2,183,80,105
17321,E02006858,2014,73,228000,220000,9,9,19,36,0,73,38,35
17322,E02006859,2009,85,196000,175000,17,13,31,24,0,85,61,24
17323,E02006859,2010,114,202000,187000,19,16,44,35,0,114,79,35
17324,E02006859,2011,105,225000,220000,30,14,43,18,0,105,87,18
17325,E02006859,2012,103,202000,178000,21,8,28,46,0,103,57,46
17326,E02006859,2013,104,199000,187000,15,11,38,40,0,104,64,40
17327,E02006859,2014,37,185000,155000,4,2,8,23,0,37,14,23
17328,E02006873,2009,246,197000,175000,65,34,114,33,153,93,204,42
17329,E02006873,2010,250,225000,200000,89,47,96,18,135,115,219,31
17330,E02006873,2011,203,238000,220000,80,31,78,14,95,108,180,23
17331,E02006873,2012,188,200000,199000,41,32,82,33,62,126,142,46
17332,E02006873,2013,218,231000,220000,74,36,82,26,61,157,183,35
17333,E02006873,2014,46,269000,244000,20,6,19,1,9,37,44,2
17334,E02006874,2009,98,252000,223000,53,20,22,3,13,85,92,6
17335,E02006874,2010,122,255000,213000,55,32,28,7,9,113,109,13
17336,E02006874,2011,137,273000,245000,71,28,27,11,19,118,121,16
17337,E02006874,2012,202,241000,214000,78,46,64,14,83,119,182,20
17338,E02006874,2013,242,274000,233000,103,65,65,9,108,134,225,17
17339,E02006874,2014,58,269000,237000,23,10,21,4,22,36,52,6
17340,E02006882,2009,79,291000,288000,2,43,23,11,2,77,69,10
17341,E02006882,2010,73,328000,330000,1,35,30,7,0,73,66,7
17342,E02006882,2011,79,318000,315000,4,35,32,8,0,79,69,10
17343,E02006882,2012,75,332000,347000,2,50,11,12,0,75,63,12
17344,E02006882,2013,80,363000,366000,1,50,20,9,0,80,70,10
17345,E02006882,2014,29,385000,421000,0,13,11,5,0,29,24,5
17346,E02006886,2009,45,296000,260000,16,25,3,1,2,43,45,0
17347,E02006886,2010,87,403000,365000,29,14,4,40,39,48,47,40
17348,E02006886,2011,63,368000,356000,15,16,7,25,24,39,38,25
17349,E02006886,2012,47,400000,330000,20,13,7,7,7,40,40,7
17350,E02006886,2013,54,401000,275000,14,22,7,11,9,45,43,11
17351,E02006886,2014,17,398000,310000,5,8,1,3,0,17,14,3
17352,E02006918,2009,150,181000,167000,0,0,10,140,80,70,9,141
17353,E02006918,2010,128,199000,187000,0,2,3,123,77,51,4,124
17354,E02006918,2011,50,236000,224000,0,0,6,44,7,43,5,45
17355,E02006918,2012,54,258000,215000,0,0,9,45,1,53,9,45
17356,E02006918,2013,98,268000,250000,0,0,2,96,16,82,2,96
17357,E02006918,2014,31,265000,250000,0,0,1,30,1,30,1,30
17358,E02006921,2009,23,212000,187000,0,0,2,21,0,23,3,20
17359,E02006921,2010,23,284000,220000,0,0,7,16,0,23,8,15
17360,E02006921,2011,28,258000,191000,0,0,6,22,0,28,5,23
17361,E02006921,2012,20,319000,242000,1,0,3,16,0,20,4,16
17362,E02006921,2013,28,368000,244000,0,0,9,19,0,28,8,20
17363,E02006921,2014,7,344000,250000,0,0,0,7,0,7,0,7
17364,E02006922,2009,165,164000,155000,42,78,21,24,19,146,139,26
17365,E02006922,2010,179,175000,170000,54,79,32,14,0,179,165,14
17366,E02006922,2011,177,177000,160000,60,70,34,13,0,177,161,16
17367,E02006922,2012,171,172000,162000,53,72,28,18,0,171,150,21
17368,E02006922,2013,192,178000,173000,68,74,29,21,0,192,169,23
17369,E02006922,2014,74,176000,173000,24,28,9,13,0,74,61,13
17370,E02006924,2009,132,238000,191000,2,15,46,69,2,130,64,68
17371,E02006924,2010,140,227000,191000,0,17,41,82,39,101,57,83
17372,E02006924,2011,92,307000,325000,1,19,49,23,0,92,68,24
17373,E02006924,2012,80,337000,328000,1,14,52,13,0,80,65,15
17374,E02006924,2013,87,354000,355000,1,18,54,14,0,87,73,14
17375,E02006924,2014,39,347000,360000,1,9,19,10,0,39,28,11
17376,E02006925,2009,76,304000,309000,2,22,42,10,1,75,66,10
17377,E02006925,2010,100,337000,335000,8,36,44,12,0,100,89,11
17378,E02006925,2011,110,333000,327000,7,45,43,15,0,110,95,15
17379,E02006925,2012,93,358000,345000,13,30,40,10,0,93,83,10
17380,E02006925,2013,110,354000,347000,6,49,43,12,0,110,98,12
17381,E02006925,2014,39,382000,383000,2,16,17,4,0,39,35,4
17382,E02006926,2009,85,202000,200000,29,15,31,10,0,85,75,10
17383,E02006926,2010,127,215000,208000,40,26,39,22,0,127,104,23
17384,E02006926,2011,108,215000,205000,36,19,35,18,0,108,89,19
17385,E02006926,2012,99,219000,203000,35,17,34,13,0,99,85,14
17386,E02006926,2013,131,217000,205000,33,20,45,33,2,129,99,32
17387,E02006926,2014,35,242000,248000,12,6,8,9,0,35,26,9
17388,E02006927,2009,99,318000,240000,12,16,43,28,0,99,67,32
17389,E02006927,2010,81,344000,295000,8,17,29,27,0,81,52,29
17390,E02006927,2011,116,382000,280000,10,18,39,49,12,104,67,49
17391,E02006927,2012,180,324000,284000,7,13,35,125,84,96,52,128
17392,E02006927,2013,241,384000,332000,13,23,43,162,124,117,77,164
17393,E02006927,2014,46,676000,440000,6,7,16,17,6,40,30,16
17394,E02006928,2009,87,271000,255000,0,0,7,80,53,34,7,80
17395,E02006928,2010,76,286000,260000,0,0,3,73,33,43,3,73
17396,E02006928,2011,247,313000,298000,0,0,8,239,164,83,8,239
17397,E02006928,2012,212,304000,265000,0,0,5,207,146,66,5,207
17398,E02006928,2013,423,424000,380000,0,0,4,419,312,111,5,418
17399,E02006928,2014,166,434000,410000,0,1,1,164,123,43,1,165
17400,E02006929,2009,41,300000,280000,0,0,11,30,1,40,11,30
17401,E02006929,2010,98,346000,320000,0,0,40,58,11,87,38,60
17402,E02006929,2011,242,310000,297000,2,1,29,210,160,82,32,210
17403,E02006929,2012,106,343000,309000,0,2,30,74,5,101,30,76
17404,E02006929,2013,114,357000,348000,0,0,27,87,0,114,27,87
17405,E02006929,2014,41,384000,352000,0,0,15,26,0,41,14,27
17406,E02006930,2009,106,335000,330000,0,4,70,32,9,97,74,32
17407,E02006930,2010,100,401000,363000,0,3,76,21,7,93,79,21
17408,E02006930,2011,113,395000,384000,1,4,81,27,0,113,85,28
17409,E02006930,2012,105,404000,371000,0,4,70,31,3,102,75,30
17410,E02006930,2013,146,446000,410000,1,4,77,64,29,117,80,66
17411,E02006930,2014,55,518000,500000,0,0,22,33,19,36,22,33
17412,E02006931,2009,106,481000,421000,5,12,50,39,2,104,63,43
17413,E02006931,2010,155,462000,400000,5,3,77,70,8,147,82,73
17414,E02006931,2011,151,528000,450000,6,12,84,49,2,149,100,51
17415,E02006931,2012,172,501000,372000,0,4,78,90,44,128,82,90
17416,E02006931,2013,192,512000,423000,3,3,76,110,39,153,79,113
17417,E02006931,2014,65,540000,455000,1,0,29,35,4,61,30,35
17418,E02004719,2009,0,0,0,0,0,0,0,0,0,0,0
17419,E02006237,2009,0,0,0,0,0,0,0,0,0,0,0
17420,E02006266,2009,0,0,0,0,0,0,0,0,0,0,0
17421,E02004576,2010,0,0,0,0,0,0,0,0,0,0,0
17422,E02004719,2010,0,0,0,0,0,0,0,0,0,0,0
17423,E02004719,2011,0,0,0,0,0,0,0,0,0,0,0
17424,E02006231,2011,0,0,0,0,0,0,0,0,0,0,0
17425,E02006237,2011,0,0,0,0,0,0,0,0,0,0,0
17426,E02006266,2011,0,0,0,0,0,0,0,0,0,0,0
17427,E02006266,2012,0,0,0,0,0,0,0,0,0,0,0
17428,E02003756,2013,0,0,0,0,0,0,0,0,0,0,0
17429,E02006237,2013,0,0,0,0,0,0,0,0,0,0,0
17430,E02006266,2013,0,0,0,0,0,0,0,0,0,0,0
17431,E02003756,2014,0,0,0,0,0,0,0,0,0,0,0
17432,E02004576,2014,0,0,0,0,0,0,0,0,0,0,0
17433,E02004719,2014,0,0,0,0,0,0,0,0,0,0,0
17434,E02005048,2014,0,0,0,0,0,0,0,0,0,0,0
17435,E02006237,2014,0,0,0,0,0,0,0,0,0,0,0
17436,E02006240,2014,0,0,0,0,0,0,0,0,0,0,0
17437,E02006266,2014,0,0,0,0,0,0,0,0,0,0,0
